nama_provinsi,nama_kota,nama_kecamatan,nama_kelurahan,id_kel,tanggal,kontak_erat,kontak_erat_isolasi_di_rumah,kontak_erat_selesai_isolasi,kontak_erat_baru,kontak_erat_isolasi_di_rumah_baru,kontak_erat_selesai_isolasi_baru
DKI JAKARTA,JAKARTA BARAT,CENGKARENG,CENGKARENG BARAT,3173011001,2020-10-01,1020,75,945,0,0,0
DKI JAKARTA,JAKARTA BARAT,CENGKARENG,CENGKARENG BARAT,3173011001,2020-10-02,1037,61,976,17,-14,31
DKI JAKARTA,JAKARTA BARAT,CENGKARENG,CENGKARENG BARAT,3173011001,2020-10-03,1043,65,978,6,4,2
DKI JAKARTA,JAKARTA BARAT,CENGKARENG,CENGKARENG BARAT,3173011001,2020-10-04,1055,72,983,12,7,5
DKI JAKARTA,JAKARTA BARAT,CENGKARENG,CENGKARENG BARAT,3173011001,2020-10-05,1059,66,993,4,-6,10
DKI JAKARTA,JAKARTA BARAT,CENGKARENG,CENGKARENG BARAT,3173011001,2020-10-06,1063,61,1002,4,-5,9
DKI JAKARTA,JAKARTA BARAT,CENGKARENG,CENGKARENG BARAT,3173011001,2020-10-07,1078,66,1012,15,5,10
DKI JAKARTA,JAKARTA BARAT,CENGKARENG,CENGKARENG BARAT,3173011001,2020-10-08,1106,84,1022,28,18,10
DKI JAKARTA,JAKARTA BARAT,CENGKARENG,CENGKARENG BARAT,3173011001,2020-10-09,1111,88,1023,5,4,1
DKI JAKARTA,JAKARTA BARAT,CENGKARENG,CENGKARENG BARAT,3173011001,2020-10-10,1119,88,1031,8,0,8
DKI JAKARTA,JAKARTA BARAT,CENGKARENG,CENGKARENG BARAT,3173011001,2020-10-11,1132,93,1039,13,5,8
DKI JAKARTA,JAKARTA BARAT,CENGKARENG,CENGKARENG BARAT,3173011001,2020-10-12,1141,95,1046,9,2,7
DKI JAKARTA,JAKARTA BARAT,CENGKARENG,CENGKARENG BARAT,3173011001,2020-10-13,1156,94,1062,15,-1,16
DKI JAKARTA,JAKARTA BARAT,CENGKARENG,CENGKARENG BARAT,3173011001,2020-10-14,1168,101,1067,12,7,5
DKI JAKARTA,JAKARTA BARAT,CENGKARENG,CENGKARENG BARAT,3173011001,2020-10-15,1175,89,1086,7,-12,19
DKI JAKARTA,JAKARTA BARAT,CENGKARENG,CENGKARENG BARAT,3173011001,2020-10-16,1191,86,1105,16,-3,19
DKI JAKARTA,JAKARTA BARAT,CENGKARENG,CENGKARENG BARAT,3173011001,2020-10-17,1220,109,1111,29,23,6
DKI JAKARTA,JAKARTA BARAT,CENGKARENG,CENGKARENG BARAT,3173011001,2020-10-18,1235,119,1116,15,10,5
DKI JAKARTA,JAKARTA BARAT,CENGKARENG,CENGKARENG BARAT,3173011001,2020-10-19,1235,107,1128,0,-12,12
DKI JAKARTA,JAKARTA BARAT,CENGKARENG,CENGKARENG BARAT,3173011001,2020-10-20,1258,109,1149,23,2,21
DKI JAKARTA,JAKARTA BARAT,CENGKARENG,CENGKARENG BARAT,3173011001,2020-10-21,1266,109,1157,8,0,8
DKI JAKARTA,JAKARTA BARAT,CENGKARENG,CENGKARENG BARAT,3173011001,2020-10-22,1268,106,1162,2,-3,5
DKI JAKARTA,JAKARTA BARAT,CENGKARENG,CENGKARENG BARAT,3173011001,2020-10-23,1271,107,1164,3,1,2
DKI JAKARTA,JAKARTA BARAT,CENGKARENG,CENGKARENG BARAT,3173011001,2020-10-24,1277,104,1173,6,-3,9
DKI JAKARTA,JAKARTA BARAT,CENGKARENG,CENGKARENG BARAT,3173011001,2020-10-25,1288,107,1181,11,3,8
DKI JAKARTA,JAKARTA BARAT,CENGKARENG,CENGKARENG BARAT,3173011001,2020-10-26,1293,99,1194,5,-8,13
DKI JAKARTA,JAKARTA BARAT,CENGKARENG,CENGKARENG BARAT,3173011001,2020-10-27,1308,97,1211,15,-2,17
DKI JAKARTA,JAKARTA BARAT,CENGKARENG,CENGKARENG BARAT,3173011001,2020-10-28,1310,90,1220,2,-7,9
DKI JAKARTA,JAKARTA BARAT,CENGKARENG,CENGKARENG BARAT,3173011001,2020-10-29,1324,67,1257,14,-23,37
DKI JAKARTA,JAKARTA BARAT,CENGKARENG,CENGKARENG BARAT,3173011001,2020-10-30,1333,70,1263,9,3,6
DKI JAKARTA,JAKARTA BARAT,CENGKARENG,CENGKARENG BARAT,3173011001,2020-10-31,1342,76,1266,9,6,3
DKI JAKARTA,JAKARTA BARAT,CENGKARENG,CENGKARENG TIMUR,3173011006,2020-10-01,1328,99,1229,0,0,0
DKI JAKARTA,JAKARTA BARAT,CENGKARENG,CENGKARENG TIMUR,3173011006,2020-10-02,1352,95,1257,24,-4,28
DKI JAKARTA,JAKARTA BARAT,CENGKARENG,CENGKARENG TIMUR,3173011006,2020-10-03,1370,102,1268,18,7,11
DKI JAKARTA,JAKARTA BARAT,CENGKARENG,CENGKARENG TIMUR,3173011006,2020-10-04,1378,109,1269,8,7,1
DKI JAKARTA,JAKARTA BARAT,CENGKARENG,CENGKARENG TIMUR,3173011006,2020-10-05,1387,94,1293,9,-15,24
DKI JAKARTA,JAKARTA BARAT,CENGKARENG,CENGKARENG TIMUR,3173011006,2020-10-06,1390,79,1311,3,-15,18
DKI JAKARTA,JAKARTA BARAT,CENGKARENG,CENGKARENG TIMUR,3173011006,2020-10-07,1430,111,1319,40,32,8
DKI JAKARTA,JAKARTA BARAT,CENGKARENG,CENGKARENG TIMUR,3173011006,2020-10-08,1485,159,1326,55,48,7
DKI JAKARTA,JAKARTA BARAT,CENGKARENG,CENGKARENG TIMUR,3173011006,2020-10-09,1493,166,1327,8,7,1
DKI JAKARTA,JAKARTA BARAT,CENGKARENG,CENGKARENG TIMUR,3173011006,2020-10-10,1508,172,1336,15,6,9
DKI JAKARTA,JAKARTA BARAT,CENGKARENG,CENGKARENG TIMUR,3173011006,2020-10-11,1516,177,1339,8,5,3
DKI JAKARTA,JAKARTA BARAT,CENGKARENG,CENGKARENG TIMUR,3173011006,2020-10-12,1528,170,1358,12,-7,19
DKI JAKARTA,JAKARTA BARAT,CENGKARENG,CENGKARENG TIMUR,3173011006,2020-10-13,1554,181,1373,26,11,15
DKI JAKARTA,JAKARTA BARAT,CENGKARENG,CENGKARENG TIMUR,3173011006,2020-10-14,1572,182,1390,18,1,17
DKI JAKARTA,JAKARTA BARAT,CENGKARENG,CENGKARENG TIMUR,3173011006,2020-10-15,1617,210,1407,45,28,17
DKI JAKARTA,JAKARTA BARAT,CENGKARENG,CENGKARENG TIMUR,3173011006,2020-10-16,1637,199,1438,20,-11,31
DKI JAKARTA,JAKARTA BARAT,CENGKARENG,CENGKARENG TIMUR,3173011006,2020-10-17,1656,208,1448,19,9,10
DKI JAKARTA,JAKARTA BARAT,CENGKARENG,CENGKARENG TIMUR,3173011006,2020-10-18,1679,225,1454,23,17,6
DKI JAKARTA,JAKARTA BARAT,CENGKARENG,CENGKARENG TIMUR,3173011006,2020-10-19,1681,200,1481,2,-25,27
DKI JAKARTA,JAKARTA BARAT,CENGKARENG,CENGKARENG TIMUR,3173011006,2020-10-20,1731,212,1519,50,12,38
DKI JAKARTA,JAKARTA BARAT,CENGKARENG,CENGKARENG TIMUR,3173011006,2020-10-21,1734,186,1548,3,-26,29
DKI JAKARTA,JAKARTA BARAT,CENGKARENG,CENGKARENG TIMUR,3173011006,2020-10-22,1735,180,1555,1,-6,7
DKI JAKARTA,JAKARTA BARAT,CENGKARENG,CENGKARENG TIMUR,3173011006,2020-10-23,1740,182,1558,5,2,3
DKI JAKARTA,JAKARTA BARAT,CENGKARENG,CENGKARENG TIMUR,3173011006,2020-10-24,1743,174,1569,3,-8,11
DKI JAKARTA,JAKARTA BARAT,CENGKARENG,CENGKARENG TIMUR,3173011006,2020-10-25,1764,185,1579,21,11,10
DKI JAKARTA,JAKARTA BARAT,CENGKARENG,CENGKARENG TIMUR,3173011006,2020-10-26,1766,169,1597,2,-16,18
DKI JAKARTA,JAKARTA BARAT,CENGKARENG,CENGKARENG TIMUR,3173011006,2020-10-27,1785,166,1619,19,-3,22
DKI JAKARTA,JAKARTA BARAT,CENGKARENG,CENGKARENG TIMUR,3173011006,2020-10-28,1790,148,1642,5,-18,23
DKI JAKARTA,JAKARTA BARAT,CENGKARENG,CENGKARENG TIMUR,3173011006,2020-10-29,1802,138,1664,12,-10,22
DKI JAKARTA,JAKARTA BARAT,CENGKARENG,CENGKARENG TIMUR,3173011006,2020-10-30,1828,145,1683,26,7,19
DKI JAKARTA,JAKARTA BARAT,CENGKARENG,CENGKARENG TIMUR,3173011006,2020-10-31,1850,166,1684,22,21,1
DKI JAKARTA,JAKARTA BARAT,CENGKARENG,DURI KOSAMBI,3173011002,2020-10-01,811,58,753,0,0,0
DKI JAKARTA,JAKARTA BARAT,CENGKARENG,DURI KOSAMBI,3173011002,2020-10-02,826,66,760,15,8,7
DKI JAKARTA,JAKARTA BARAT,CENGKARENG,DURI KOSAMBI,3173011002,2020-10-03,829,65,764,3,-1,4
DKI JAKARTA,JAKARTA BARAT,CENGKARENG,DURI KOSAMBI,3173011002,2020-10-04,838,72,766,9,7,2
DKI JAKARTA,JAKARTA BARAT,CENGKARENG,DURI KOSAMBI,3173011002,2020-10-05,843,62,781,5,-10,15
DKI JAKARTA,JAKARTA BARAT,CENGKARENG,DURI KOSAMBI,3173011002,2020-10-06,846,55,791,3,-7,10
DKI JAKARTA,JAKARTA BARAT,CENGKARENG,DURI KOSAMBI,3173011002,2020-10-07,869,74,795,23,19,4
DKI JAKARTA,JAKARTA BARAT,CENGKARENG,DURI KOSAMBI,3173011002,2020-10-08,888,82,806,19,8,11
DKI JAKARTA,JAKARTA BARAT,CENGKARENG,DURI KOSAMBI,3173011002,2020-10-09,893,87,806,5,5,0
DKI JAKARTA,JAKARTA BARAT,CENGKARENG,DURI KOSAMBI,3173011002,2020-10-10,903,84,819,10,-3,13
DKI JAKARTA,JAKARTA BARAT,CENGKARENG,DURI KOSAMBI,3173011002,2020-10-11,910,86,824,7,2,5
DKI JAKARTA,JAKARTA BARAT,CENGKARENG,DURI KOSAMBI,3173011002,2020-10-12,917,86,831,7,0,7
DKI JAKARTA,JAKARTA BARAT,CENGKARENG,DURI KOSAMBI,3173011002,2020-10-13,925,86,839,8,0,8
DKI JAKARTA,JAKARTA BARAT,CENGKARENG,DURI KOSAMBI,3173011002,2020-10-14,932,86,846,7,0,7
DKI JAKARTA,JAKARTA BARAT,CENGKARENG,DURI KOSAMBI,3173011002,2020-10-15,939,77,862,7,-9,16
DKI JAKARTA,JAKARTA BARAT,CENGKARENG,DURI KOSAMBI,3173011002,2020-10-16,979,100,879,40,23,17
DKI JAKARTA,JAKARTA BARAT,CENGKARENG,DURI KOSAMBI,3173011002,2020-10-17,1002,119,883,23,19,4
DKI JAKARTA,JAKARTA BARAT,CENGKARENG,DURI KOSAMBI,3173011002,2020-10-18,1014,126,888,12,7,5
DKI JAKARTA,JAKARTA BARAT,CENGKARENG,DURI KOSAMBI,3173011002,2020-10-19,1016,118,898,2,-8,10
DKI JAKARTA,JAKARTA BARAT,CENGKARENG,DURI KOSAMBI,3173011002,2020-10-20,1035,134,901,19,16,3
DKI JAKARTA,JAKARTA BARAT,CENGKARENG,DURI KOSAMBI,3173011002,2020-10-21,1038,123,915,3,-11,14
DKI JAKARTA,JAKARTA BARAT,CENGKARENG,DURI KOSAMBI,3173011002,2020-10-22,1040,116,924,2,-7,9
DKI JAKARTA,JAKARTA BARAT,CENGKARENG,DURI KOSAMBI,3173011002,2020-10-23,1043,118,925,3,2,1
DKI JAKARTA,JAKARTA BARAT,CENGKARENG,DURI KOSAMBI,3173011002,2020-10-24,1054,123,931,11,5,6
DKI JAKARTA,JAKARTA BARAT,CENGKARENG,DURI KOSAMBI,3173011002,2020-10-25,1067,132,935,13,9,4
DKI JAKARTA,JAKARTA BARAT,CENGKARENG,DURI KOSAMBI,3173011002,2020-10-26,1068,130,938,1,-2,3
DKI JAKARTA,JAKARTA BARAT,CENGKARENG,DURI KOSAMBI,3173011002,2020-10-27,1082,121,961,14,-9,23
DKI JAKARTA,JAKARTA BARAT,CENGKARENG,DURI KOSAMBI,3173011002,2020-10-28,1090,101,989,8,-20,28
DKI JAKARTA,JAKARTA BARAT,CENGKARENG,DURI KOSAMBI,3173011002,2020-10-29,1100,84,1016,10,-17,27
DKI JAKARTA,JAKARTA BARAT,CENGKARENG,DURI KOSAMBI,3173011002,2020-10-30,1110,90,1020,10,6,4
DKI JAKARTA,JAKARTA BARAT,CENGKARENG,DURI KOSAMBI,3173011002,2020-10-31,1124,101,1023,14,11,3
DKI JAKARTA,JAKARTA BARAT,CENGKARENG,KAPUK,3173011005,2020-10-01,1175,101,1074,0,0,0
DKI JAKARTA,JAKARTA BARAT,CENGKARENG,KAPUK,3173011005,2020-10-02,1209,123,1086,34,22,12
DKI JAKARTA,JAKARTA BARAT,CENGKARENG,KAPUK,3173011005,2020-10-03,1219,126,1093,10,3,7
DKI JAKARTA,JAKARTA BARAT,CENGKARENG,KAPUK,3173011005,2020-10-04,1231,136,1095,12,10,2
DKI JAKARTA,JAKARTA BARAT,CENGKARENG,KAPUK,3173011005,2020-10-05,1238,111,1127,7,-25,32
DKI JAKARTA,JAKARTA BARAT,CENGKARENG,KAPUK,3173011005,2020-10-06,1241,104,1137,3,-7,10
DKI JAKARTA,JAKARTA BARAT,CENGKARENG,KAPUK,3173011005,2020-10-07,1269,119,1150,28,15,13
DKI JAKARTA,JAKARTA BARAT,CENGKARENG,KAPUK,3173011005,2020-10-08,1313,152,1161,44,33,11
DKI JAKARTA,JAKARTA BARAT,CENGKARENG,KAPUK,3173011005,2020-10-09,1323,160,1163,10,8,2
DKI JAKARTA,JAKARTA BARAT,CENGKARENG,KAPUK,3173011005,2020-10-10,1335,159,1176,12,-1,13
DKI JAKARTA,JAKARTA BARAT,CENGKARENG,KAPUK,3173011005,2020-10-11,1364,186,1178,29,27,2
DKI JAKARTA,JAKARTA BARAT,CENGKARENG,KAPUK,3173011005,2020-10-12,1371,165,1206,7,-21,28
DKI JAKARTA,JAKARTA BARAT,CENGKARENG,KAPUK,3173011005,2020-10-13,1387,158,1229,16,-7,23
DKI JAKARTA,JAKARTA BARAT,CENGKARENG,KAPUK,3173011005,2020-10-14,1410,167,1243,23,9,14
DKI JAKARTA,JAKARTA BARAT,CENGKARENG,KAPUK,3173011005,2020-10-15,1442,168,1274,32,1,31
DKI JAKARTA,JAKARTA BARAT,CENGKARENG,KAPUK,3173011005,2020-10-16,1461,163,1298,19,-5,24
DKI JAKARTA,JAKARTA BARAT,CENGKARENG,KAPUK,3173011005,2020-10-17,1486,178,1308,25,15,10
DKI JAKARTA,JAKARTA BARAT,CENGKARENG,KAPUK,3173011005,2020-10-18,1498,186,1312,12,8,4
DKI JAKARTA,JAKARTA BARAT,CENGKARENG,KAPUK,3173011005,2020-10-19,1504,168,1336,6,-18,24
DKI JAKARTA,JAKARTA BARAT,CENGKARENG,KAPUK,3173011005,2020-10-20,1521,152,1369,17,-16,33
DKI JAKARTA,JAKARTA BARAT,CENGKARENG,KAPUK,3173011005,2020-10-21,1531,153,1378,10,1,9
DKI JAKARTA,JAKARTA BARAT,CENGKARENG,KAPUK,3173011005,2020-10-22,1534,146,1388,3,-7,10
DKI JAKARTA,JAKARTA BARAT,CENGKARENG,KAPUK,3173011005,2020-10-23,1538,147,1391,4,1,3
DKI JAKARTA,JAKARTA BARAT,CENGKARENG,KAPUK,3173011005,2020-10-24,1541,132,1409,3,-15,18
DKI JAKARTA,JAKARTA BARAT,CENGKARENG,KAPUK,3173011005,2020-10-25,1559,145,1414,18,13,5
DKI JAKARTA,JAKARTA BARAT,CENGKARENG,KAPUK,3173011005,2020-10-26,1563,133,1430,4,-12,16
DKI JAKARTA,JAKARTA BARAT,CENGKARENG,KAPUK,3173011005,2020-10-27,1594,144,1450,31,11,20
DKI JAKARTA,JAKARTA BARAT,CENGKARENG,KAPUK,3173011005,2020-10-28,1599,126,1473,5,-18,23
DKI JAKARTA,JAKARTA BARAT,CENGKARENG,KAPUK,3173011005,2020-10-29,1613,109,1504,14,-17,31
DKI JAKARTA,JAKARTA BARAT,CENGKARENG,KAPUK,3173011005,2020-10-30,1624,108,1516,11,-1,12
DKI JAKARTA,JAKARTA BARAT,CENGKARENG,KAPUK,3173011005,2020-10-31,1639,120,1519,15,12,3
DKI JAKARTA,JAKARTA BARAT,CENGKARENG,KEDAUNG KALI ANGKE,3173011004,2020-10-01,393,45,348,0,0,0
DKI JAKARTA,JAKARTA BARAT,CENGKARENG,KEDAUNG KALI ANGKE,3173011004,2020-10-02,404,46,358,11,1,10
DKI JAKARTA,JAKARTA BARAT,CENGKARENG,KEDAUNG KALI ANGKE,3173011004,2020-10-03,439,51,388,35,5,30
DKI JAKARTA,JAKARTA BARAT,CENGKARENG,KEDAUNG KALI ANGKE,3173011004,2020-10-04,445,57,388,6,6,0
DKI JAKARTA,JAKARTA BARAT,CENGKARENG,KEDAUNG KALI ANGKE,3173011004,2020-10-05,450,57,393,5,0,5
DKI JAKARTA,JAKARTA BARAT,CENGKARENG,KEDAUNG KALI ANGKE,3173011004,2020-10-06,452,56,396,2,-1,3
DKI JAKARTA,JAKARTA BARAT,CENGKARENG,KEDAUNG KALI ANGKE,3173011004,2020-10-07,457,38,419,5,-18,23
DKI JAKARTA,JAKARTA BARAT,CENGKARENG,KEDAUNG KALI ANGKE,3173011004,2020-10-08,486,63,423,29,25,4
DKI JAKARTA,JAKARTA BARAT,CENGKARENG,KEDAUNG KALI ANGKE,3173011004,2020-10-09,491,67,424,5,4,1
DKI JAKARTA,JAKARTA BARAT,CENGKARENG,KEDAUNG KALI ANGKE,3173011004,2020-10-10,500,71,429,9,4,5
DKI JAKARTA,JAKARTA BARAT,CENGKARENG,KEDAUNG KALI ANGKE,3173011004,2020-10-11,508,75,433,8,4,4
DKI JAKARTA,JAKARTA BARAT,CENGKARENG,KEDAUNG KALI ANGKE,3173011004,2020-10-12,516,78,438,8,3,5
DKI JAKARTA,JAKARTA BARAT,CENGKARENG,KEDAUNG KALI ANGKE,3173011004,2020-10-13,519,65,454,3,-13,16
DKI JAKARTA,JAKARTA BARAT,CENGKARENG,KEDAUNG KALI ANGKE,3173011004,2020-10-14,537,78,459,18,13,5
DKI JAKARTA,JAKARTA BARAT,CENGKARENG,KEDAUNG KALI ANGKE,3173011004,2020-10-15,553,80,473,16,2,14
DKI JAKARTA,JAKARTA BARAT,CENGKARENG,KEDAUNG KALI ANGKE,3173011004,2020-10-16,559,69,490,6,-11,17
DKI JAKARTA,JAKARTA BARAT,CENGKARENG,KEDAUNG KALI ANGKE,3173011004,2020-10-17,568,75,493,9,6,3
DKI JAKARTA,JAKARTA BARAT,CENGKARENG,KEDAUNG KALI ANGKE,3173011004,2020-10-18,580,85,495,12,10,2
DKI JAKARTA,JAKARTA BARAT,CENGKARENG,KEDAUNG KALI ANGKE,3173011004,2020-10-19,581,75,506,1,-10,11
DKI JAKARTA,JAKARTA BARAT,CENGKARENG,KEDAUNG KALI ANGKE,3173011004,2020-10-20,592,72,520,11,-3,14
DKI JAKARTA,JAKARTA BARAT,CENGKARENG,KEDAUNG KALI ANGKE,3173011004,2020-10-21,592,64,528,0,-8,8
DKI JAKARTA,JAKARTA BARAT,CENGKARENG,KEDAUNG KALI ANGKE,3173011004,2020-10-22,595,58,537,3,-6,9
DKI JAKARTA,JAKARTA BARAT,CENGKARENG,KEDAUNG KALI ANGKE,3173011004,2020-10-23,596,58,538,1,0,1
DKI JAKARTA,JAKARTA BARAT,CENGKARENG,KEDAUNG KALI ANGKE,3173011004,2020-10-24,596,54,542,0,-4,4
DKI JAKARTA,JAKARTA BARAT,CENGKARENG,KEDAUNG KALI ANGKE,3173011004,2020-10-25,600,55,545,4,1,3
DKI JAKARTA,JAKARTA BARAT,CENGKARENG,KEDAUNG KALI ANGKE,3173011004,2020-10-26,601,52,549,1,-3,4
DKI JAKARTA,JAKARTA BARAT,CENGKARENG,KEDAUNG KALI ANGKE,3173011004,2020-10-27,612,59,553,11,7,4
DKI JAKARTA,JAKARTA BARAT,CENGKARENG,KEDAUNG KALI ANGKE,3173011004,2020-10-28,614,49,565,2,-10,12
DKI JAKARTA,JAKARTA BARAT,CENGKARENG,KEDAUNG KALI ANGKE,3173011004,2020-10-29,615,37,578,1,-12,13
DKI JAKARTA,JAKARTA BARAT,CENGKARENG,KEDAUNG KALI ANGKE,3173011004,2020-10-30,624,40,584,9,3,6
DKI JAKARTA,JAKARTA BARAT,CENGKARENG,KEDAUNG KALI ANGKE,3173011004,2020-10-31,626,42,584,2,2,0
DKI JAKARTA,JAKARTA BARAT,CENGKARENG,RAWA BUAYA,3173011003,2020-10-01,604,55,549,0,0,0
DKI JAKARTA,JAKARTA BARAT,CENGKARENG,RAWA BUAYA,3173011003,2020-10-02,627,55,572,23,0,23
DKI JAKARTA,JAKARTA BARAT,CENGKARENG,RAWA BUAYA,3173011003,2020-10-03,642,67,575,15,12,3
DKI JAKARTA,JAKARTA BARAT,CENGKARENG,RAWA BUAYA,3173011003,2020-10-04,646,69,577,4,2,2
DKI JAKARTA,JAKARTA BARAT,CENGKARENG,RAWA BUAYA,3173011003,2020-10-05,657,73,584,11,4,7
DKI JAKARTA,JAKARTA BARAT,CENGKARENG,RAWA BUAYA,3173011003,2020-10-06,665,75,590,8,2,6
DKI JAKARTA,JAKARTA BARAT,CENGKARENG,RAWA BUAYA,3173011003,2020-10-07,679,83,596,14,8,6
DKI JAKARTA,JAKARTA BARAT,CENGKARENG,RAWA BUAYA,3173011003,2020-10-08,719,114,605,40,31,9
DKI JAKARTA,JAKARTA BARAT,CENGKARENG,RAWA BUAYA,3173011003,2020-10-09,722,117,605,3,3,0
DKI JAKARTA,JAKARTA BARAT,CENGKARENG,RAWA BUAYA,3173011003,2020-10-10,727,110,617,5,-7,12
DKI JAKARTA,JAKARTA BARAT,CENGKARENG,RAWA BUAYA,3173011003,2020-10-11,736,119,617,9,9,0
DKI JAKARTA,JAKARTA BARAT,CENGKARENG,RAWA BUAYA,3173011003,2020-10-12,741,119,622,5,0,5
DKI JAKARTA,JAKARTA BARAT,CENGKARENG,RAWA BUAYA,3173011003,2020-10-13,742,88,654,1,-31,32
DKI JAKARTA,JAKARTA BARAT,CENGKARENG,RAWA BUAYA,3173011003,2020-10-14,748,86,662,6,-2,8
DKI JAKARTA,JAKARTA BARAT,CENGKARENG,RAWA BUAYA,3173011003,2020-10-15,762,76,686,14,-10,24
DKI JAKARTA,JAKARTA BARAT,CENGKARENG,RAWA BUAYA,3173011003,2020-10-16,770,69,701,8,-7,15
DKI JAKARTA,JAKARTA BARAT,CENGKARENG,RAWA BUAYA,3173011003,2020-10-17,775,70,705,5,1,4
DKI JAKARTA,JAKARTA BARAT,CENGKARENG,RAWA BUAYA,3173011003,2020-10-18,780,74,706,5,4,1
DKI JAKARTA,JAKARTA BARAT,CENGKARENG,RAWA BUAYA,3173011003,2020-10-19,781,72,709,1,-2,3
DKI JAKARTA,JAKARTA BARAT,CENGKARENG,RAWA BUAYA,3173011003,2020-10-20,799,77,722,18,5,13
DKI JAKARTA,JAKARTA BARAT,CENGKARENG,RAWA BUAYA,3173011003,2020-10-21,800,73,727,1,-4,5
DKI JAKARTA,JAKARTA BARAT,CENGKARENG,RAWA BUAYA,3173011003,2020-10-22,804,72,732,4,-1,5
DKI JAKARTA,JAKARTA BARAT,CENGKARENG,RAWA BUAYA,3173011003,2020-10-23,807,73,734,3,1,2
DKI JAKARTA,JAKARTA BARAT,CENGKARENG,RAWA BUAYA,3173011003,2020-10-24,814,76,738,7,3,4
DKI JAKARTA,JAKARTA BARAT,CENGKARENG,RAWA BUAYA,3173011003,2020-10-25,824,83,741,10,7,3
DKI JAKARTA,JAKARTA BARAT,CENGKARENG,RAWA BUAYA,3173011003,2020-10-26,827,84,743,3,1,2
DKI JAKARTA,JAKARTA BARAT,CENGKARENG,RAWA BUAYA,3173011003,2020-10-27,836,78,758,9,-6,15
DKI JAKARTA,JAKARTA BARAT,CENGKARENG,RAWA BUAYA,3173011003,2020-10-28,844,73,771,8,-5,13
DKI JAKARTA,JAKARTA BARAT,CENGKARENG,RAWA BUAYA,3173011003,2020-10-29,847,65,782,3,-8,11
DKI JAKARTA,JAKARTA BARAT,CENGKARENG,RAWA BUAYA,3173011003,2020-10-30,867,81,786,20,16,4
DKI JAKARTA,JAKARTA BARAT,CENGKARENG,RAWA BUAYA,3173011003,2020-10-31,875,89,786,8,8,0
DKI JAKARTA,JAKARTA BARAT,GROGOL PETAMBURAN,GROGOL,3173021001,2020-10-01,707,75,632,0,0,0
DKI JAKARTA,JAKARTA BARAT,GROGOL PETAMBURAN,GROGOL,3173021001,2020-10-02,732,75,657,25,0,25
DKI JAKARTA,JAKARTA BARAT,GROGOL PETAMBURAN,GROGOL,3173021001,2020-10-03,744,79,665,12,4,8
DKI JAKARTA,JAKARTA BARAT,GROGOL PETAMBURAN,GROGOL,3173021001,2020-10-04,752,85,667,8,6,2
DKI JAKARTA,JAKARTA BARAT,GROGOL PETAMBURAN,GROGOL,3173021001,2020-10-05,757,77,680,5,-8,13
DKI JAKARTA,JAKARTA BARAT,GROGOL PETAMBURAN,GROGOL,3173021001,2020-10-06,766,78,688,9,1,8
DKI JAKARTA,JAKARTA BARAT,GROGOL PETAMBURAN,GROGOL,3173021001,2020-10-07,790,91,699,24,13,11
DKI JAKARTA,JAKARTA BARAT,GROGOL PETAMBURAN,GROGOL,3173021001,2020-10-08,816,109,707,26,18,8
DKI JAKARTA,JAKARTA BARAT,GROGOL PETAMBURAN,GROGOL,3173021001,2020-10-09,828,121,707,12,12,0
DKI JAKARTA,JAKARTA BARAT,GROGOL PETAMBURAN,GROGOL,3173021001,2020-10-10,849,123,726,21,2,19
DKI JAKARTA,JAKARTA BARAT,GROGOL PETAMBURAN,GROGOL,3173021001,2020-10-11,871,139,732,22,16,6
DKI JAKARTA,JAKARTA BARAT,GROGOL PETAMBURAN,GROGOL,3173021001,2020-10-12,879,124,755,8,-15,23
DKI JAKARTA,JAKARTA BARAT,GROGOL PETAMBURAN,GROGOL,3173021001,2020-10-13,887,127,760,8,3,5
DKI JAKARTA,JAKARTA BARAT,GROGOL PETAMBURAN,GROGOL,3173021001,2020-10-14,890,125,765,3,-2,5
DKI JAKARTA,JAKARTA BARAT,GROGOL PETAMBURAN,GROGOL,3173021001,2020-10-15,900,123,777,10,-2,12
DKI JAKARTA,JAKARTA BARAT,GROGOL PETAMBURAN,GROGOL,3173021001,2020-10-16,904,108,796,4,-15,19
DKI JAKARTA,JAKARTA BARAT,GROGOL PETAMBURAN,GROGOL,3173021001,2020-10-17,911,111,800,7,3,4
DKI JAKARTA,JAKARTA BARAT,GROGOL PETAMBURAN,GROGOL,3173021001,2020-10-18,926,122,804,15,11,4
DKI JAKARTA,JAKARTA BARAT,GROGOL PETAMBURAN,GROGOL,3173021001,2020-10-19,926,95,831,0,-27,27
DKI JAKARTA,JAKARTA BARAT,GROGOL PETAMBURAN,GROGOL,3173021001,2020-10-20,931,91,840,5,-4,9
DKI JAKARTA,JAKARTA BARAT,GROGOL PETAMBURAN,GROGOL,3173021001,2020-10-21,982,125,857,51,34,17
DKI JAKARTA,JAKARTA BARAT,GROGOL PETAMBURAN,GROGOL,3173021001,2020-10-22,983,110,873,1,-15,16
DKI JAKARTA,JAKARTA BARAT,GROGOL PETAMBURAN,GROGOL,3173021001,2020-10-23,986,111,875,3,1,2
DKI JAKARTA,JAKARTA BARAT,GROGOL PETAMBURAN,GROGOL,3173021001,2020-10-24,987,93,894,1,-18,19
DKI JAKARTA,JAKARTA BARAT,GROGOL PETAMBURAN,GROGOL,3173021001,2020-10-25,989,90,899,2,-3,5
DKI JAKARTA,JAKARTA BARAT,GROGOL PETAMBURAN,GROGOL,3173021001,2020-10-26,991,84,907,2,-6,8
DKI JAKARTA,JAKARTA BARAT,GROGOL PETAMBURAN,GROGOL,3173021001,2020-10-27,1004,87,917,13,3,10
DKI JAKARTA,JAKARTA BARAT,GROGOL PETAMBURAN,GROGOL,3173021001,2020-10-28,1005,80,925,1,-7,8
DKI JAKARTA,JAKARTA BARAT,GROGOL PETAMBURAN,GROGOL,3173021001,2020-10-29,1008,78,930,3,-2,5
DKI JAKARTA,JAKARTA BARAT,GROGOL PETAMBURAN,GROGOL,3173021001,2020-10-30,1021,86,935,13,8,5
DKI JAKARTA,JAKARTA BARAT,GROGOL PETAMBURAN,GROGOL,3173021001,2020-10-31,1024,85,939,3,-1,4
DKI JAKARTA,JAKARTA BARAT,GROGOL PETAMBURAN,JELAMBAR,3173021004,2020-10-01,624,40,584,0,0,0
DKI JAKARTA,JAKARTA BARAT,GROGOL PETAMBURAN,JELAMBAR,3173021004,2020-10-02,638,44,594,14,4,10
DKI JAKARTA,JAKARTA BARAT,GROGOL PETAMBURAN,JELAMBAR,3173021004,2020-10-03,645,43,602,7,-1,8
DKI JAKARTA,JAKARTA BARAT,GROGOL PETAMBURAN,JELAMBAR,3173021004,2020-10-04,651,48,603,6,5,1
DKI JAKARTA,JAKARTA BARAT,GROGOL PETAMBURAN,JELAMBAR,3173021004,2020-10-05,655,47,608,4,-1,5
DKI JAKARTA,JAKARTA BARAT,GROGOL PETAMBURAN,JELAMBAR,3173021004,2020-10-06,659,51,608,4,4,0
DKI JAKARTA,JAKARTA BARAT,GROGOL PETAMBURAN,JELAMBAR,3173021004,2020-10-07,666,51,615,7,0,7
DKI JAKARTA,JAKARTA BARAT,GROGOL PETAMBURAN,JELAMBAR,3173021004,2020-10-08,673,54,619,7,3,4
DKI JAKARTA,JAKARTA BARAT,GROGOL PETAMBURAN,JELAMBAR,3173021004,2020-10-09,679,58,621,6,4,2
DKI JAKARTA,JAKARTA BARAT,GROGOL PETAMBURAN,JELAMBAR,3173021004,2020-10-10,687,54,633,8,-4,12
DKI JAKARTA,JAKARTA BARAT,GROGOL PETAMBURAN,JELAMBAR,3173021004,2020-10-11,689,52,637,2,-2,4
DKI JAKARTA,JAKARTA BARAT,GROGOL PETAMBURAN,JELAMBAR,3173021004,2020-10-12,701,54,647,12,2,10
DKI JAKARTA,JAKARTA BARAT,GROGOL PETAMBURAN,JELAMBAR,3173021004,2020-10-13,715,59,656,14,5,9
DKI JAKARTA,JAKARTA BARAT,GROGOL PETAMBURAN,JELAMBAR,3173021004,2020-10-14,724,57,667,9,-2,11
DKI JAKARTA,JAKARTA BARAT,GROGOL PETAMBURAN,JELAMBAR,3173021004,2020-10-15,739,62,677,15,5,10
DKI JAKARTA,JAKARTA BARAT,GROGOL PETAMBURAN,JELAMBAR,3173021004,2020-10-16,747,63,684,8,1,7
DKI JAKARTA,JAKARTA BARAT,GROGOL PETAMBURAN,JELAMBAR,3173021004,2020-10-17,756,68,688,9,5,4
DKI JAKARTA,JAKARTA BARAT,GROGOL PETAMBURAN,JELAMBAR,3173021004,2020-10-18,769,80,689,13,12,1
DKI JAKARTA,JAKARTA BARAT,GROGOL PETAMBURAN,JELAMBAR,3173021004,2020-10-19,773,81,692,4,1,3
DKI JAKARTA,JAKARTA BARAT,GROGOL PETAMBURAN,JELAMBAR,3173021004,2020-10-20,780,83,697,7,2,5
DKI JAKARTA,JAKARTA BARAT,GROGOL PETAMBURAN,JELAMBAR,3173021004,2020-10-21,783,81,702,3,-2,5
DKI JAKARTA,JAKARTA BARAT,GROGOL PETAMBURAN,JELAMBAR,3173021004,2020-10-22,784,71,713,1,-10,11
DKI JAKARTA,JAKARTA BARAT,GROGOL PETAMBURAN,JELAMBAR,3173021004,2020-10-23,793,79,714,9,8,1
DKI JAKARTA,JAKARTA BARAT,GROGOL PETAMBURAN,JELAMBAR,3173021004,2020-10-24,815,95,720,22,16,6
DKI JAKARTA,JAKARTA BARAT,GROGOL PETAMBURAN,JELAMBAR,3173021004,2020-10-25,817,95,722,2,0,2
DKI JAKARTA,JAKARTA BARAT,GROGOL PETAMBURAN,JELAMBAR,3173021004,2020-10-26,820,70,750,3,-25,28
DKI JAKARTA,JAKARTA BARAT,GROGOL PETAMBURAN,JELAMBAR,3173021004,2020-10-27,827,57,770,7,-13,20
DKI JAKARTA,JAKARTA BARAT,GROGOL PETAMBURAN,JELAMBAR,3173021004,2020-10-28,827,46,781,0,-11,11
DKI JAKARTA,JAKARTA BARAT,GROGOL PETAMBURAN,JELAMBAR,3173021004,2020-10-29,833,47,786,6,1,5
DKI JAKARTA,JAKARTA BARAT,GROGOL PETAMBURAN,JELAMBAR,3173021004,2020-10-30,845,55,790,12,8,4
DKI JAKARTA,JAKARTA BARAT,GROGOL PETAMBURAN,JELAMBAR,3173021004,2020-10-31,850,58,792,5,3,2
DKI JAKARTA,JAKARTA BARAT,GROGOL PETAMBURAN,JELAMBAR BARU,3173021006,2020-10-01,509,35,474,0,0,0
DKI JAKARTA,JAKARTA BARAT,GROGOL PETAMBURAN,JELAMBAR BARU,3173021006,2020-10-02,532,53,479,23,18,5
DKI JAKARTA,JAKARTA BARAT,GROGOL PETAMBURAN,JELAMBAR BARU,3173021006,2020-10-03,535,52,483,3,-1,4
DKI JAKARTA,JAKARTA BARAT,GROGOL PETAMBURAN,JELAMBAR BARU,3173021006,2020-10-04,547,64,483,12,12,0
DKI JAKARTA,JAKARTA BARAT,GROGOL PETAMBURAN,JELAMBAR BARU,3173021006,2020-10-05,549,61,488,2,-3,5
DKI JAKARTA,JAKARTA BARAT,GROGOL PETAMBURAN,JELAMBAR BARU,3173021006,2020-10-06,550,60,490,1,-1,2
DKI JAKARTA,JAKARTA BARAT,GROGOL PETAMBURAN,JELAMBAR BARU,3173021006,2020-10-07,553,59,494,3,-1,4
DKI JAKARTA,JAKARTA BARAT,GROGOL PETAMBURAN,JELAMBAR BARU,3173021006,2020-10-08,561,65,496,8,6,2
DKI JAKARTA,JAKARTA BARAT,GROGOL PETAMBURAN,JELAMBAR BARU,3173021006,2020-10-09,569,72,497,8,7,1
DKI JAKARTA,JAKARTA BARAT,GROGOL PETAMBURAN,JELAMBAR BARU,3173021006,2020-10-10,573,65,508,4,-7,11
DKI JAKARTA,JAKARTA BARAT,GROGOL PETAMBURAN,JELAMBAR BARU,3173021006,2020-10-11,575,50,525,2,-15,17
DKI JAKARTA,JAKARTA BARAT,GROGOL PETAMBURAN,JELAMBAR BARU,3173021006,2020-10-12,580,47,533,5,-3,8
DKI JAKARTA,JAKARTA BARAT,GROGOL PETAMBURAN,JELAMBAR BARU,3173021006,2020-10-13,583,38,545,3,-9,12
DKI JAKARTA,JAKARTA BARAT,GROGOL PETAMBURAN,JELAMBAR BARU,3173021006,2020-10-14,591,41,550,8,3,5
DKI JAKARTA,JAKARTA BARAT,GROGOL PETAMBURAN,JELAMBAR BARU,3173021006,2020-10-15,603,52,551,12,11,1
DKI JAKARTA,JAKARTA BARAT,GROGOL PETAMBURAN,JELAMBAR BARU,3173021006,2020-10-16,605,49,556,2,-3,5
DKI JAKARTA,JAKARTA BARAT,GROGOL PETAMBURAN,JELAMBAR BARU,3173021006,2020-10-17,612,50,562,7,1,6
DKI JAKARTA,JAKARTA BARAT,GROGOL PETAMBURAN,JELAMBAR BARU,3173021006,2020-10-18,615,53,562,3,3,0
DKI JAKARTA,JAKARTA BARAT,GROGOL PETAMBURAN,JELAMBAR BARU,3173021006,2020-10-19,616,40,576,1,-13,14
DKI JAKARTA,JAKARTA BARAT,GROGOL PETAMBURAN,JELAMBAR BARU,3173021006,2020-10-20,622,44,578,6,4,2
DKI JAKARTA,JAKARTA BARAT,GROGOL PETAMBURAN,JELAMBAR BARU,3173021006,2020-10-21,635,53,582,13,9,4
DKI JAKARTA,JAKARTA BARAT,GROGOL PETAMBURAN,JELAMBAR BARU,3173021006,2020-10-22,643,58,585,8,5,3
DKI JAKARTA,JAKARTA BARAT,GROGOL PETAMBURAN,JELAMBAR BARU,3173021006,2020-10-23,644,59,585,1,1,0
DKI JAKARTA,JAKARTA BARAT,GROGOL PETAMBURAN,JELAMBAR BARU,3173021006,2020-10-24,645,55,590,1,-4,5
DKI JAKARTA,JAKARTA BARAT,GROGOL PETAMBURAN,JELAMBAR BARU,3173021006,2020-10-25,648,55,593,3,0,3
DKI JAKARTA,JAKARTA BARAT,GROGOL PETAMBURAN,JELAMBAR BARU,3173021006,2020-10-26,650,41,609,2,-14,16
DKI JAKARTA,JAKARTA BARAT,GROGOL PETAMBURAN,JELAMBAR BARU,3173021006,2020-10-27,663,50,613,13,9,4
DKI JAKARTA,JAKARTA BARAT,GROGOL PETAMBURAN,JELAMBAR BARU,3173021006,2020-10-28,663,41,622,0,-9,9
DKI JAKARTA,JAKARTA BARAT,GROGOL PETAMBURAN,JELAMBAR BARU,3173021006,2020-10-29,665,38,627,2,-3,5
DKI JAKARTA,JAKARTA BARAT,GROGOL PETAMBURAN,JELAMBAR BARU,3173021006,2020-10-30,682,49,633,17,11,6
DKI JAKARTA,JAKARTA BARAT,GROGOL PETAMBURAN,JELAMBAR BARU,3173021006,2020-10-31,685,52,633,3,3,0
DKI JAKARTA,JAKARTA BARAT,GROGOL PETAMBURAN,TANJUNG DUREN SELATAN,3173021005,2020-10-01,536,38,498,0,0,0
DKI JAKARTA,JAKARTA BARAT,GROGOL PETAMBURAN,TANJUNG DUREN SELATAN,3173021005,2020-10-02,546,43,503,10,5,5
DKI JAKARTA,JAKARTA BARAT,GROGOL PETAMBURAN,TANJUNG DUREN SELATAN,3173021005,2020-10-03,547,40,507,1,-3,4
DKI JAKARTA,JAKARTA BARAT,GROGOL PETAMBURAN,TANJUNG DUREN SELATAN,3173021005,2020-10-04,551,40,511,4,0,4
DKI JAKARTA,JAKARTA BARAT,GROGOL PETAMBURAN,TANJUNG DUREN SELATAN,3173021005,2020-10-05,552,33,519,1,-7,8
DKI JAKARTA,JAKARTA BARAT,GROGOL PETAMBURAN,TANJUNG DUREN SELATAN,3173021005,2020-10-06,554,33,521,2,0,2
DKI JAKARTA,JAKARTA BARAT,GROGOL PETAMBURAN,TANJUNG DUREN SELATAN,3173021005,2020-10-07,567,37,530,13,4,9
DKI JAKARTA,JAKARTA BARAT,GROGOL PETAMBURAN,TANJUNG DUREN SELATAN,3173021005,2020-10-08,593,54,539,26,17,9
DKI JAKARTA,JAKARTA BARAT,GROGOL PETAMBURAN,TANJUNG DUREN SELATAN,3173021005,2020-10-09,597,56,541,4,2,2
DKI JAKARTA,JAKARTA BARAT,GROGOL PETAMBURAN,TANJUNG DUREN SELATAN,3173021005,2020-10-10,613,63,550,16,7,9
DKI JAKARTA,JAKARTA BARAT,GROGOL PETAMBURAN,TANJUNG DUREN SELATAN,3173021005,2020-10-11,614,64,550,1,1,0
DKI JAKARTA,JAKARTA BARAT,GROGOL PETAMBURAN,TANJUNG DUREN SELATAN,3173021005,2020-10-12,622,66,556,8,2,6
DKI JAKARTA,JAKARTA BARAT,GROGOL PETAMBURAN,TANJUNG DUREN SELATAN,3173021005,2020-10-13,630,67,563,8,1,7
DKI JAKARTA,JAKARTA BARAT,GROGOL PETAMBURAN,TANJUNG DUREN SELATAN,3173021005,2020-10-14,635,70,565,5,3,2
DKI JAKARTA,JAKARTA BARAT,GROGOL PETAMBURAN,TANJUNG DUREN SELATAN,3173021005,2020-10-15,646,79,567,11,9,2
DKI JAKARTA,JAKARTA BARAT,GROGOL PETAMBURAN,TANJUNG DUREN SELATAN,3173021005,2020-10-16,654,81,573,8,2,6
DKI JAKARTA,JAKARTA BARAT,GROGOL PETAMBURAN,TANJUNG DUREN SELATAN,3173021005,2020-10-17,662,80,582,8,-1,9
DKI JAKARTA,JAKARTA BARAT,GROGOL PETAMBURAN,TANJUNG DUREN SELATAN,3173021005,2020-10-18,673,87,586,11,7,4
DKI JAKARTA,JAKARTA BARAT,GROGOL PETAMBURAN,TANJUNG DUREN SELATAN,3173021005,2020-10-19,675,82,593,2,-5,7
DKI JAKARTA,JAKARTA BARAT,GROGOL PETAMBURAN,TANJUNG DUREN SELATAN,3173021005,2020-10-20,680,66,614,5,-16,21
DKI JAKARTA,JAKARTA BARAT,GROGOL PETAMBURAN,TANJUNG DUREN SELATAN,3173021005,2020-10-21,685,62,623,5,-4,9
DKI JAKARTA,JAKARTA BARAT,GROGOL PETAMBURAN,TANJUNG DUREN SELATAN,3173021005,2020-10-22,685,58,627,0,-4,4
DKI JAKARTA,JAKARTA BARAT,GROGOL PETAMBURAN,TANJUNG DUREN SELATAN,3173021005,2020-10-23,689,62,627,4,4,0
DKI JAKARTA,JAKARTA BARAT,GROGOL PETAMBURAN,TANJUNG DUREN SELATAN,3173021005,2020-10-24,695,58,637,6,-4,10
DKI JAKARTA,JAKARTA BARAT,GROGOL PETAMBURAN,TANJUNG DUREN SELATAN,3173021005,2020-10-25,703,59,644,8,1,7
DKI JAKARTA,JAKARTA BARAT,GROGOL PETAMBURAN,TANJUNG DUREN SELATAN,3173021005,2020-10-26,704,42,662,1,-17,18
DKI JAKARTA,JAKARTA BARAT,GROGOL PETAMBURAN,TANJUNG DUREN SELATAN,3173021005,2020-10-27,710,40,670,6,-2,8
DKI JAKARTA,JAKARTA BARAT,GROGOL PETAMBURAN,TANJUNG DUREN SELATAN,3173021005,2020-10-28,713,38,675,3,-2,5
DKI JAKARTA,JAKARTA BARAT,GROGOL PETAMBURAN,TANJUNG DUREN SELATAN,3173021005,2020-10-29,718,33,685,5,-5,10
DKI JAKARTA,JAKARTA BARAT,GROGOL PETAMBURAN,TANJUNG DUREN SELATAN,3173021005,2020-10-30,724,33,691,6,0,6
DKI JAKARTA,JAKARTA BARAT,GROGOL PETAMBURAN,TANJUNG DUREN SELATAN,3173021005,2020-10-31,729,36,693,5,3,2
DKI JAKARTA,JAKARTA BARAT,GROGOL PETAMBURAN,TANJUNG DUREN UTARA,3173021002,2020-10-01,420,31,389,0,0,0
DKI JAKARTA,JAKARTA BARAT,GROGOL PETAMBURAN,TANJUNG DUREN UTARA,3173021002,2020-10-02,433,36,397,13,5,8
DKI JAKARTA,JAKARTA BARAT,GROGOL PETAMBURAN,TANJUNG DUREN UTARA,3173021002,2020-10-03,433,33,400,0,-3,3
DKI JAKARTA,JAKARTA BARAT,GROGOL PETAMBURAN,TANJUNG DUREN UTARA,3173021002,2020-10-04,434,32,402,1,-1,2
DKI JAKARTA,JAKARTA BARAT,GROGOL PETAMBURAN,TANJUNG DUREN UTARA,3173021002,2020-10-05,442,34,408,8,2,6
DKI JAKARTA,JAKARTA BARAT,GROGOL PETAMBURAN,TANJUNG DUREN UTARA,3173021002,2020-10-06,447,39,408,5,5,0
DKI JAKARTA,JAKARTA BARAT,GROGOL PETAMBURAN,TANJUNG DUREN UTARA,3173021002,2020-10-07,452,43,409,5,4,1
DKI JAKARTA,JAKARTA BARAT,GROGOL PETAMBURAN,TANJUNG DUREN UTARA,3173021002,2020-10-08,467,58,409,15,15,0
DKI JAKARTA,JAKARTA BARAT,GROGOL PETAMBURAN,TANJUNG DUREN UTARA,3173021002,2020-10-09,467,58,409,0,0,0
DKI JAKARTA,JAKARTA BARAT,GROGOL PETAMBURAN,TANJUNG DUREN UTARA,3173021002,2020-10-10,481,56,425,14,-2,16
DKI JAKARTA,JAKARTA BARAT,GROGOL PETAMBURAN,TANJUNG DUREN UTARA,3173021002,2020-10-11,481,55,426,0,-1,1
DKI JAKARTA,JAKARTA BARAT,GROGOL PETAMBURAN,TANJUNG DUREN UTARA,3173021002,2020-10-12,484,50,434,3,-5,8
DKI JAKARTA,JAKARTA BARAT,GROGOL PETAMBURAN,TANJUNG DUREN UTARA,3173021002,2020-10-13,489,49,440,5,-1,6
DKI JAKARTA,JAKARTA BARAT,GROGOL PETAMBURAN,TANJUNG DUREN UTARA,3173021002,2020-10-14,501,50,451,12,1,11
DKI JAKARTA,JAKARTA BARAT,GROGOL PETAMBURAN,TANJUNG DUREN UTARA,3173021002,2020-10-15,508,56,452,7,6,1
DKI JAKARTA,JAKARTA BARAT,GROGOL PETAMBURAN,TANJUNG DUREN UTARA,3173021002,2020-10-16,514,52,462,6,-4,10
DKI JAKARTA,JAKARTA BARAT,GROGOL PETAMBURAN,TANJUNG DUREN UTARA,3173021002,2020-10-17,544,80,464,30,28,2
DKI JAKARTA,JAKARTA BARAT,GROGOL PETAMBURAN,TANJUNG DUREN UTARA,3173021002,2020-10-18,555,88,467,11,8,3
DKI JAKARTA,JAKARTA BARAT,GROGOL PETAMBURAN,TANJUNG DUREN UTARA,3173021002,2020-10-19,556,89,467,1,1,0
DKI JAKARTA,JAKARTA BARAT,GROGOL PETAMBURAN,TANJUNG DUREN UTARA,3173021002,2020-10-20,577,98,479,21,9,12
DKI JAKARTA,JAKARTA BARAT,GROGOL PETAMBURAN,TANJUNG DUREN UTARA,3173021002,2020-10-21,583,95,488,6,-3,9
DKI JAKARTA,JAKARTA BARAT,GROGOL PETAMBURAN,TANJUNG DUREN UTARA,3173021002,2020-10-22,584,94,490,1,-1,2
DKI JAKARTA,JAKARTA BARAT,GROGOL PETAMBURAN,TANJUNG DUREN UTARA,3173021002,2020-10-23,584,94,490,0,0,0
DKI JAKARTA,JAKARTA BARAT,GROGOL PETAMBURAN,TANJUNG DUREN UTARA,3173021002,2020-10-24,586,91,495,2,-3,5
DKI JAKARTA,JAKARTA BARAT,GROGOL PETAMBURAN,TANJUNG DUREN UTARA,3173021002,2020-10-25,592,89,503,6,-2,8
DKI JAKARTA,JAKARTA BARAT,GROGOL PETAMBURAN,TANJUNG DUREN UTARA,3173021002,2020-10-26,593,67,526,1,-22,23
DKI JAKARTA,JAKARTA BARAT,GROGOL PETAMBURAN,TANJUNG DUREN UTARA,3173021002,2020-10-27,593,63,530,0,-4,4
DKI JAKARTA,JAKARTA BARAT,GROGOL PETAMBURAN,TANJUNG DUREN UTARA,3173021002,2020-10-28,595,59,536,2,-4,6
DKI JAKARTA,JAKARTA BARAT,GROGOL PETAMBURAN,TANJUNG DUREN UTARA,3173021002,2020-10-29,602,26,576,7,-33,40
DKI JAKARTA,JAKARTA BARAT,GROGOL PETAMBURAN,TANJUNG DUREN UTARA,3173021002,2020-10-30,607,23,584,5,-3,8
DKI JAKARTA,JAKARTA BARAT,GROGOL PETAMBURAN,TANJUNG DUREN UTARA,3173021002,2020-10-31,610,26,584,3,3,0
DKI JAKARTA,JAKARTA BARAT,GROGOL PETAMBURAN,TOMANG,3173021003,2020-10-01,595,50,545,0,0,0
DKI JAKARTA,JAKARTA BARAT,GROGOL PETAMBURAN,TOMANG,3173021003,2020-10-02,603,55,548,8,5,3
DKI JAKARTA,JAKARTA BARAT,GROGOL PETAMBURAN,TOMANG,3173021003,2020-10-03,607,51,556,4,-4,8
DKI JAKARTA,JAKARTA BARAT,GROGOL PETAMBURAN,TOMANG,3173021003,2020-10-04,617,60,557,10,9,1
DKI JAKARTA,JAKARTA BARAT,GROGOL PETAMBURAN,TOMANG,3173021003,2020-10-05,618,44,574,1,-16,17
DKI JAKARTA,JAKARTA BARAT,GROGOL PETAMBURAN,TOMANG,3173021003,2020-10-06,621,44,577,3,0,3
DKI JAKARTA,JAKARTA BARAT,GROGOL PETAMBURAN,TOMANG,3173021003,2020-10-07,628,42,586,7,-2,9
DKI JAKARTA,JAKARTA BARAT,GROGOL PETAMBURAN,TOMANG,3173021003,2020-10-08,645,53,592,17,11,6
DKI JAKARTA,JAKARTA BARAT,GROGOL PETAMBURAN,TOMANG,3173021003,2020-10-09,653,61,592,8,8,0
DKI JAKARTA,JAKARTA BARAT,GROGOL PETAMBURAN,TOMANG,3173021003,2020-10-10,657,58,599,4,-3,7
DKI JAKARTA,JAKARTA BARAT,GROGOL PETAMBURAN,TOMANG,3173021003,2020-10-11,662,61,601,5,3,2
DKI JAKARTA,JAKARTA BARAT,GROGOL PETAMBURAN,TOMANG,3173021003,2020-10-12,669,60,609,7,-1,8
DKI JAKARTA,JAKARTA BARAT,GROGOL PETAMBURAN,TOMANG,3173021003,2020-10-13,672,61,611,3,1,2
DKI JAKARTA,JAKARTA BARAT,GROGOL PETAMBURAN,TOMANG,3173021003,2020-10-14,678,58,620,6,-3,9
DKI JAKARTA,JAKARTA BARAT,GROGOL PETAMBURAN,TOMANG,3173021003,2020-10-15,696,67,629,18,9,9
DKI JAKARTA,JAKARTA BARAT,GROGOL PETAMBURAN,TOMANG,3173021003,2020-10-16,708,74,634,12,7,5
DKI JAKARTA,JAKARTA BARAT,GROGOL PETAMBURAN,TOMANG,3173021003,2020-10-17,720,84,636,12,10,2
DKI JAKARTA,JAKARTA BARAT,GROGOL PETAMBURAN,TOMANG,3173021003,2020-10-18,732,94,638,12,10,2
DKI JAKARTA,JAKARTA BARAT,GROGOL PETAMBURAN,TOMANG,3173021003,2020-10-19,733,80,653,1,-14,15
DKI JAKARTA,JAKARTA BARAT,GROGOL PETAMBURAN,TOMANG,3173021003,2020-10-20,751,87,664,18,7,11
DKI JAKARTA,JAKARTA BARAT,GROGOL PETAMBURAN,TOMANG,3173021003,2020-10-21,755,84,671,4,-3,7
DKI JAKARTA,JAKARTA BARAT,GROGOL PETAMBURAN,TOMANG,3173021003,2020-10-22,757,77,680,2,-7,9
DKI JAKARTA,JAKARTA BARAT,GROGOL PETAMBURAN,TOMANG,3173021003,2020-10-23,760,77,683,3,0,3
DKI JAKARTA,JAKARTA BARAT,GROGOL PETAMBURAN,TOMANG,3173021003,2020-10-24,764,70,694,4,-7,11
DKI JAKARTA,JAKARTA BARAT,GROGOL PETAMBURAN,TOMANG,3173021003,2020-10-25,770,70,700,6,0,6
DKI JAKARTA,JAKARTA BARAT,GROGOL PETAMBURAN,TOMANG,3173021003,2020-10-26,774,52,722,4,-18,22
DKI JAKARTA,JAKARTA BARAT,GROGOL PETAMBURAN,TOMANG,3173021003,2020-10-27,784,50,734,10,-2,12
DKI JAKARTA,JAKARTA BARAT,GROGOL PETAMBURAN,TOMANG,3173021003,2020-10-28,789,38,751,5,-12,17
DKI JAKARTA,JAKARTA BARAT,GROGOL PETAMBURAN,TOMANG,3173021003,2020-10-29,792,33,759,3,-5,8
DKI JAKARTA,JAKARTA BARAT,GROGOL PETAMBURAN,TOMANG,3173021003,2020-10-30,798,32,766,6,-1,7
DKI JAKARTA,JAKARTA BARAT,GROGOL PETAMBURAN,TOMANG,3173021003,2020-10-31,799,32,767,1,0,1
DKI JAKARTA,JAKARTA BARAT,GROGOL PETAMBURAN,WIJAYA KUSUMA,3173021007,2020-10-01,671,61,610,0,0,0
DKI JAKARTA,JAKARTA BARAT,GROGOL PETAMBURAN,WIJAYA KUSUMA,3173021007,2020-10-02,693,76,617,22,15,7
DKI JAKARTA,JAKARTA BARAT,GROGOL PETAMBURAN,WIJAYA KUSUMA,3173021007,2020-10-03,702,81,621,9,5,4
DKI JAKARTA,JAKARTA BARAT,GROGOL PETAMBURAN,WIJAYA KUSUMA,3173021007,2020-10-04,713,89,624,11,8,3
DKI JAKARTA,JAKARTA BARAT,GROGOL PETAMBURAN,WIJAYA KUSUMA,3173021007,2020-10-05,717,79,638,4,-10,14
DKI JAKARTA,JAKARTA BARAT,GROGOL PETAMBURAN,WIJAYA KUSUMA,3173021007,2020-10-06,717,71,646,0,-8,8
DKI JAKARTA,JAKARTA BARAT,GROGOL PETAMBURAN,WIJAYA KUSUMA,3173021007,2020-10-07,726,77,649,9,6,3
DKI JAKARTA,JAKARTA BARAT,GROGOL PETAMBURAN,WIJAYA KUSUMA,3173021007,2020-10-08,745,90,655,19,13,6
DKI JAKARTA,JAKARTA BARAT,GROGOL PETAMBURAN,WIJAYA KUSUMA,3173021007,2020-10-09,752,96,656,7,6,1
DKI JAKARTA,JAKARTA BARAT,GROGOL PETAMBURAN,WIJAYA KUSUMA,3173021007,2020-10-10,758,79,679,6,-17,23
DKI JAKARTA,JAKARTA BARAT,GROGOL PETAMBURAN,WIJAYA KUSUMA,3173021007,2020-10-11,763,83,680,5,4,1
DKI JAKARTA,JAKARTA BARAT,GROGOL PETAMBURAN,WIJAYA KUSUMA,3173021007,2020-10-12,773,89,684,10,6,4
DKI JAKARTA,JAKARTA BARAT,GROGOL PETAMBURAN,WIJAYA KUSUMA,3173021007,2020-10-13,784,80,704,11,-9,20
DKI JAKARTA,JAKARTA BARAT,GROGOL PETAMBURAN,WIJAYA KUSUMA,3173021007,2020-10-14,793,81,712,9,1,8
DKI JAKARTA,JAKARTA BARAT,GROGOL PETAMBURAN,WIJAYA KUSUMA,3173021007,2020-10-15,800,74,726,7,-7,14
DKI JAKARTA,JAKARTA BARAT,GROGOL PETAMBURAN,WIJAYA KUSUMA,3173021007,2020-10-16,805,75,730,5,1,4
DKI JAKARTA,JAKARTA BARAT,GROGOL PETAMBURAN,WIJAYA KUSUMA,3173021007,2020-10-17,808,76,732,3,1,2
DKI JAKARTA,JAKARTA BARAT,GROGOL PETAMBURAN,WIJAYA KUSUMA,3173021007,2020-10-18,811,73,738,3,-3,6
DKI JAKARTA,JAKARTA BARAT,GROGOL PETAMBURAN,WIJAYA KUSUMA,3173021007,2020-10-19,813,66,747,2,-7,9
DKI JAKARTA,JAKARTA BARAT,GROGOL PETAMBURAN,WIJAYA KUSUMA,3173021007,2020-10-20,823,70,753,10,4,6
DKI JAKARTA,JAKARTA BARAT,GROGOL PETAMBURAN,WIJAYA KUSUMA,3173021007,2020-10-21,837,73,764,14,3,11
DKI JAKARTA,JAKARTA BARAT,GROGOL PETAMBURAN,WIJAYA KUSUMA,3173021007,2020-10-22,839,65,774,2,-8,10
DKI JAKARTA,JAKARTA BARAT,GROGOL PETAMBURAN,WIJAYA KUSUMA,3173021007,2020-10-23,848,72,776,9,7,2
DKI JAKARTA,JAKARTA BARAT,GROGOL PETAMBURAN,WIJAYA KUSUMA,3173021007,2020-10-24,852,63,789,4,-9,13
DKI JAKARTA,JAKARTA BARAT,GROGOL PETAMBURAN,WIJAYA KUSUMA,3173021007,2020-10-25,854,62,792,2,-1,3
DKI JAKARTA,JAKARTA BARAT,GROGOL PETAMBURAN,WIJAYA KUSUMA,3173021007,2020-10-26,855,47,808,1,-15,16
DKI JAKARTA,JAKARTA BARAT,GROGOL PETAMBURAN,WIJAYA KUSUMA,3173021007,2020-10-27,865,47,818,10,0,10
DKI JAKARTA,JAKARTA BARAT,GROGOL PETAMBURAN,WIJAYA KUSUMA,3173021007,2020-10-28,866,47,819,1,0,1
DKI JAKARTA,JAKARTA BARAT,GROGOL PETAMBURAN,WIJAYA KUSUMA,3173021007,2020-10-29,869,41,828,3,-6,9
DKI JAKARTA,JAKARTA BARAT,GROGOL PETAMBURAN,WIJAYA KUSUMA,3173021007,2020-10-30,877,48,829,8,7,1
DKI JAKARTA,JAKARTA BARAT,GROGOL PETAMBURAN,WIJAYA KUSUMA,3173021007,2020-10-31,878,49,829,1,1,0
DKI JAKARTA,JAKARTA BARAT,KALI DERES,KALIDERES,3173061001,2020-10-01,1874,130,1744,0,0,0
DKI JAKARTA,JAKARTA BARAT,KALI DERES,KALIDERES,3173061001,2020-10-02,1915,150,1765,41,20,21
DKI JAKARTA,JAKARTA BARAT,KALI DERES,KALIDERES,3173061001,2020-10-03,1930,158,1772,15,8,7
DKI JAKARTA,JAKARTA BARAT,KALI DERES,KALIDERES,3173061001,2020-10-04,1940,166,1774,10,8,2
DKI JAKARTA,JAKARTA BARAT,KALI DERES,KALIDERES,3173061001,2020-10-05,1945,150,1795,5,-16,21
DKI JAKARTA,JAKARTA BARAT,KALI DERES,KALIDERES,3173061001,2020-10-06,1963,148,1815,18,-2,20
DKI JAKARTA,JAKARTA BARAT,KALI DERES,KALIDERES,3173061001,2020-10-07,2021,190,1831,58,42,16
DKI JAKARTA,JAKARTA BARAT,KALI DERES,KALIDERES,3173061001,2020-10-08,2050,209,1841,29,19,10
DKI JAKARTA,JAKARTA BARAT,KALI DERES,KALIDERES,3173061001,2020-10-09,2066,224,1842,16,15,1
DKI JAKARTA,JAKARTA BARAT,KALI DERES,KALIDERES,3173061001,2020-10-10,2077,212,1865,11,-12,23
DKI JAKARTA,JAKARTA BARAT,KALI DERES,KALIDERES,3173061001,2020-10-11,2103,233,1870,26,21,5
DKI JAKARTA,JAKARTA BARAT,KALI DERES,KALIDERES,3173061001,2020-10-12,2131,217,1914,28,-16,44
DKI JAKARTA,JAKARTA BARAT,KALI DERES,KALIDERES,3173061001,2020-10-13,2133,196,1937,2,-21,23
DKI JAKARTA,JAKARTA BARAT,KALI DERES,KALIDERES,3173061001,2020-10-14,2148,205,1943,15,9,6
DKI JAKARTA,JAKARTA BARAT,KALI DERES,KALIDERES,3173061001,2020-10-15,2165,178,1987,17,-27,44
DKI JAKARTA,JAKARTA BARAT,KALI DERES,KALIDERES,3173061001,2020-10-16,2177,157,2020,12,-21,33
DKI JAKARTA,JAKARTA BARAT,KALI DERES,KALIDERES,3173061001,2020-10-17,2201,178,2023,24,21,3
DKI JAKARTA,JAKARTA BARAT,KALI DERES,KALIDERES,3173061001,2020-10-18,2212,186,2026,11,8,3
DKI JAKARTA,JAKARTA BARAT,KALI DERES,KALIDERES,3173061001,2020-10-19,2212,157,2055,0,-29,29
DKI JAKARTA,JAKARTA BARAT,KALI DERES,KALIDERES,3173061001,2020-10-20,2227,136,2091,15,-21,36
DKI JAKARTA,JAKARTA BARAT,KALI DERES,KALIDERES,3173061001,2020-10-21,2229,132,2097,2,-4,6
DKI JAKARTA,JAKARTA BARAT,KALI DERES,KALIDERES,3173061001,2020-10-22,2230,101,2129,1,-31,32
DKI JAKARTA,JAKARTA BARAT,KALI DERES,KALIDERES,3173061001,2020-10-23,2245,115,2130,15,14,1
DKI JAKARTA,JAKARTA BARAT,KALI DERES,KALIDERES,3173061001,2020-10-24,2253,105,2148,8,-10,18
DKI JAKARTA,JAKARTA BARAT,KALI DERES,KALIDERES,3173061001,2020-10-25,2272,119,2153,19,14,5
DKI JAKARTA,JAKARTA BARAT,KALI DERES,KALIDERES,3173061001,2020-10-26,2286,110,2176,14,-9,23
DKI JAKARTA,JAKARTA BARAT,KALI DERES,KALIDERES,3173061001,2020-10-27,2299,104,2195,13,-6,19
DKI JAKARTA,JAKARTA BARAT,KALI DERES,KALIDERES,3173061001,2020-10-28,2300,100,2200,1,-4,5
DKI JAKARTA,JAKARTA BARAT,KALI DERES,KALIDERES,3173061001,2020-10-29,2331,98,2233,31,-2,33
DKI JAKARTA,JAKARTA BARAT,KALI DERES,KALIDERES,3173061001,2020-10-30,2351,113,2238,20,15,5
DKI JAKARTA,JAKARTA BARAT,KALI DERES,KALIDERES,3173061001,2020-10-31,2358,117,2241,7,4,3
DKI JAKARTA,JAKARTA BARAT,KALI DERES,KAMAL,3173061004,2020-10-01,485,28,457,0,0,0
DKI JAKARTA,JAKARTA BARAT,KALI DERES,KAMAL,3173061004,2020-10-02,492,30,462,7,2,5
DKI JAKARTA,JAKARTA BARAT,KALI DERES,KAMAL,3173061004,2020-10-03,495,30,465,3,0,3
DKI JAKARTA,JAKARTA BARAT,KALI DERES,KAMAL,3173061004,2020-10-04,497,30,467,2,0,2
DKI JAKARTA,JAKARTA BARAT,KALI DERES,KAMAL,3173061004,2020-10-05,499,30,469,2,0,2
DKI JAKARTA,JAKARTA BARAT,KALI DERES,KAMAL,3173061004,2020-10-06,500,30,470,1,0,1
DKI JAKARTA,JAKARTA BARAT,KALI DERES,KAMAL,3173061004,2020-10-07,506,33,473,6,3,3
DKI JAKARTA,JAKARTA BARAT,KALI DERES,KAMAL,3173061004,2020-10-08,510,33,477,4,0,4
DKI JAKARTA,JAKARTA BARAT,KALI DERES,KAMAL,3173061004,2020-10-09,511,34,477,1,1,0
DKI JAKARTA,JAKARTA BARAT,KALI DERES,KAMAL,3173061004,2020-10-10,511,28,483,0,-6,6
DKI JAKARTA,JAKARTA BARAT,KALI DERES,KAMAL,3173061004,2020-10-11,514,28,486,3,0,3
DKI JAKARTA,JAKARTA BARAT,KALI DERES,KAMAL,3173061004,2020-10-12,520,30,490,6,2,4
DKI JAKARTA,JAKARTA BARAT,KALI DERES,KAMAL,3173061004,2020-10-13,520,25,495,0,-5,5
DKI JAKARTA,JAKARTA BARAT,KALI DERES,KAMAL,3173061004,2020-10-14,521,25,496,1,0,1
DKI JAKARTA,JAKARTA BARAT,KALI DERES,KAMAL,3173061004,2020-10-15,527,25,502,6,0,6
DKI JAKARTA,JAKARTA BARAT,KALI DERES,KAMAL,3173061004,2020-10-16,530,24,506,3,-1,4
DKI JAKARTA,JAKARTA BARAT,KALI DERES,KAMAL,3173061004,2020-10-17,543,36,507,13,12,1
DKI JAKARTA,JAKARTA BARAT,KALI DERES,KAMAL,3173061004,2020-10-18,550,43,507,7,7,0
DKI JAKARTA,JAKARTA BARAT,KALI DERES,KAMAL,3173061004,2020-10-19,550,41,509,0,-2,2
DKI JAKARTA,JAKARTA BARAT,KALI DERES,KAMAL,3173061004,2020-10-20,553,42,511,3,1,2
DKI JAKARTA,JAKARTA BARAT,KALI DERES,KAMAL,3173061004,2020-10-21,554,43,511,1,1,0
DKI JAKARTA,JAKARTA BARAT,KALI DERES,KAMAL,3173061004,2020-10-22,556,39,517,2,-4,6
DKI JAKARTA,JAKARTA BARAT,KALI DERES,KAMAL,3173061004,2020-10-23,556,39,517,0,0,0
DKI JAKARTA,JAKARTA BARAT,KALI DERES,KAMAL,3173061004,2020-10-24,558,36,522,2,-3,5
DKI JAKARTA,JAKARTA BARAT,KALI DERES,KAMAL,3173061004,2020-10-25,561,38,523,3,2,1
DKI JAKARTA,JAKARTA BARAT,KALI DERES,KAMAL,3173061004,2020-10-26,565,40,525,4,2,2
DKI JAKARTA,JAKARTA BARAT,KALI DERES,KAMAL,3173061004,2020-10-27,569,38,531,4,-2,6
DKI JAKARTA,JAKARTA BARAT,KALI DERES,KAMAL,3173061004,2020-10-28,570,36,534,1,-2,3
DKI JAKARTA,JAKARTA BARAT,KALI DERES,KAMAL,3173061004,2020-10-29,574,24,550,4,-12,16
DKI JAKARTA,JAKARTA BARAT,KALI DERES,KAMAL,3173061004,2020-10-30,580,27,553,6,3,3
DKI JAKARTA,JAKARTA BARAT,KALI DERES,KAMAL,3173061004,2020-10-31,581,28,553,1,1,0
DKI JAKARTA,JAKARTA BARAT,KALI DERES,PEGADUNGAN,3173061005,2020-10-01,1252,99,1153,0,0,0
DKI JAKARTA,JAKARTA BARAT,KALI DERES,PEGADUNGAN,3173061005,2020-10-02,1274,97,1177,22,-2,24
DKI JAKARTA,JAKARTA BARAT,KALI DERES,PEGADUNGAN,3173061005,2020-10-03,1288,102,1186,14,5,9
DKI JAKARTA,JAKARTA BARAT,KALI DERES,PEGADUNGAN,3173061005,2020-10-04,1297,106,1191,9,4,5
DKI JAKARTA,JAKARTA BARAT,KALI DERES,PEGADUNGAN,3173061005,2020-10-05,1302,96,1206,5,-10,15
DKI JAKARTA,JAKARTA BARAT,KALI DERES,PEGADUNGAN,3173061005,2020-10-06,1311,87,1224,9,-9,18
DKI JAKARTA,JAKARTA BARAT,KALI DERES,PEGADUNGAN,3173061005,2020-10-07,1353,112,1241,42,25,17
DKI JAKARTA,JAKARTA BARAT,KALI DERES,PEGADUNGAN,3173061005,2020-10-08,1366,121,1245,13,9,4
DKI JAKARTA,JAKARTA BARAT,KALI DERES,PEGADUNGAN,3173061005,2020-10-09,1377,130,1247,11,9,2
DKI JAKARTA,JAKARTA BARAT,KALI DERES,PEGADUNGAN,3173061005,2020-10-10,1381,122,1259,4,-8,12
DKI JAKARTA,JAKARTA BARAT,KALI DERES,PEGADUNGAN,3173061005,2020-10-11,1388,127,1261,7,5,2
DKI JAKARTA,JAKARTA BARAT,KALI DERES,PEGADUNGAN,3173061005,2020-10-12,1416,140,1276,28,13,15
DKI JAKARTA,JAKARTA BARAT,KALI DERES,PEGADUNGAN,3173061005,2020-10-13,1424,129,1295,8,-11,19
DKI JAKARTA,JAKARTA BARAT,KALI DERES,PEGADUNGAN,3173061005,2020-10-14,1448,145,1303,24,16,8
DKI JAKARTA,JAKARTA BARAT,KALI DERES,PEGADUNGAN,3173061005,2020-10-15,1471,147,1324,23,2,21
DKI JAKARTA,JAKARTA BARAT,KALI DERES,PEGADUNGAN,3173061005,2020-10-16,1483,131,1352,12,-16,28
DKI JAKARTA,JAKARTA BARAT,KALI DERES,PEGADUNGAN,3173061005,2020-10-17,1497,133,1364,14,2,12
DKI JAKARTA,JAKARTA BARAT,KALI DERES,PEGADUNGAN,3173061005,2020-10-18,1505,139,1366,8,6,2
DKI JAKARTA,JAKARTA BARAT,KALI DERES,PEGADUNGAN,3173061005,2020-10-19,1506,122,1384,1,-17,18
DKI JAKARTA,JAKARTA BARAT,KALI DERES,PEGADUNGAN,3173061005,2020-10-20,1514,118,1396,8,-4,12
DKI JAKARTA,JAKARTA BARAT,KALI DERES,PEGADUNGAN,3173061005,2020-10-21,1516,117,1399,2,-1,3
DKI JAKARTA,JAKARTA BARAT,KALI DERES,PEGADUNGAN,3173061005,2020-10-22,1519,108,1411,3,-9,12
DKI JAKARTA,JAKARTA BARAT,KALI DERES,PEGADUNGAN,3173061005,2020-10-23,1523,111,1412,4,3,1
DKI JAKARTA,JAKARTA BARAT,KALI DERES,PEGADUNGAN,3173061005,2020-10-24,1526,88,1438,3,-23,26
DKI JAKARTA,JAKARTA BARAT,KALI DERES,PEGADUNGAN,3173061005,2020-10-25,1534,93,1441,8,5,3
DKI JAKARTA,JAKARTA BARAT,KALI DERES,PEGADUNGAN,3173061005,2020-10-26,1541,82,1459,7,-11,18
DKI JAKARTA,JAKARTA BARAT,KALI DERES,PEGADUNGAN,3173061005,2020-10-27,1543,68,1475,2,-14,16
DKI JAKARTA,JAKARTA BARAT,KALI DERES,PEGADUNGAN,3173061005,2020-10-28,1547,57,1490,4,-11,15
DKI JAKARTA,JAKARTA BARAT,KALI DERES,PEGADUNGAN,3173061005,2020-10-29,1564,51,1513,17,-6,23
DKI JAKARTA,JAKARTA BARAT,KALI DERES,PEGADUNGAN,3173061005,2020-10-30,1576,60,1516,12,9,3
DKI JAKARTA,JAKARTA BARAT,KALI DERES,PEGADUNGAN,3173061005,2020-10-31,1591,74,1517,15,14,1
DKI JAKARTA,JAKARTA BARAT,KALI DERES,SEMANAN,3173061002,2020-10-01,847,89,758,0,0,0
DKI JAKARTA,JAKARTA BARAT,KALI DERES,SEMANAN,3173061002,2020-10-02,878,95,783,31,6,25
DKI JAKARTA,JAKARTA BARAT,KALI DERES,SEMANAN,3173061002,2020-10-03,890,93,797,12,-2,14
DKI JAKARTA,JAKARTA BARAT,KALI DERES,SEMANAN,3173061002,2020-10-04,893,96,797,3,3,0
DKI JAKARTA,JAKARTA BARAT,KALI DERES,SEMANAN,3173061002,2020-10-05,893,70,823,0,-26,26
DKI JAKARTA,JAKARTA BARAT,KALI DERES,SEMANAN,3173061002,2020-10-06,901,66,835,8,-4,12
DKI JAKARTA,JAKARTA BARAT,KALI DERES,SEMANAN,3173061002,2020-10-07,934,81,853,33,15,18
DKI JAKARTA,JAKARTA BARAT,KALI DERES,SEMANAN,3173061002,2020-10-08,972,104,868,38,23,15
DKI JAKARTA,JAKARTA BARAT,KALI DERES,SEMANAN,3173061002,2020-10-09,984,115,869,12,11,1
DKI JAKARTA,JAKARTA BARAT,KALI DERES,SEMANAN,3173061002,2020-10-10,991,109,882,7,-6,13
DKI JAKARTA,JAKARTA BARAT,KALI DERES,SEMANAN,3173061002,2020-10-11,995,110,885,4,1,3
DKI JAKARTA,JAKARTA BARAT,KALI DERES,SEMANAN,3173061002,2020-10-12,1007,107,900,12,-3,15
DKI JAKARTA,JAKARTA BARAT,KALI DERES,SEMANAN,3173061002,2020-10-13,1013,104,909,6,-3,9
DKI JAKARTA,JAKARTA BARAT,KALI DERES,SEMANAN,3173061002,2020-10-14,1020,106,914,7,2,5
DKI JAKARTA,JAKARTA BARAT,KALI DERES,SEMANAN,3173061002,2020-10-15,1032,100,932,12,-6,18
DKI JAKARTA,JAKARTA BARAT,KALI DERES,SEMANAN,3173061002,2020-10-16,1058,99,959,26,-1,27
DKI JAKARTA,JAKARTA BARAT,KALI DERES,SEMANAN,3173061002,2020-10-17,1073,107,966,15,8,7
DKI JAKARTA,JAKARTA BARAT,KALI DERES,SEMANAN,3173061002,2020-10-18,1087,120,967,14,13,1
DKI JAKARTA,JAKARTA BARAT,KALI DERES,SEMANAN,3173061002,2020-10-19,1088,92,996,1,-28,29
DKI JAKARTA,JAKARTA BARAT,KALI DERES,SEMANAN,3173061002,2020-10-20,1101,77,1024,13,-15,28
DKI JAKARTA,JAKARTA BARAT,KALI DERES,SEMANAN,3173061002,2020-10-21,1103,75,1028,2,-2,4
DKI JAKARTA,JAKARTA BARAT,KALI DERES,SEMANAN,3173061002,2020-10-22,1107,72,1035,4,-3,7
DKI JAKARTA,JAKARTA BARAT,KALI DERES,SEMANAN,3173061002,2020-10-23,1114,78,1036,7,6,1
DKI JAKARTA,JAKARTA BARAT,KALI DERES,SEMANAN,3173061002,2020-10-24,1119,68,1051,5,-10,15
DKI JAKARTA,JAKARTA BARAT,KALI DERES,SEMANAN,3173061002,2020-10-25,1145,90,1055,26,22,4
DKI JAKARTA,JAKARTA BARAT,KALI DERES,SEMANAN,3173061002,2020-10-26,1151,82,1069,6,-8,14
DKI JAKARTA,JAKARTA BARAT,KALI DERES,SEMANAN,3173061002,2020-10-27,1156,80,1076,5,-2,7
DKI JAKARTA,JAKARTA BARAT,KALI DERES,SEMANAN,3173061002,2020-10-28,1158,77,1081,2,-3,5
DKI JAKARTA,JAKARTA BARAT,KALI DERES,SEMANAN,3173061002,2020-10-29,1191,91,1100,33,14,19
DKI JAKARTA,JAKARTA BARAT,KALI DERES,SEMANAN,3173061002,2020-10-30,1226,114,1112,35,23,12
DKI JAKARTA,JAKARTA BARAT,KALI DERES,SEMANAN,3173061002,2020-10-31,1239,125,1114,13,11,2
DKI JAKARTA,JAKARTA BARAT,KALI DERES,TEGAL ALUR,3173061003,2020-10-01,1044,121,923,0,0,0
DKI JAKARTA,JAKARTA BARAT,KALI DERES,TEGAL ALUR,3173061003,2020-10-02,1066,123,943,22,2,20
DKI JAKARTA,JAKARTA BARAT,KALI DERES,TEGAL ALUR,3173061003,2020-10-03,1070,126,944,4,3,1
DKI JAKARTA,JAKARTA BARAT,KALI DERES,TEGAL ALUR,3173061003,2020-10-04,1081,133,948,11,7,4
DKI JAKARTA,JAKARTA BARAT,KALI DERES,TEGAL ALUR,3173061003,2020-10-05,1084,110,974,3,-23,26
DKI JAKARTA,JAKARTA BARAT,KALI DERES,TEGAL ALUR,3173061003,2020-10-06,1088,102,986,4,-8,12
DKI JAKARTA,JAKARTA BARAT,KALI DERES,TEGAL ALUR,3173061003,2020-10-07,1106,117,989,18,15,3
DKI JAKARTA,JAKARTA BARAT,KALI DERES,TEGAL ALUR,3173061003,2020-10-08,1124,108,1016,18,-9,27
DKI JAKARTA,JAKARTA BARAT,KALI DERES,TEGAL ALUR,3173061003,2020-10-09,1137,120,1017,13,12,1
DKI JAKARTA,JAKARTA BARAT,KALI DERES,TEGAL ALUR,3173061003,2020-10-10,1141,105,1036,4,-15,19
DKI JAKARTA,JAKARTA BARAT,KALI DERES,TEGAL ALUR,3173061003,2020-10-11,1147,106,1041,6,1,5
DKI JAKARTA,JAKARTA BARAT,KALI DERES,TEGAL ALUR,3173061003,2020-10-12,1160,96,1064,13,-10,23
DKI JAKARTA,JAKARTA BARAT,KALI DERES,TEGAL ALUR,3173061003,2020-10-13,1164,86,1078,4,-10,14
DKI JAKARTA,JAKARTA BARAT,KALI DERES,TEGAL ALUR,3173061003,2020-10-14,1174,91,1083,10,5,5
DKI JAKARTA,JAKARTA BARAT,KALI DERES,TEGAL ALUR,3173061003,2020-10-15,1191,100,1091,17,9,8
DKI JAKARTA,JAKARTA BARAT,KALI DERES,TEGAL ALUR,3173061003,2020-10-16,1200,96,1104,9,-4,13
DKI JAKARTA,JAKARTA BARAT,KALI DERES,TEGAL ALUR,3173061003,2020-10-17,1216,108,1108,16,12,4
DKI JAKARTA,JAKARTA BARAT,KALI DERES,TEGAL ALUR,3173061003,2020-10-18,1226,117,1109,10,9,1
DKI JAKARTA,JAKARTA BARAT,KALI DERES,TEGAL ALUR,3173061003,2020-10-19,1228,100,1128,2,-17,19
DKI JAKARTA,JAKARTA BARAT,KALI DERES,TEGAL ALUR,3173061003,2020-10-20,1234,85,1149,6,-15,21
DKI JAKARTA,JAKARTA BARAT,KALI DERES,TEGAL ALUR,3173061003,2020-10-21,1236,86,1150,2,1,1
DKI JAKARTA,JAKARTA BARAT,KALI DERES,TEGAL ALUR,3173061003,2020-10-22,1239,78,1161,3,-8,11
DKI JAKARTA,JAKARTA BARAT,KALI DERES,TEGAL ALUR,3173061003,2020-10-23,1241,80,1161,2,2,0
DKI JAKARTA,JAKARTA BARAT,KALI DERES,TEGAL ALUR,3173061003,2020-10-24,1244,62,1182,3,-18,21
DKI JAKARTA,JAKARTA BARAT,KALI DERES,TEGAL ALUR,3173061003,2020-10-25,1252,68,1184,8,6,2
DKI JAKARTA,JAKARTA BARAT,KALI DERES,TEGAL ALUR,3173061003,2020-10-26,1263,75,1188,11,7,4
DKI JAKARTA,JAKARTA BARAT,KALI DERES,TEGAL ALUR,3173061003,2020-10-27,1275,69,1206,12,-6,18
DKI JAKARTA,JAKARTA BARAT,KALI DERES,TEGAL ALUR,3173061003,2020-10-28,1275,61,1214,0,-8,8
DKI JAKARTA,JAKARTA BARAT,KALI DERES,TEGAL ALUR,3173061003,2020-10-29,1284,47,1237,9,-14,23
DKI JAKARTA,JAKARTA BARAT,KALI DERES,TEGAL ALUR,3173061003,2020-10-30,1297,58,1239,13,11,2
DKI JAKARTA,JAKARTA BARAT,KALI DERES,TEGAL ALUR,3173061003,2020-10-31,1303,64,1239,6,6,0
DKI JAKARTA,JAKARTA BARAT,KEBON JERUK,DURI KEPA,3173051005,2020-10-01,1023,88,935,0,0,0
DKI JAKARTA,JAKARTA BARAT,KEBON JERUK,DURI KEPA,3173051005,2020-10-02,1045,80,965,22,-8,30
DKI JAKARTA,JAKARTA BARAT,KEBON JERUK,DURI KEPA,3173051005,2020-10-03,1052,80,972,7,0,7
DKI JAKARTA,JAKARTA BARAT,KEBON JERUK,DURI KEPA,3173051005,2020-10-04,1059,84,975,7,4,3
DKI JAKARTA,JAKARTA BARAT,KEBON JERUK,DURI KEPA,3173051005,2020-10-05,1065,82,983,6,-2,8
DKI JAKARTA,JAKARTA BARAT,KEBON JERUK,DURI KEPA,3173051005,2020-10-06,1073,75,998,8,-7,15
DKI JAKARTA,JAKARTA BARAT,KEBON JERUK,DURI KEPA,3173051005,2020-10-07,1106,95,1011,33,20,13
DKI JAKARTA,JAKARTA BARAT,KEBON JERUK,DURI KEPA,3173051005,2020-10-08,1126,88,1038,20,-7,27
DKI JAKARTA,JAKARTA BARAT,KEBON JERUK,DURI KEPA,3173051005,2020-10-09,1137,99,1038,11,11,0
DKI JAKARTA,JAKARTA BARAT,KEBON JERUK,DURI KEPA,3173051005,2020-10-10,1151,95,1056,14,-4,18
DKI JAKARTA,JAKARTA BARAT,KEBON JERUK,DURI KEPA,3173051005,2020-10-11,1152,94,1058,1,-1,2
DKI JAKARTA,JAKARTA BARAT,KEBON JERUK,DURI KEPA,3173051005,2020-10-12,1169,99,1070,17,5,12
DKI JAKARTA,JAKARTA BARAT,KEBON JERUK,DURI KEPA,3173051005,2020-10-13,1176,93,1083,7,-6,13
DKI JAKARTA,JAKARTA BARAT,KEBON JERUK,DURI KEPA,3173051005,2020-10-14,1186,91,1095,10,-2,12
DKI JAKARTA,JAKARTA BARAT,KEBON JERUK,DURI KEPA,3173051005,2020-10-15,1204,99,1105,18,8,10
DKI JAKARTA,JAKARTA BARAT,KEBON JERUK,DURI KEPA,3173051005,2020-10-16,1229,114,1115,25,15,10
DKI JAKARTA,JAKARTA BARAT,KEBON JERUK,DURI KEPA,3173051005,2020-10-17,1249,112,1137,20,-2,22
DKI JAKARTA,JAKARTA BARAT,KEBON JERUK,DURI KEPA,3173051005,2020-10-18,1263,118,1145,14,6,8
DKI JAKARTA,JAKARTA BARAT,KEBON JERUK,DURI KEPA,3173051005,2020-10-19,1271,119,1152,8,1,7
DKI JAKARTA,JAKARTA BARAT,KEBON JERUK,DURI KEPA,3173051005,2020-10-20,1284,112,1172,13,-7,20
DKI JAKARTA,JAKARTA BARAT,KEBON JERUK,DURI KEPA,3173051005,2020-10-21,1287,111,1176,3,-1,4
DKI JAKARTA,JAKARTA BARAT,KEBON JERUK,DURI KEPA,3173051005,2020-10-22,1289,90,1199,2,-21,23
DKI JAKARTA,JAKARTA BARAT,KEBON JERUK,DURI KEPA,3173051005,2020-10-23,1291,91,1200,2,1,1
DKI JAKARTA,JAKARTA BARAT,KEBON JERUK,DURI KEPA,3173051005,2020-10-24,1292,78,1214,1,-13,14
DKI JAKARTA,JAKARTA BARAT,KEBON JERUK,DURI KEPA,3173051005,2020-10-25,1300,79,1221,8,1,7
DKI JAKARTA,JAKARTA BARAT,KEBON JERUK,DURI KEPA,3173051005,2020-10-26,1301,73,1228,1,-6,7
DKI JAKARTA,JAKARTA BARAT,KEBON JERUK,DURI KEPA,3173051005,2020-10-27,1308,64,1244,7,-9,16
DKI JAKARTA,JAKARTA BARAT,KEBON JERUK,DURI KEPA,3173051005,2020-10-28,1312,54,1258,4,-10,14
DKI JAKARTA,JAKARTA BARAT,KEBON JERUK,DURI KEPA,3173051005,2020-10-29,1321,35,1287,9,-19,29
DKI JAKARTA,JAKARTA BARAT,KEBON JERUK,DURI KEPA,3173051005,2020-10-30,1339,51,1289,18,16,2
DKI JAKARTA,JAKARTA BARAT,KEBON JERUK,DURI KEPA,3173051005,2020-10-31,1349,54,1296,10,3,7
DKI JAKARTA,JAKARTA BARAT,KEBON JERUK,KEBON JERUK,3173051001,2020-10-01,1504,156,1348,0,0,0
DKI JAKARTA,JAKARTA BARAT,KEBON JERUK,KEBON JERUK,3173051001,2020-10-02,1552,162,1390,48,6,42
DKI JAKARTA,JAKARTA BARAT,KEBON JERUK,KEBON JERUK,3173051001,2020-10-03,1567,161,1406,15,-1,16
DKI JAKARTA,JAKARTA BARAT,KEBON JERUK,KEBON JERUK,3173051001,2020-10-04,1575,164,1411,8,3,5
DKI JAKARTA,JAKARTA BARAT,KEBON JERUK,KEBON JERUK,3173051001,2020-10-05,1582,159,1423,7,-5,12
DKI JAKARTA,JAKARTA BARAT,KEBON JERUK,KEBON JERUK,3173051001,2020-10-06,1595,147,1448,13,-12,25
DKI JAKARTA,JAKARTA BARAT,KEBON JERUK,KEBON JERUK,3173051001,2020-10-07,1631,169,1462,36,22,14
DKI JAKARTA,JAKARTA BARAT,KEBON JERUK,KEBON JERUK,3173051001,2020-10-08,1658,166,1492,27,-3,30
DKI JAKARTA,JAKARTA BARAT,KEBON JERUK,KEBON JERUK,3173051001,2020-10-09,1682,189,1493,24,23,1
DKI JAKARTA,JAKARTA BARAT,KEBON JERUK,KEBON JERUK,3173051001,2020-10-10,1699,185,1514,17,-4,21
DKI JAKARTA,JAKARTA BARAT,KEBON JERUK,KEBON JERUK,3173051001,2020-10-11,1717,182,1535,18,-3,21
DKI JAKARTA,JAKARTA BARAT,KEBON JERUK,KEBON JERUK,3173051001,2020-10-12,1734,181,1553,17,-1,18
DKI JAKARTA,JAKARTA BARAT,KEBON JERUK,KEBON JERUK,3173051001,2020-10-13,1748,145,1603,14,-36,50
DKI JAKARTA,JAKARTA BARAT,KEBON JERUK,KEBON JERUK,3173051001,2020-10-14,1755,138,1617,7,-7,14
DKI JAKARTA,JAKARTA BARAT,KEBON JERUK,KEBON JERUK,3173051001,2020-10-15,1792,142,1650,37,4,33
DKI JAKARTA,JAKARTA BARAT,KEBON JERUK,KEBON JERUK,3173051001,2020-10-16,1817,158,1659,25,16,9
DKI JAKARTA,JAKARTA BARAT,KEBON JERUK,KEBON JERUK,3173051001,2020-10-17,1851,169,1682,34,11,23
DKI JAKARTA,JAKARTA BARAT,KEBON JERUK,KEBON JERUK,3173051001,2020-10-18,1862,176,1686,11,7,4
DKI JAKARTA,JAKARTA BARAT,KEBON JERUK,KEBON JERUK,3173051001,2020-10-19,1868,160,1708,6,-16,22
DKI JAKARTA,JAKARTA BARAT,KEBON JERUK,KEBON JERUK,3173051001,2020-10-20,1901,150,1751,33,-10,43
DKI JAKARTA,JAKARTA BARAT,KEBON JERUK,KEBON JERUK,3173051001,2020-10-21,1916,143,1773,15,-7,22
DKI JAKARTA,JAKARTA BARAT,KEBON JERUK,KEBON JERUK,3173051001,2020-10-22,1918,115,1803,2,-28,30
DKI JAKARTA,JAKARTA BARAT,KEBON JERUK,KEBON JERUK,3173051001,2020-10-23,1930,125,1805,12,10,2
DKI JAKARTA,JAKARTA BARAT,KEBON JERUK,KEBON JERUK,3173051001,2020-10-24,1978,157,1821,48,32,16
DKI JAKARTA,JAKARTA BARAT,KEBON JERUK,KEBON JERUK,3173051001,2020-10-25,2020,190,1830,42,33,9
DKI JAKARTA,JAKARTA BARAT,KEBON JERUK,KEBON JERUK,3173051001,2020-10-26,2023,179,1844,3,-11,14
DKI JAKARTA,JAKARTA BARAT,KEBON JERUK,KEBON JERUK,3173051001,2020-10-27,2043,164,1879,20,-15,35
DKI JAKARTA,JAKARTA BARAT,KEBON JERUK,KEBON JERUK,3173051001,2020-10-28,2046,156,1890,3,-8,11
DKI JAKARTA,JAKARTA BARAT,KEBON JERUK,KEBON JERUK,3173051001,2020-10-29,2054,136,1918,8,-20,28
DKI JAKARTA,JAKARTA BARAT,KEBON JERUK,KEBON JERUK,3173051001,2020-10-30,2072,147,1925,18,11,7
DKI JAKARTA,JAKARTA BARAT,KEBON JERUK,KEBON JERUK,3173051001,2020-10-31,2081,154,1927,9,7,2
DKI JAKARTA,JAKARTA BARAT,KEBON JERUK,KEDOYA SELATAN,3173051007,2020-10-01,507,53,454,0,0,0
DKI JAKARTA,JAKARTA BARAT,KEBON JERUK,KEDOYA SELATAN,3173051007,2020-10-02,531,59,472,24,6,18
DKI JAKARTA,JAKARTA BARAT,KEBON JERUK,KEDOYA SELATAN,3173051007,2020-10-03,540,61,479,9,2,7
DKI JAKARTA,JAKARTA BARAT,KEBON JERUK,KEDOYA SELATAN,3173051007,2020-10-04,544,63,481,4,2,2
DKI JAKARTA,JAKARTA BARAT,KEBON JERUK,KEDOYA SELATAN,3173051007,2020-10-05,558,65,493,14,2,12
DKI JAKARTA,JAKARTA BARAT,KEBON JERUK,KEDOYA SELATAN,3173051007,2020-10-06,575,79,496,17,14,3
DKI JAKARTA,JAKARTA BARAT,KEBON JERUK,KEDOYA SELATAN,3173051007,2020-10-07,586,86,500,11,7,4
DKI JAKARTA,JAKARTA BARAT,KEBON JERUK,KEDOYA SELATAN,3173051007,2020-10-08,599,91,508,13,5,8
DKI JAKARTA,JAKARTA BARAT,KEBON JERUK,KEDOYA SELATAN,3173051007,2020-10-09,603,94,509,4,3,1
DKI JAKARTA,JAKARTA BARAT,KEBON JERUK,KEDOYA SELATAN,3173051007,2020-10-10,609,88,521,6,-6,12
DKI JAKARTA,JAKARTA BARAT,KEBON JERUK,KEDOYA SELATAN,3173051007,2020-10-11,613,92,521,4,4,0
DKI JAKARTA,JAKARTA BARAT,KEBON JERUK,KEDOYA SELATAN,3173051007,2020-10-12,620,78,542,7,-14,21
DKI JAKARTA,JAKARTA BARAT,KEBON JERUK,KEDOYA SELATAN,3173051007,2020-10-13,625,78,547,5,0,5
DKI JAKARTA,JAKARTA BARAT,KEBON JERUK,KEDOYA SELATAN,3173051007,2020-10-14,628,46,582,3,-32,35
DKI JAKARTA,JAKARTA BARAT,KEBON JERUK,KEDOYA SELATAN,3173051007,2020-10-15,647,56,591,19,10,9
DKI JAKARTA,JAKARTA BARAT,KEBON JERUK,KEDOYA SELATAN,3173051007,2020-10-16,658,57,601,11,1,10
DKI JAKARTA,JAKARTA BARAT,KEBON JERUK,KEDOYA SELATAN,3173051007,2020-10-17,667,66,601,9,9,0
DKI JAKARTA,JAKARTA BARAT,KEBON JERUK,KEDOYA SELATAN,3173051007,2020-10-18,674,70,604,7,4,3
DKI JAKARTA,JAKARTA BARAT,KEBON JERUK,KEDOYA SELATAN,3173051007,2020-10-19,676,64,612,2,-6,8
DKI JAKARTA,JAKARTA BARAT,KEBON JERUK,KEDOYA SELATAN,3173051007,2020-10-20,681,62,619,5,-2,7
DKI JAKARTA,JAKARTA BARAT,KEBON JERUK,KEDOYA SELATAN,3173051007,2020-10-21,684,58,626,3,-4,7
DKI JAKARTA,JAKARTA BARAT,KEBON JERUK,KEDOYA SELATAN,3173051007,2020-10-22,684,51,633,0,-7,7
DKI JAKARTA,JAKARTA BARAT,KEBON JERUK,KEDOYA SELATAN,3173051007,2020-10-23,687,53,634,3,2,1
DKI JAKARTA,JAKARTA BARAT,KEBON JERUK,KEDOYA SELATAN,3173051007,2020-10-24,690,46,644,3,-7,10
DKI JAKARTA,JAKARTA BARAT,KEBON JERUK,KEDOYA SELATAN,3173051007,2020-10-25,701,53,648,11,7,4
DKI JAKARTA,JAKARTA BARAT,KEBON JERUK,KEDOYA SELATAN,3173051007,2020-10-26,703,36,667,2,-17,19
DKI JAKARTA,JAKARTA BARAT,KEBON JERUK,KEDOYA SELATAN,3173051007,2020-10-27,712,40,672,9,4,5
DKI JAKARTA,JAKARTA BARAT,KEBON JERUK,KEDOYA SELATAN,3173051007,2020-10-28,725,43,682,13,3,10
DKI JAKARTA,JAKARTA BARAT,KEBON JERUK,KEDOYA SELATAN,3173051007,2020-10-29,732,42,691,7,-1,9
DKI JAKARTA,JAKARTA BARAT,KEBON JERUK,KEDOYA SELATAN,3173051007,2020-10-30,732,40,693,0,-2,2
DKI JAKARTA,JAKARTA BARAT,KEBON JERUK,KEDOYA SELATAN,3173051007,2020-10-31,772,47,726,40,7,33
DKI JAKARTA,JAKARTA BARAT,KEBON JERUK,KEDOYA UTARA,3173051006,2020-10-01,691,73,618,0,0,0
DKI JAKARTA,JAKARTA BARAT,KEBON JERUK,KEDOYA UTARA,3173051006,2020-10-02,722,94,628,31,21,10
DKI JAKARTA,JAKARTA BARAT,KEBON JERUK,KEDOYA UTARA,3173051006,2020-10-03,726,94,632,4,0,4
DKI JAKARTA,JAKARTA BARAT,KEBON JERUK,KEDOYA UTARA,3173051006,2020-10-04,733,99,634,7,5,2
DKI JAKARTA,JAKARTA BARAT,KEBON JERUK,KEDOYA UTARA,3173051006,2020-10-05,740,96,644,7,-3,10
DKI JAKARTA,JAKARTA BARAT,KEBON JERUK,KEDOYA UTARA,3173051006,2020-10-06,744,91,653,4,-5,9
DKI JAKARTA,JAKARTA BARAT,KEBON JERUK,KEDOYA UTARA,3173051006,2020-10-07,764,103,661,20,12,8
DKI JAKARTA,JAKARTA BARAT,KEBON JERUK,KEDOYA UTARA,3173051006,2020-10-08,771,84,687,7,-19,26
DKI JAKARTA,JAKARTA BARAT,KEBON JERUK,KEDOYA UTARA,3173051006,2020-10-09,776,89,687,5,5,0
DKI JAKARTA,JAKARTA BARAT,KEBON JERUK,KEDOYA UTARA,3173051006,2020-10-10,783,90,693,7,1,6
DKI JAKARTA,JAKARTA BARAT,KEBON JERUK,KEDOYA UTARA,3173051006,2020-10-11,786,78,708,3,-12,15
DKI JAKARTA,JAKARTA BARAT,KEBON JERUK,KEDOYA UTARA,3173051006,2020-10-12,810,85,725,24,7,17
DKI JAKARTA,JAKARTA BARAT,KEBON JERUK,KEDOYA UTARA,3173051006,2020-10-13,812,69,743,2,-16,18
DKI JAKARTA,JAKARTA BARAT,KEBON JERUK,KEDOYA UTARA,3173051006,2020-10-14,819,69,750,7,0,7
DKI JAKARTA,JAKARTA BARAT,KEBON JERUK,KEDOYA UTARA,3173051006,2020-10-15,831,71,760,12,2,10
DKI JAKARTA,JAKARTA BARAT,KEBON JERUK,KEDOYA UTARA,3173051006,2020-10-16,844,71,773,13,0,13
DKI JAKARTA,JAKARTA BARAT,KEBON JERUK,KEDOYA UTARA,3173051006,2020-10-17,872,92,780,28,21,7
DKI JAKARTA,JAKARTA BARAT,KEBON JERUK,KEDOYA UTARA,3173051006,2020-10-18,885,99,786,13,7,6
DKI JAKARTA,JAKARTA BARAT,KEBON JERUK,KEDOYA UTARA,3173051006,2020-10-19,891,101,790,6,2,4
DKI JAKARTA,JAKARTA BARAT,KEBON JERUK,KEDOYA UTARA,3173051006,2020-10-20,911,109,802,20,8,12
DKI JAKARTA,JAKARTA BARAT,KEBON JERUK,KEDOYA UTARA,3173051006,2020-10-21,915,104,811,4,-5,9
DKI JAKARTA,JAKARTA BARAT,KEBON JERUK,KEDOYA UTARA,3173051006,2020-10-22,921,89,832,6,-15,21
DKI JAKARTA,JAKARTA BARAT,KEBON JERUK,KEDOYA UTARA,3173051006,2020-10-23,928,94,834,7,5,2
DKI JAKARTA,JAKARTA BARAT,KEBON JERUK,KEDOYA UTARA,3173051006,2020-10-24,931,87,844,3,-7,10
DKI JAKARTA,JAKARTA BARAT,KEBON JERUK,KEDOYA UTARA,3173051006,2020-10-25,941,85,856,10,-2,12
DKI JAKARTA,JAKARTA BARAT,KEBON JERUK,KEDOYA UTARA,3173051006,2020-10-26,942,78,864,1,-7,8
DKI JAKARTA,JAKARTA BARAT,KEBON JERUK,KEDOYA UTARA,3173051006,2020-10-27,949,62,887,7,-16,23
DKI JAKARTA,JAKARTA BARAT,KEBON JERUK,KEDOYA UTARA,3173051006,2020-10-28,951,55,896,2,-7,9
DKI JAKARTA,JAKARTA BARAT,KEBON JERUK,KEDOYA UTARA,3173051006,2020-10-29,956,30,926,5,-25,30
DKI JAKARTA,JAKARTA BARAT,KEBON JERUK,KEDOYA UTARA,3173051006,2020-10-30,966,37,929,10,7,3
DKI JAKARTA,JAKARTA BARAT,KEBON JERUK,KEDOYA UTARA,3173051006,2020-10-31,973,42,931,7,5,2
DKI JAKARTA,JAKARTA BARAT,KEBON JERUK,KELAPA DUA,3173051004,2020-10-01,458,69,389,0,0,0
DKI JAKARTA,JAKARTA BARAT,KEBON JERUK,KELAPA DUA,3173051004,2020-10-02,480,84,396,22,15,7
DKI JAKARTA,JAKARTA BARAT,KEBON JERUK,KELAPA DUA,3173051004,2020-10-03,473,76,397,-7,-8,1
DKI JAKARTA,JAKARTA BARAT,KEBON JERUK,KELAPA DUA,3173051004,2020-10-04,491,85,406,18,9,9
DKI JAKARTA,JAKARTA BARAT,KEBON JERUK,KELAPA DUA,3173051004,2020-10-05,495,80,415,4,-5,9
DKI JAKARTA,JAKARTA BARAT,KEBON JERUK,KELAPA DUA,3173051004,2020-10-06,503,86,417,8,6,2
DKI JAKARTA,JAKARTA BARAT,KEBON JERUK,KELAPA DUA,3173051004,2020-10-07,516,81,435,13,-5,18
DKI JAKARTA,JAKARTA BARAT,KEBON JERUK,KELAPA DUA,3173051004,2020-10-08,529,85,444,13,4,9
DKI JAKARTA,JAKARTA BARAT,KEBON JERUK,KELAPA DUA,3173051004,2020-10-09,534,88,446,5,3,2
DKI JAKARTA,JAKARTA BARAT,KEBON JERUK,KELAPA DUA,3173051004,2020-10-10,539,70,469,5,-18,23
DKI JAKARTA,JAKARTA BARAT,KEBON JERUK,KELAPA DUA,3173051004,2020-10-11,554,81,473,15,11,4
DKI JAKARTA,JAKARTA BARAT,KEBON JERUK,KELAPA DUA,3173051004,2020-10-12,563,69,494,9,-12,21
DKI JAKARTA,JAKARTA BARAT,KEBON JERUK,KELAPA DUA,3173051004,2020-10-13,580,81,499,17,12,5
DKI JAKARTA,JAKARTA BARAT,KEBON JERUK,KELAPA DUA,3173051004,2020-10-14,608,97,511,28,16,12
DKI JAKARTA,JAKARTA BARAT,KEBON JERUK,KELAPA DUA,3173051004,2020-10-15,618,103,515,10,6,4
DKI JAKARTA,JAKARTA BARAT,KEBON JERUK,KELAPA DUA,3173051004,2020-10-16,630,106,524,12,3,9
DKI JAKARTA,JAKARTA BARAT,KEBON JERUK,KELAPA DUA,3173051004,2020-10-17,644,111,533,14,5,9
DKI JAKARTA,JAKARTA BARAT,KEBON JERUK,KELAPA DUA,3173051004,2020-10-18,652,119,533,8,8,0
DKI JAKARTA,JAKARTA BARAT,KEBON JERUK,KELAPA DUA,3173051004,2020-10-19,657,114,543,5,-5,10
DKI JAKARTA,JAKARTA BARAT,KEBON JERUK,KELAPA DUA,3173051004,2020-10-20,663,116,547,6,2,4
DKI JAKARTA,JAKARTA BARAT,KEBON JERUK,KELAPA DUA,3173051004,2020-10-21,666,104,562,3,-12,15
DKI JAKARTA,JAKARTA BARAT,KEBON JERUK,KELAPA DUA,3173051004,2020-10-22,667,89,578,1,-15,16
DKI JAKARTA,JAKARTA BARAT,KEBON JERUK,KELAPA DUA,3173051004,2020-10-23,681,103,578,14,14,0
DKI JAKARTA,JAKARTA BARAT,KEBON JERUK,KELAPA DUA,3173051004,2020-10-24,685,70,615,4,-33,37
DKI JAKARTA,JAKARTA BARAT,KEBON JERUK,KELAPA DUA,3173051004,2020-10-25,689,58,631,4,-12,16
DKI JAKARTA,JAKARTA BARAT,KEBON JERUK,KELAPA DUA,3173051004,2020-10-26,691,52,639,2,-6,8
DKI JAKARTA,JAKARTA BARAT,KEBON JERUK,KELAPA DUA,3173051004,2020-10-27,706,52,654,15,0,15
DKI JAKARTA,JAKARTA BARAT,KEBON JERUK,KELAPA DUA,3173051004,2020-10-28,710,41,669,4,-11,15
DKI JAKARTA,JAKARTA BARAT,KEBON JERUK,KELAPA DUA,3173051004,2020-10-29,718,44,674,8,3,5
DKI JAKARTA,JAKARTA BARAT,KEBON JERUK,KELAPA DUA,3173051004,2020-10-30,724,47,677,6,3,3
DKI JAKARTA,JAKARTA BARAT,KEBON JERUK,KELAPA DUA,3173051004,2020-10-31,731,53,678,7,6,1
DKI JAKARTA,JAKARTA BARAT,KEBON JERUK,SUKABUMI SELATAN,3173051003,2020-10-01,538,61,477,0,0,0
DKI JAKARTA,JAKARTA BARAT,KEBON JERUK,SUKABUMI SELATAN,3173051003,2020-10-02,556,72,484,18,11,7
DKI JAKARTA,JAKARTA BARAT,KEBON JERUK,SUKABUMI SELATAN,3173051003,2020-10-03,559,74,485,3,2,1
DKI JAKARTA,JAKARTA BARAT,KEBON JERUK,SUKABUMI SELATAN,3173051003,2020-10-04,561,74,487,2,0,2
DKI JAKARTA,JAKARTA BARAT,KEBON JERUK,SUKABUMI SELATAN,3173051003,2020-10-05,571,70,501,10,-4,14
DKI JAKARTA,JAKARTA BARAT,KEBON JERUK,SUKABUMI SELATAN,3173051003,2020-10-06,583,79,504,12,9,3
DKI JAKARTA,JAKARTA BARAT,KEBON JERUK,SUKABUMI SELATAN,3173051003,2020-10-07,605,91,514,22,12,10
DKI JAKARTA,JAKARTA BARAT,KEBON JERUK,SUKABUMI SELATAN,3173051003,2020-10-08,619,98,521,14,7,7
DKI JAKARTA,JAKARTA BARAT,KEBON JERUK,SUKABUMI SELATAN,3173051003,2020-10-09,624,102,522,5,4,1
DKI JAKARTA,JAKARTA BARAT,KEBON JERUK,SUKABUMI SELATAN,3173051003,2020-10-10,630,96,534,6,-6,12
DKI JAKARTA,JAKARTA BARAT,KEBON JERUK,SUKABUMI SELATAN,3173051003,2020-10-11,636,100,536,6,4,2
DKI JAKARTA,JAKARTA BARAT,KEBON JERUK,SUKABUMI SELATAN,3173051003,2020-10-12,640,81,559,4,-19,23
DKI JAKARTA,JAKARTA BARAT,KEBON JERUK,SUKABUMI SELATAN,3173051003,2020-10-13,644,82,562,4,1,3
DKI JAKARTA,JAKARTA BARAT,KEBON JERUK,SUKABUMI SELATAN,3173051003,2020-10-14,647,55,592,3,-27,30
DKI JAKARTA,JAKARTA BARAT,KEBON JERUK,SUKABUMI SELATAN,3173051003,2020-10-15,656,57,599,9,2,7
DKI JAKARTA,JAKARTA BARAT,KEBON JERUK,SUKABUMI SELATAN,3173051003,2020-10-16,663,54,609,7,-3,10
DKI JAKARTA,JAKARTA BARAT,KEBON JERUK,SUKABUMI SELATAN,3173051003,2020-10-17,673,58,615,10,4,6
DKI JAKARTA,JAKARTA BARAT,KEBON JERUK,SUKABUMI SELATAN,3173051003,2020-10-18,676,58,618,3,0,3
DKI JAKARTA,JAKARTA BARAT,KEBON JERUK,SUKABUMI SELATAN,3173051003,2020-10-19,678,52,626,2,-6,8
DKI JAKARTA,JAKARTA BARAT,KEBON JERUK,SUKABUMI SELATAN,3173051003,2020-10-20,691,61,630,13,9,4
DKI JAKARTA,JAKARTA BARAT,KEBON JERUK,SUKABUMI SELATAN,3173051003,2020-10-21,699,59,640,8,-2,10
DKI JAKARTA,JAKARTA BARAT,KEBON JERUK,SUKABUMI SELATAN,3173051003,2020-10-22,712,67,645,13,8,5
DKI JAKARTA,JAKARTA BARAT,KEBON JERUK,SUKABUMI SELATAN,3173051003,2020-10-23,713,68,645,1,1,0
DKI JAKARTA,JAKARTA BARAT,KEBON JERUK,SUKABUMI SELATAN,3173051003,2020-10-24,714,60,654,1,-8,9
DKI JAKARTA,JAKARTA BARAT,KEBON JERUK,SUKABUMI SELATAN,3173051003,2020-10-25,718,61,657,4,1,3
DKI JAKARTA,JAKARTA BARAT,KEBON JERUK,SUKABUMI SELATAN,3173051003,2020-10-26,721,45,676,3,-16,19
DKI JAKARTA,JAKARTA BARAT,KEBON JERUK,SUKABUMI SELATAN,3173051003,2020-10-27,731,48,683,10,3,7
DKI JAKARTA,JAKARTA BARAT,KEBON JERUK,SUKABUMI SELATAN,3173051003,2020-10-28,740,52,688,9,4,5
DKI JAKARTA,JAKARTA BARAT,KEBON JERUK,SUKABUMI SELATAN,3173051003,2020-10-29,742,50,693,2,-2,5
DKI JAKARTA,JAKARTA BARAT,KEBON JERUK,SUKABUMI SELATAN,3173051003,2020-10-30,761,57,705,19,7,12
DKI JAKARTA,JAKARTA BARAT,KEBON JERUK,SUKABUMI SELATAN,3173051003,2020-10-31,767,63,705,6,6,0
DKI JAKARTA,JAKARTA BARAT,KEBON JERUK,SUKABUMI UTARA,3173051002,2020-10-01,549,64,485,0,0,0
DKI JAKARTA,JAKARTA BARAT,KEBON JERUK,SUKABUMI UTARA,3173051002,2020-10-02,573,83,490,24,19,5
DKI JAKARTA,JAKARTA BARAT,KEBON JERUK,SUKABUMI UTARA,3173051002,2020-10-03,586,90,496,13,7,6
DKI JAKARTA,JAKARTA BARAT,KEBON JERUK,SUKABUMI UTARA,3173051002,2020-10-04,592,94,498,6,4,2
DKI JAKARTA,JAKARTA BARAT,KEBON JERUK,SUKABUMI UTARA,3173051002,2020-10-05,603,85,518,11,-9,20
DKI JAKARTA,JAKARTA BARAT,KEBON JERUK,SUKABUMI UTARA,3173051002,2020-10-06,614,93,521,11,8,3
DKI JAKARTA,JAKARTA BARAT,KEBON JERUK,SUKABUMI UTARA,3173051002,2020-10-07,631,95,536,17,2,15
DKI JAKARTA,JAKARTA BARAT,KEBON JERUK,SUKABUMI UTARA,3173051002,2020-10-08,647,106,541,16,11,5
DKI JAKARTA,JAKARTA BARAT,KEBON JERUK,SUKABUMI UTARA,3173051002,2020-10-09,651,109,542,4,3,1
DKI JAKARTA,JAKARTA BARAT,KEBON JERUK,SUKABUMI UTARA,3173051002,2020-10-10,655,97,558,4,-12,16
DKI JAKARTA,JAKARTA BARAT,KEBON JERUK,SUKABUMI UTARA,3173051002,2020-10-11,671,108,563,16,11,5
DKI JAKARTA,JAKARTA BARAT,KEBON JERUK,SUKABUMI UTARA,3173051002,2020-10-12,682,98,584,11,-10,21
DKI JAKARTA,JAKARTA BARAT,KEBON JERUK,SUKABUMI UTARA,3173051002,2020-10-13,685,93,592,3,-5,8
DKI JAKARTA,JAKARTA BARAT,KEBON JERUK,SUKABUMI UTARA,3173051002,2020-10-14,698,79,619,13,-14,27
DKI JAKARTA,JAKARTA BARAT,KEBON JERUK,SUKABUMI UTARA,3173051002,2020-10-15,710,79,631,12,0,12
DKI JAKARTA,JAKARTA BARAT,KEBON JERUK,SUKABUMI UTARA,3173051002,2020-10-16,724,82,642,14,3,11
DKI JAKARTA,JAKARTA BARAT,KEBON JERUK,SUKABUMI UTARA,3173051002,2020-10-17,737,93,644,13,11,2
DKI JAKARTA,JAKARTA BARAT,KEBON JERUK,SUKABUMI UTARA,3173051002,2020-10-18,742,96,646,5,3,2
DKI JAKARTA,JAKARTA BARAT,KEBON JERUK,SUKABUMI UTARA,3173051002,2020-10-19,743,83,660,1,-13,14
DKI JAKARTA,JAKARTA BARAT,KEBON JERUK,SUKABUMI UTARA,3173051002,2020-10-20,751,88,663,8,5,3
DKI JAKARTA,JAKARTA BARAT,KEBON JERUK,SUKABUMI UTARA,3173051002,2020-10-21,752,81,671,1,-7,8
DKI JAKARTA,JAKARTA BARAT,KEBON JERUK,SUKABUMI UTARA,3173051002,2020-10-22,763,83,680,11,2,9
DKI JAKARTA,JAKARTA BARAT,KEBON JERUK,SUKABUMI UTARA,3173051002,2020-10-23,774,94,680,11,11,0
DKI JAKARTA,JAKARTA BARAT,KEBON JERUK,SUKABUMI UTARA,3173051002,2020-10-24,780,60,720,6,-34,40
DKI JAKARTA,JAKARTA BARAT,KEBON JERUK,SUKABUMI UTARA,3173051002,2020-10-25,783,58,725,3,-2,5
DKI JAKARTA,JAKARTA BARAT,KEBON JERUK,SUKABUMI UTARA,3173051002,2020-10-26,783,49,734,0,-9,9
DKI JAKARTA,JAKARTA BARAT,KEBON JERUK,SUKABUMI UTARA,3173051002,2020-10-27,793,52,741,10,3,7
DKI JAKARTA,JAKARTA BARAT,KEBON JERUK,SUKABUMI UTARA,3173051002,2020-10-28,794,34,760,1,-18,19
DKI JAKARTA,JAKARTA BARAT,KEBON JERUK,SUKABUMI UTARA,3173051002,2020-10-29,795,24,771,1,-10,11
DKI JAKARTA,JAKARTA BARAT,KEBON JERUK,SUKABUMI UTARA,3173051002,2020-10-30,817,42,775,22,18,4
DKI JAKARTA,JAKARTA BARAT,KEBON JERUK,SUKABUMI UTARA,3173051002,2020-10-31,823,47,776,6,5,1
DKI JAKARTA,JAKARTA BARAT,KEMBANGAN,JOGLO,3173081005,2020-10-01,591,134,457,0,0,0
DKI JAKARTA,JAKARTA BARAT,KEMBANGAN,JOGLO,3173081005,2020-10-02,613,134,479,22,0,22
DKI JAKARTA,JAKARTA BARAT,KEMBANGAN,JOGLO,3173081005,2020-10-03,623,127,496,10,-7,17
DKI JAKARTA,JAKARTA BARAT,KEMBANGAN,JOGLO,3173081005,2020-10-04,626,129,497,3,2,1
DKI JAKARTA,JAKARTA BARAT,KEMBANGAN,JOGLO,3173081005,2020-10-05,627,122,505,1,-7,8
DKI JAKARTA,JAKARTA BARAT,KEMBANGAN,JOGLO,3173081005,2020-10-06,636,122,514,9,0,9
DKI JAKARTA,JAKARTA BARAT,KEMBANGAN,JOGLO,3173081005,2020-10-07,647,118,529,11,-4,15
DKI JAKARTA,JAKARTA BARAT,KEMBANGAN,JOGLO,3173081005,2020-10-08,668,92,576,21,-26,47
DKI JAKARTA,JAKARTA BARAT,KEMBANGAN,JOGLO,3173081005,2020-10-09,670,94,576,2,2,0
DKI JAKARTA,JAKARTA BARAT,KEMBANGAN,JOGLO,3173081005,2020-10-10,677,93,584,7,-1,8
DKI JAKARTA,JAKARTA BARAT,KEMBANGAN,JOGLO,3173081005,2020-10-11,687,100,587,10,7,3
DKI JAKARTA,JAKARTA BARAT,KEMBANGAN,JOGLO,3173081005,2020-10-12,694,97,597,7,-3,10
DKI JAKARTA,JAKARTA BARAT,KEMBANGAN,JOGLO,3173081005,2020-10-13,697,73,624,3,-24,27
DKI JAKARTA,JAKARTA BARAT,KEMBANGAN,JOGLO,3173081005,2020-10-14,707,73,634,10,0,10
DKI JAKARTA,JAKARTA BARAT,KEMBANGAN,JOGLO,3173081005,2020-10-15,713,68,645,6,-5,11
DKI JAKARTA,JAKARTA BARAT,KEMBANGAN,JOGLO,3173081005,2020-10-16,722,70,652,9,2,7
DKI JAKARTA,JAKARTA BARAT,KEMBANGAN,JOGLO,3173081005,2020-10-17,729,73,656,7,3,4
DKI JAKARTA,JAKARTA BARAT,KEMBANGAN,JOGLO,3173081005,2020-10-18,735,77,658,6,4,2
DKI JAKARTA,JAKARTA BARAT,KEMBANGAN,JOGLO,3173081005,2020-10-19,737,69,668,2,-8,10
DKI JAKARTA,JAKARTA BARAT,KEMBANGAN,JOGLO,3173081005,2020-10-20,743,61,682,6,-8,14
DKI JAKARTA,JAKARTA BARAT,KEMBANGAN,JOGLO,3173081005,2020-10-21,745,54,691,2,-7,9
DKI JAKARTA,JAKARTA BARAT,KEMBANGAN,JOGLO,3173081005,2020-10-22,746,53,693,1,-1,2
DKI JAKARTA,JAKARTA BARAT,KEMBANGAN,JOGLO,3173081005,2020-10-23,748,55,693,2,2,0
DKI JAKARTA,JAKARTA BARAT,KEMBANGAN,JOGLO,3173081005,2020-10-24,752,48,704,4,-7,11
DKI JAKARTA,JAKARTA BARAT,KEMBANGAN,JOGLO,3173081005,2020-10-25,761,50,711,9,2,7
DKI JAKARTA,JAKARTA BARAT,KEMBANGAN,JOGLO,3173081005,2020-10-26,763,47,716,2,-3,5
DKI JAKARTA,JAKARTA BARAT,KEMBANGAN,JOGLO,3173081005,2020-10-27,774,47,727,11,0,11
DKI JAKARTA,JAKARTA BARAT,KEMBANGAN,JOGLO,3173081005,2020-10-28,777,42,735,3,-5,8
DKI JAKARTA,JAKARTA BARAT,KEMBANGAN,JOGLO,3173081005,2020-10-29,781,38,743,4,-4,8
DKI JAKARTA,JAKARTA BARAT,KEMBANGAN,JOGLO,3173081005,2020-10-30,789,41,748,8,3,5
DKI JAKARTA,JAKARTA BARAT,KEMBANGAN,JOGLO,3173081005,2020-10-31,794,44,750,5,3,2
DKI JAKARTA,JAKARTA BARAT,KEMBANGAN,KEMBANGAN SELATAN,3173081006,2020-10-01,465,41,424,0,0,0
DKI JAKARTA,JAKARTA BARAT,KEMBANGAN,KEMBANGAN SELATAN,3173081006,2020-10-02,480,48,432,15,7,8
DKI JAKARTA,JAKARTA BARAT,KEMBANGAN,KEMBANGAN SELATAN,3173081006,2020-10-03,492,54,438,12,6,6
DKI JAKARTA,JAKARTA BARAT,KEMBANGAN,KEMBANGAN SELATAN,3173081006,2020-10-04,497,57,440,5,3,2
DKI JAKARTA,JAKARTA BARAT,KEMBANGAN,KEMBANGAN SELATAN,3173081006,2020-10-05,499,53,446,2,-4,6
DKI JAKARTA,JAKARTA BARAT,KEMBANGAN,KEMBANGAN SELATAN,3173081006,2020-10-06,503,44,459,4,-9,13
DKI JAKARTA,JAKARTA BARAT,KEMBANGAN,KEMBANGAN SELATAN,3173081006,2020-10-07,512,51,461,9,7,2
DKI JAKARTA,JAKARTA BARAT,KEMBANGAN,KEMBANGAN SELATAN,3173081006,2020-10-08,513,46,467,1,-5,6
DKI JAKARTA,JAKARTA BARAT,KEMBANGAN,KEMBANGAN SELATAN,3173081006,2020-10-09,516,48,468,3,2,1
DKI JAKARTA,JAKARTA BARAT,KEMBANGAN,KEMBANGAN SELATAN,3173081006,2020-10-10,521,49,472,5,1,4
DKI JAKARTA,JAKARTA BARAT,KEMBANGAN,KEMBANGAN SELATAN,3173081006,2020-10-11,541,62,479,20,13,7
DKI JAKARTA,JAKARTA BARAT,KEMBANGAN,KEMBANGAN SELATAN,3173081006,2020-10-12,545,53,492,4,-9,13
DKI JAKARTA,JAKARTA BARAT,KEMBANGAN,KEMBANGAN SELATAN,3173081006,2020-10-13,554,49,505,9,-4,13
DKI JAKARTA,JAKARTA BARAT,KEMBANGAN,KEMBANGAN SELATAN,3173081006,2020-10-14,565,54,511,11,5,6
DKI JAKARTA,JAKARTA BARAT,KEMBANGAN,KEMBANGAN SELATAN,3173081006,2020-10-15,570,51,519,5,-3,8
DKI JAKARTA,JAKARTA BARAT,KEMBANGAN,KEMBANGAN SELATAN,3173081006,2020-10-16,579,53,526,9,2,7
DKI JAKARTA,JAKARTA BARAT,KEMBANGAN,KEMBANGAN SELATAN,3173081006,2020-10-17,588,58,530,9,5,4
DKI JAKARTA,JAKARTA BARAT,KEMBANGAN,KEMBANGAN SELATAN,3173081006,2020-10-18,592,62,530,4,4,0
DKI JAKARTA,JAKARTA BARAT,KEMBANGAN,KEMBANGAN SELATAN,3173081006,2020-10-19,593,62,531,1,0,1
DKI JAKARTA,JAKARTA BARAT,KEMBANGAN,KEMBANGAN SELATAN,3173081006,2020-10-20,599,62,537,6,0,6
DKI JAKARTA,JAKARTA BARAT,KEMBANGAN,KEMBANGAN SELATAN,3173081006,2020-10-21,602,63,539,3,1,2
DKI JAKARTA,JAKARTA BARAT,KEMBANGAN,KEMBANGAN SELATAN,3173081006,2020-10-22,603,56,547,1,-7,8
DKI JAKARTA,JAKARTA BARAT,KEMBANGAN,KEMBANGAN SELATAN,3173081006,2020-10-23,606,59,547,3,3,0
DKI JAKARTA,JAKARTA BARAT,KEMBANGAN,KEMBANGAN SELATAN,3173081006,2020-10-24,610,53,557,4,-6,10
DKI JAKARTA,JAKARTA BARAT,KEMBANGAN,KEMBANGAN SELATAN,3173081006,2020-10-25,614,41,573,4,-12,16
DKI JAKARTA,JAKARTA BARAT,KEMBANGAN,KEMBANGAN SELATAN,3173081006,2020-10-26,614,34,580,0,-7,7
DKI JAKARTA,JAKARTA BARAT,KEMBANGAN,KEMBANGAN SELATAN,3173081006,2020-10-27,618,30,588,4,-4,8
DKI JAKARTA,JAKARTA BARAT,KEMBANGAN,KEMBANGAN SELATAN,3173081006,2020-10-28,620,27,593,2,-3,5
DKI JAKARTA,JAKARTA BARAT,KEMBANGAN,KEMBANGAN SELATAN,3173081006,2020-10-29,627,24,603,7,-3,10
DKI JAKARTA,JAKARTA BARAT,KEMBANGAN,KEMBANGAN SELATAN,3173081006,2020-10-30,643,39,604,16,15,1
DKI JAKARTA,JAKARTA BARAT,KEMBANGAN,KEMBANGAN SELATAN,3173081006,2020-10-31,648,42,606,5,3,2
DKI JAKARTA,JAKARTA BARAT,KEMBANGAN,KEMBANGAN UTARA,3173081001,2020-10-01,1293,112,1181,0,0,0
DKI JAKARTA,JAKARTA BARAT,KEMBANGAN,KEMBANGAN UTARA,3173081001,2020-10-02,1324,99,1225,31,-13,44
DKI JAKARTA,JAKARTA BARAT,KEMBANGAN,KEMBANGAN UTARA,3173081001,2020-10-03,1339,109,1230,15,10,5
DKI JAKARTA,JAKARTA BARAT,KEMBANGAN,KEMBANGAN UTARA,3173081001,2020-10-04,1346,112,1234,7,3,4
DKI JAKARTA,JAKARTA BARAT,KEMBANGAN,KEMBANGAN UTARA,3173081001,2020-10-05,1355,111,1244,9,-1,10
DKI JAKARTA,JAKARTA BARAT,KEMBANGAN,KEMBANGAN UTARA,3173081001,2020-10-06,1372,111,1261,17,0,17
DKI JAKARTA,JAKARTA BARAT,KEMBANGAN,KEMBANGAN UTARA,3173081001,2020-10-07,1392,120,1272,20,9,11
DKI JAKARTA,JAKARTA BARAT,KEMBANGAN,KEMBANGAN UTARA,3173081001,2020-10-08,1409,123,1286,17,3,14
DKI JAKARTA,JAKARTA BARAT,KEMBANGAN,KEMBANGAN UTARA,3173081001,2020-10-09,1415,128,1287,6,5,1
DKI JAKARTA,JAKARTA BARAT,KEMBANGAN,KEMBANGAN UTARA,3173081001,2020-10-10,1422,119,1303,7,-9,16
DKI JAKARTA,JAKARTA BARAT,KEMBANGAN,KEMBANGAN UTARA,3173081001,2020-10-11,1442,133,1309,20,14,6
DKI JAKARTA,JAKARTA BARAT,KEMBANGAN,KEMBANGAN UTARA,3173081001,2020-10-12,1450,131,1319,8,-2,10
DKI JAKARTA,JAKARTA BARAT,KEMBANGAN,KEMBANGAN UTARA,3173081001,2020-10-13,1455,108,1347,5,-23,28
DKI JAKARTA,JAKARTA BARAT,KEMBANGAN,KEMBANGAN UTARA,3173081001,2020-10-14,1472,108,1364,17,0,17
DKI JAKARTA,JAKARTA BARAT,KEMBANGAN,KEMBANGAN UTARA,3173081001,2020-10-15,1485,104,1381,13,-4,17
DKI JAKARTA,JAKARTA BARAT,KEMBANGAN,KEMBANGAN UTARA,3173081001,2020-10-16,1494,91,1403,9,-13,22
DKI JAKARTA,JAKARTA BARAT,KEMBANGAN,KEMBANGAN UTARA,3173081001,2020-10-17,1506,94,1412,12,3,9
DKI JAKARTA,JAKARTA BARAT,KEMBANGAN,KEMBANGAN UTARA,3173081001,2020-10-18,1512,97,1415,6,3,3
DKI JAKARTA,JAKARTA BARAT,KEMBANGAN,KEMBANGAN UTARA,3173081001,2020-10-19,1513,88,1425,1,-9,10
DKI JAKARTA,JAKARTA BARAT,KEMBANGAN,KEMBANGAN UTARA,3173081001,2020-10-20,1531,85,1446,18,-3,21
DKI JAKARTA,JAKARTA BARAT,KEMBANGAN,KEMBANGAN UTARA,3173081001,2020-10-21,1532,82,1450,1,-3,4
DKI JAKARTA,JAKARTA BARAT,KEMBANGAN,KEMBANGAN UTARA,3173081001,2020-10-22,1535,71,1464,3,-11,14
DKI JAKARTA,JAKARTA BARAT,KEMBANGAN,KEMBANGAN UTARA,3173081001,2020-10-23,1538,74,1464,3,3,0
DKI JAKARTA,JAKARTA BARAT,KEMBANGAN,KEMBANGAN UTARA,3173081001,2020-10-24,1538,69,1469,0,-5,5
DKI JAKARTA,JAKARTA BARAT,KEMBANGAN,KEMBANGAN UTARA,3173081001,2020-10-25,1545,66,1479,7,-3,10
DKI JAKARTA,JAKARTA BARAT,KEMBANGAN,KEMBANGAN UTARA,3173081001,2020-10-26,1553,53,1500,8,-13,21
DKI JAKARTA,JAKARTA BARAT,KEMBANGAN,KEMBANGAN UTARA,3173081001,2020-10-27,1555,44,1511,2,-9,11
DKI JAKARTA,JAKARTA BARAT,KEMBANGAN,KEMBANGAN UTARA,3173081001,2020-10-28,1556,39,1517,1,-5,6
DKI JAKARTA,JAKARTA BARAT,KEMBANGAN,KEMBANGAN UTARA,3173081001,2020-10-29,1562,34,1528,6,-5,11
DKI JAKARTA,JAKARTA BARAT,KEMBANGAN,KEMBANGAN UTARA,3173081001,2020-10-30,1578,42,1536,16,8,8
DKI JAKARTA,JAKARTA BARAT,KEMBANGAN,KEMBANGAN UTARA,3173081001,2020-10-31,1586,49,1537,8,7,1
DKI JAKARTA,JAKARTA BARAT,KEMBANGAN,MERUYA SELATAN,3173081003,2020-10-01,637,106,531,0,0,0
DKI JAKARTA,JAKARTA BARAT,KEMBANGAN,MERUYA SELATAN,3173081003,2020-10-02,646,100,546,9,-6,15
DKI JAKARTA,JAKARTA BARAT,KEMBANGAN,MERUYA SELATAN,3173081003,2020-10-03,660,110,550,14,10,4
DKI JAKARTA,JAKARTA BARAT,KEMBANGAN,MERUYA SELATAN,3173081003,2020-10-04,662,108,554,2,-2,4
DKI JAKARTA,JAKARTA BARAT,KEMBANGAN,MERUYA SELATAN,3173081003,2020-10-05,665,109,556,3,1,2
DKI JAKARTA,JAKARTA BARAT,KEMBANGAN,MERUYA SELATAN,3173081003,2020-10-06,674,103,571,9,-6,15
DKI JAKARTA,JAKARTA BARAT,KEMBANGAN,MERUYA SELATAN,3173081003,2020-10-07,695,117,578,21,14,7
DKI JAKARTA,JAKARTA BARAT,KEMBANGAN,MERUYA SELATAN,3173081003,2020-10-08,703,103,600,8,-14,22
DKI JAKARTA,JAKARTA BARAT,KEMBANGAN,MERUYA SELATAN,3173081003,2020-10-09,706,105,601,3,2,1
DKI JAKARTA,JAKARTA BARAT,KEMBANGAN,MERUYA SELATAN,3173081003,2020-10-10,710,78,632,4,-27,31
DKI JAKARTA,JAKARTA BARAT,KEMBANGAN,MERUYA SELATAN,3173081003,2020-10-11,722,85,637,12,7,5
DKI JAKARTA,JAKARTA BARAT,KEMBANGAN,MERUYA SELATAN,3173081003,2020-10-12,726,77,649,4,-8,12
DKI JAKARTA,JAKARTA BARAT,KEMBANGAN,MERUYA SELATAN,3173081003,2020-10-13,728,63,665,2,-14,16
DKI JAKARTA,JAKARTA BARAT,KEMBANGAN,MERUYA SELATAN,3173081003,2020-10-14,732,61,671,4,-2,6
DKI JAKARTA,JAKARTA BARAT,KEMBANGAN,MERUYA SELATAN,3173081003,2020-10-15,743,52,691,11,-9,20
DKI JAKARTA,JAKARTA BARAT,KEMBANGAN,MERUYA SELATAN,3173081003,2020-10-16,751,52,699,8,0,8
DKI JAKARTA,JAKARTA BARAT,KEMBANGAN,MERUYA SELATAN,3173081003,2020-10-17,760,59,701,9,7,2
DKI JAKARTA,JAKARTA BARAT,KEMBANGAN,MERUYA SELATAN,3173081003,2020-10-18,769,63,706,9,4,5
DKI JAKARTA,JAKARTA BARAT,KEMBANGAN,MERUYA SELATAN,3173081003,2020-10-19,770,57,713,1,-6,7
DKI JAKARTA,JAKARTA BARAT,KEMBANGAN,MERUYA SELATAN,3173081003,2020-10-20,779,57,722,9,0,9
DKI JAKARTA,JAKARTA BARAT,KEMBANGAN,MERUYA SELATAN,3173081003,2020-10-21,779,52,727,0,-5,5
DKI JAKARTA,JAKARTA BARAT,KEMBANGAN,MERUYA SELATAN,3173081003,2020-10-22,784,48,736,5,-4,9
DKI JAKARTA,JAKARTA BARAT,KEMBANGAN,MERUYA SELATAN,3173081003,2020-10-23,792,56,736,8,8,0
DKI JAKARTA,JAKARTA BARAT,KEMBANGAN,MERUYA SELATAN,3173081003,2020-10-24,796,52,744,4,-4,8
DKI JAKARTA,JAKARTA BARAT,KEMBANGAN,MERUYA SELATAN,3173081003,2020-10-25,798,49,749,2,-3,5
DKI JAKARTA,JAKARTA BARAT,KEMBANGAN,MERUYA SELATAN,3173081003,2020-10-26,801,48,753,3,-1,4
DKI JAKARTA,JAKARTA BARAT,KEMBANGAN,MERUYA SELATAN,3173081003,2020-10-27,805,45,760,4,-3,7
DKI JAKARTA,JAKARTA BARAT,KEMBANGAN,MERUYA SELATAN,3173081003,2020-10-28,811,42,769,6,-3,9
DKI JAKARTA,JAKARTA BARAT,KEMBANGAN,MERUYA SELATAN,3173081003,2020-10-29,814,37,777,3,-5,8
DKI JAKARTA,JAKARTA BARAT,KEMBANGAN,MERUYA SELATAN,3173081003,2020-10-30,824,40,784,10,3,7
DKI JAKARTA,JAKARTA BARAT,KEMBANGAN,MERUYA SELATAN,3173081003,2020-10-31,834,48,786,10,8,2
DKI JAKARTA,JAKARTA BARAT,KEMBANGAN,MERUYA UTARA,3173081002,2020-10-01,792,74,718,0,0,0
DKI JAKARTA,JAKARTA BARAT,KEMBANGAN,MERUYA UTARA,3173081002,2020-10-02,804,80,724,12,6,6
DKI JAKARTA,JAKARTA BARAT,KEMBANGAN,MERUYA UTARA,3173081002,2020-10-03,813,84,729,9,4,5
DKI JAKARTA,JAKARTA BARAT,KEMBANGAN,MERUYA UTARA,3173081002,2020-10-04,821,88,733,8,4,4
DKI JAKARTA,JAKARTA BARAT,KEMBANGAN,MERUYA UTARA,3173081002,2020-10-05,825,82,743,4,-6,10
DKI JAKARTA,JAKARTA BARAT,KEMBANGAN,MERUYA UTARA,3173081002,2020-10-06,836,88,748,11,6,5
DKI JAKARTA,JAKARTA BARAT,KEMBANGAN,MERUYA UTARA,3173081002,2020-10-07,856,88,768,20,0,20
DKI JAKARTA,JAKARTA BARAT,KEMBANGAN,MERUYA UTARA,3173081002,2020-10-08,869,96,773,13,8,5
DKI JAKARTA,JAKARTA BARAT,KEMBANGAN,MERUYA UTARA,3173081002,2020-10-09,872,96,776,3,0,3
DKI JAKARTA,JAKARTA BARAT,KEMBANGAN,MERUYA UTARA,3173081002,2020-10-10,883,79,804,11,-17,28
DKI JAKARTA,JAKARTA BARAT,KEMBANGAN,MERUYA UTARA,3173081002,2020-10-11,899,93,806,16,14,2
DKI JAKARTA,JAKARTA BARAT,KEMBANGAN,MERUYA UTARA,3173081002,2020-10-12,908,84,824,9,-9,18
DKI JAKARTA,JAKARTA BARAT,KEMBANGAN,MERUYA UTARA,3173081002,2020-10-13,913,83,830,5,-1,6
DKI JAKARTA,JAKARTA BARAT,KEMBANGAN,MERUYA UTARA,3173081002,2020-10-14,924,86,838,11,3,8
DKI JAKARTA,JAKARTA BARAT,KEMBANGAN,MERUYA UTARA,3173081002,2020-10-15,939,86,853,15,0,15
DKI JAKARTA,JAKARTA BARAT,KEMBANGAN,MERUYA UTARA,3173081002,2020-10-16,948,85,863,9,-1,10
DKI JAKARTA,JAKARTA BARAT,KEMBANGAN,MERUYA UTARA,3173081002,2020-10-17,959,93,866,11,8,3
DKI JAKARTA,JAKARTA BARAT,KEMBANGAN,MERUYA UTARA,3173081002,2020-10-18,971,101,870,12,8,4
DKI JAKARTA,JAKARTA BARAT,KEMBANGAN,MERUYA UTARA,3173081002,2020-10-19,972,97,875,1,-4,5
DKI JAKARTA,JAKARTA BARAT,KEMBANGAN,MERUYA UTARA,3173081002,2020-10-20,981,97,884,9,0,9
DKI JAKARTA,JAKARTA BARAT,KEMBANGAN,MERUYA UTARA,3173081002,2020-10-21,985,92,893,4,-5,9
DKI JAKARTA,JAKARTA BARAT,KEMBANGAN,MERUYA UTARA,3173081002,2020-10-22,986,73,913,1,-19,20
DKI JAKARTA,JAKARTA BARAT,KEMBANGAN,MERUYA UTARA,3173081002,2020-10-23,988,74,914,2,1,1
DKI JAKARTA,JAKARTA BARAT,KEMBANGAN,MERUYA UTARA,3173081002,2020-10-24,997,67,930,9,-7,16
DKI JAKARTA,JAKARTA BARAT,KEMBANGAN,MERUYA UTARA,3173081002,2020-10-25,1008,72,936,11,5,6
DKI JAKARTA,JAKARTA BARAT,KEMBANGAN,MERUYA UTARA,3173081002,2020-10-26,1015,68,947,7,-4,11
DKI JAKARTA,JAKARTA BARAT,KEMBANGAN,MERUYA UTARA,3173081002,2020-10-27,1021,58,963,6,-10,16
DKI JAKARTA,JAKARTA BARAT,KEMBANGAN,MERUYA UTARA,3173081002,2020-10-28,1026,49,977,5,-9,14
DKI JAKARTA,JAKARTA BARAT,KEMBANGAN,MERUYA UTARA,3173081002,2020-10-29,1030,42,988,4,-7,11
DKI JAKARTA,JAKARTA BARAT,KEMBANGAN,MERUYA UTARA,3173081002,2020-10-30,1043,48,995,13,6,7
DKI JAKARTA,JAKARTA BARAT,KEMBANGAN,MERUYA UTARA,3173081002,2020-10-31,1059,63,996,16,15,1
DKI JAKARTA,JAKARTA BARAT,KEMBANGAN,SRENGSENG,3173081004,2020-10-01,934,119,815,0,0,0
DKI JAKARTA,JAKARTA BARAT,KEMBANGAN,SRENGSENG,3173081004,2020-10-02,954,117,837,20,-2,22
DKI JAKARTA,JAKARTA BARAT,KEMBANGAN,SRENGSENG,3173081004,2020-10-03,1010,130,880,56,13,43
DKI JAKARTA,JAKARTA BARAT,KEMBANGAN,SRENGSENG,3173081004,2020-10-04,1039,155,884,29,25,4
DKI JAKARTA,JAKARTA BARAT,KEMBANGAN,SRENGSENG,3173081004,2020-10-05,1053,161,892,14,6,8
DKI JAKARTA,JAKARTA BARAT,KEMBANGAN,SRENGSENG,3173081004,2020-10-06,1074,162,912,21,1,20
DKI JAKARTA,JAKARTA BARAT,KEMBANGAN,SRENGSENG,3173081004,2020-10-07,1107,180,927,33,18,15
DKI JAKARTA,JAKARTA BARAT,KEMBANGAN,SRENGSENG,3173081004,2020-10-08,1129,185,944,22,5,17
DKI JAKARTA,JAKARTA BARAT,KEMBANGAN,SRENGSENG,3173081004,2020-10-09,1129,185,944,0,0,0
DKI JAKARTA,JAKARTA BARAT,KEMBANGAN,SRENGSENG,3173081004,2020-10-10,1137,175,962,8,-10,18
DKI JAKARTA,JAKARTA BARAT,KEMBANGAN,SRENGSENG,3173081004,2020-10-11,1156,185,971,19,10,9
DKI JAKARTA,JAKARTA BARAT,KEMBANGAN,SRENGSENG,3173081004,2020-10-12,1165,174,991,9,-11,20
DKI JAKARTA,JAKARTA BARAT,KEMBANGAN,SRENGSENG,3173081004,2020-10-13,1175,163,1012,10,-11,21
DKI JAKARTA,JAKARTA BARAT,KEMBANGAN,SRENGSENG,3173081004,2020-10-14,1179,116,1063,4,-47,51
DKI JAKARTA,JAKARTA BARAT,KEMBANGAN,SRENGSENG,3173081004,2020-10-15,1198,120,1078,19,4,15
DKI JAKARTA,JAKARTA BARAT,KEMBANGAN,SRENGSENG,3173081004,2020-10-16,1207,108,1099,9,-12,21
DKI JAKARTA,JAKARTA BARAT,KEMBANGAN,SRENGSENG,3173081004,2020-10-17,1220,112,1108,13,4,9
DKI JAKARTA,JAKARTA BARAT,KEMBANGAN,SRENGSENG,3173081004,2020-10-18,1234,118,1116,14,6,8
DKI JAKARTA,JAKARTA BARAT,KEMBANGAN,SRENGSENG,3173081004,2020-10-19,1238,109,1129,4,-9,13
DKI JAKARTA,JAKARTA BARAT,KEMBANGAN,SRENGSENG,3173081004,2020-10-20,1254,114,1140,16,5,11
DKI JAKARTA,JAKARTA BARAT,KEMBANGAN,SRENGSENG,3173081004,2020-10-21,1281,129,1152,27,15,12
DKI JAKARTA,JAKARTA BARAT,KEMBANGAN,SRENGSENG,3173081004,2020-10-22,1287,116,1171,6,-13,19
DKI JAKARTA,JAKARTA BARAT,KEMBANGAN,SRENGSENG,3173081004,2020-10-23,1295,124,1171,8,8,0
DKI JAKARTA,JAKARTA BARAT,KEMBANGAN,SRENGSENG,3173081004,2020-10-24,1297,109,1188,2,-15,17
DKI JAKARTA,JAKARTA BARAT,KEMBANGAN,SRENGSENG,3173081004,2020-10-25,1304,112,1192,7,3,4
DKI JAKARTA,JAKARTA BARAT,KEMBANGAN,SRENGSENG,3173081004,2020-10-26,1317,115,1202,13,3,10
DKI JAKARTA,JAKARTA BARAT,KEMBANGAN,SRENGSENG,3173081004,2020-10-27,1320,109,1211,3,-6,9
DKI JAKARTA,JAKARTA BARAT,KEMBANGAN,SRENGSENG,3173081004,2020-10-28,1328,101,1227,8,-8,16
DKI JAKARTA,JAKARTA BARAT,KEMBANGAN,SRENGSENG,3173081004,2020-10-29,1334,92,1242,6,-9,15
DKI JAKARTA,JAKARTA BARAT,KEMBANGAN,SRENGSENG,3173081004,2020-10-30,1341,89,1252,7,-3,10
DKI JAKARTA,JAKARTA BARAT,KEMBANGAN,SRENGSENG,3173081004,2020-10-31,1357,104,1253,16,15,1
DKI JAKARTA,JAKARTA BARAT,PALMERAH,JATI PULO,3173071004,2020-10-01,650,70,580,0,0,0
DKI JAKARTA,JAKARTA BARAT,PALMERAH,JATI PULO,3173071004,2020-10-02,657,71,586,7,1,6
DKI JAKARTA,JAKARTA BARAT,PALMERAH,JATI PULO,3173071004,2020-10-03,660,69,591,3,-2,5
DKI JAKARTA,JAKARTA BARAT,PALMERAH,JATI PULO,3173071004,2020-10-04,663,71,592,3,2,1
DKI JAKARTA,JAKARTA BARAT,PALMERAH,JATI PULO,3173071004,2020-10-05,664,66,598,1,-5,6
DKI JAKARTA,JAKARTA BARAT,PALMERAH,JATI PULO,3173071004,2020-10-06,670,54,616,6,-12,18
DKI JAKARTA,JAKARTA BARAT,PALMERAH,JATI PULO,3173071004,2020-10-07,682,59,623,12,5,7
DKI JAKARTA,JAKARTA BARAT,PALMERAH,JATI PULO,3173071004,2020-10-08,693,50,643,11,-9,20
DKI JAKARTA,JAKARTA BARAT,PALMERAH,JATI PULO,3173071004,2020-10-09,698,53,645,5,3,2
DKI JAKARTA,JAKARTA BARAT,PALMERAH,JATI PULO,3173071004,2020-10-10,700,48,652,2,-5,7
DKI JAKARTA,JAKARTA BARAT,PALMERAH,JATI PULO,3173071004,2020-10-11,712,59,653,12,11,1
DKI JAKARTA,JAKARTA BARAT,PALMERAH,JATI PULO,3173071004,2020-10-12,717,55,662,5,-4,9
DKI JAKARTA,JAKARTA BARAT,PALMERAH,JATI PULO,3173071004,2020-10-13,718,49,669,1,-6,7
DKI JAKARTA,JAKARTA BARAT,PALMERAH,JATI PULO,3173071004,2020-10-14,724,49,675,6,0,6
DKI JAKARTA,JAKARTA BARAT,PALMERAH,JATI PULO,3173071004,2020-10-15,727,46,681,3,-3,6
DKI JAKARTA,JAKARTA BARAT,PALMERAH,JATI PULO,3173071004,2020-10-16,730,43,687,3,-3,6
DKI JAKARTA,JAKARTA BARAT,PALMERAH,JATI PULO,3173071004,2020-10-17,736,48,688,6,5,1
DKI JAKARTA,JAKARTA BARAT,PALMERAH,JATI PULO,3173071004,2020-10-18,742,51,691,6,3,3
DKI JAKARTA,JAKARTA BARAT,PALMERAH,JATI PULO,3173071004,2020-10-19,743,46,697,1,-5,6
DKI JAKARTA,JAKARTA BARAT,PALMERAH,JATI PULO,3173071004,2020-10-20,751,38,713,8,-8,16
DKI JAKARTA,JAKARTA BARAT,PALMERAH,JATI PULO,3173071004,2020-10-21,756,38,718,5,0,5
DKI JAKARTA,JAKARTA BARAT,PALMERAH,JATI PULO,3173071004,2020-10-22,757,36,721,1,-2,3
DKI JAKARTA,JAKARTA BARAT,PALMERAH,JATI PULO,3173071004,2020-10-23,769,47,722,12,11,1
DKI JAKARTA,JAKARTA BARAT,PALMERAH,JATI PULO,3173071004,2020-10-24,776,50,726,7,3,4
DKI JAKARTA,JAKARTA BARAT,PALMERAH,JATI PULO,3173071004,2020-10-25,776,49,727,0,-1,1
DKI JAKARTA,JAKARTA BARAT,PALMERAH,JATI PULO,3173071004,2020-10-26,779,40,739,3,-9,12
DKI JAKARTA,JAKARTA BARAT,PALMERAH,JATI PULO,3173071004,2020-10-27,783,39,744,4,-1,5
DKI JAKARTA,JAKARTA BARAT,PALMERAH,JATI PULO,3173071004,2020-10-28,787,36,751,4,-3,7
DKI JAKARTA,JAKARTA BARAT,PALMERAH,JATI PULO,3173071004,2020-10-29,790,36,754,3,0,3
DKI JAKARTA,JAKARTA BARAT,PALMERAH,JATI PULO,3173071004,2020-10-30,798,40,758,8,4,4
DKI JAKARTA,JAKARTA BARAT,PALMERAH,JATI PULO,3173071004,2020-10-31,804,44,760,6,4,2
DKI JAKARTA,JAKARTA BARAT,PALMERAH,KEMANGGISAN,3173071005,2020-10-01,770,92,678,0,0,0
DKI JAKARTA,JAKARTA BARAT,PALMERAH,KEMANGGISAN,3173071005,2020-10-02,778,81,697,8,-11,19
DKI JAKARTA,JAKARTA BARAT,PALMERAH,KEMANGGISAN,3173071005,2020-10-03,793,87,706,15,6,9
DKI JAKARTA,JAKARTA BARAT,PALMERAH,KEMANGGISAN,3173071005,2020-10-04,800,91,709,7,4,3
DKI JAKARTA,JAKARTA BARAT,PALMERAH,KEMANGGISAN,3173071005,2020-10-05,800,70,730,0,-21,21
DKI JAKARTA,JAKARTA BARAT,PALMERAH,KEMANGGISAN,3173071005,2020-10-06,809,71,738,9,1,8
DKI JAKARTA,JAKARTA BARAT,PALMERAH,KEMANGGISAN,3173071005,2020-10-07,819,69,750,10,-2,12
DKI JAKARTA,JAKARTA BARAT,PALMERAH,KEMANGGISAN,3173071005,2020-10-08,837,82,755,18,13,5
DKI JAKARTA,JAKARTA BARAT,PALMERAH,KEMANGGISAN,3173071005,2020-10-09,840,85,755,3,3,0
DKI JAKARTA,JAKARTA BARAT,PALMERAH,KEMANGGISAN,3173071005,2020-10-10,843,80,763,3,-5,8
DKI JAKARTA,JAKARTA BARAT,PALMERAH,KEMANGGISAN,3173071005,2020-10-11,852,89,763,9,9,0
DKI JAKARTA,JAKARTA BARAT,PALMERAH,KEMANGGISAN,3173071005,2020-10-12,857,72,785,5,-17,22
DKI JAKARTA,JAKARTA BARAT,PALMERAH,KEMANGGISAN,3173071005,2020-10-13,860,62,798,3,-10,13
DKI JAKARTA,JAKARTA BARAT,PALMERAH,KEMANGGISAN,3173071005,2020-10-14,863,55,808,3,-7,10
DKI JAKARTA,JAKARTA BARAT,PALMERAH,KEMANGGISAN,3173071005,2020-10-15,875,51,824,12,-4,16
DKI JAKARTA,JAKARTA BARAT,PALMERAH,KEMANGGISAN,3173071005,2020-10-16,882,51,831,7,0,7
DKI JAKARTA,JAKARTA BARAT,PALMERAH,KEMANGGISAN,3173071005,2020-10-17,889,55,834,7,4,3
DKI JAKARTA,JAKARTA BARAT,PALMERAH,KEMANGGISAN,3173071005,2020-10-18,893,55,838,4,0,4
DKI JAKARTA,JAKARTA BARAT,PALMERAH,KEMANGGISAN,3173071005,2020-10-19,895,48,847,2,-7,9
DKI JAKARTA,JAKARTA BARAT,PALMERAH,KEMANGGISAN,3173071005,2020-10-20,900,43,857,5,-5,10
DKI JAKARTA,JAKARTA BARAT,PALMERAH,KEMANGGISAN,3173071005,2020-10-21,915,51,864,15,8,7
DKI JAKARTA,JAKARTA BARAT,PALMERAH,KEMANGGISAN,3173071005,2020-10-22,916,47,869,1,-4,5
DKI JAKARTA,JAKARTA BARAT,PALMERAH,KEMANGGISAN,3173071005,2020-10-23,923,51,872,7,4,3
DKI JAKARTA,JAKARTA BARAT,PALMERAH,KEMANGGISAN,3173071005,2020-10-24,925,42,883,2,-9,11
DKI JAKARTA,JAKARTA BARAT,PALMERAH,KEMANGGISAN,3173071005,2020-10-25,935,49,886,10,7,3
DKI JAKARTA,JAKARTA BARAT,PALMERAH,KEMANGGISAN,3173071005,2020-10-26,941,47,894,6,-2,8
DKI JAKARTA,JAKARTA BARAT,PALMERAH,KEMANGGISAN,3173071005,2020-10-27,950,50,900,9,3,6
DKI JAKARTA,JAKARTA BARAT,PALMERAH,KEMANGGISAN,3173071005,2020-10-28,953,49,904,3,-1,4
DKI JAKARTA,JAKARTA BARAT,PALMERAH,KEMANGGISAN,3173071005,2020-10-29,959,45,914,6,-4,10
DKI JAKARTA,JAKARTA BARAT,PALMERAH,KEMANGGISAN,3173071005,2020-10-30,968,51,917,9,6,3
DKI JAKARTA,JAKARTA BARAT,PALMERAH,KEMANGGISAN,3173071005,2020-10-31,970,53,917,2,2,0
DKI JAKARTA,JAKARTA BARAT,PALMERAH,KOTA BAMBU SELATAN,3173071006,2020-10-01,756,35,721,0,0,0
DKI JAKARTA,JAKARTA BARAT,PALMERAH,KOTA BAMBU SELATAN,3173071006,2020-10-02,759,38,721,3,3,0
DKI JAKARTA,JAKARTA BARAT,PALMERAH,KOTA BAMBU SELATAN,3173071006,2020-10-03,765,42,723,6,4,2
DKI JAKARTA,JAKARTA BARAT,PALMERAH,KOTA BAMBU SELATAN,3173071006,2020-10-04,767,44,723,2,2,0
DKI JAKARTA,JAKARTA BARAT,PALMERAH,KOTA BAMBU SELATAN,3173071006,2020-10-05,768,39,729,1,-5,6
DKI JAKARTA,JAKARTA BARAT,PALMERAH,KOTA BAMBU SELATAN,3173071006,2020-10-06,775,44,731,7,5,2
DKI JAKARTA,JAKARTA BARAT,PALMERAH,KOTA BAMBU SELATAN,3173071006,2020-10-07,782,48,734,7,4,3
DKI JAKARTA,JAKARTA BARAT,PALMERAH,KOTA BAMBU SELATAN,3173071006,2020-10-08,804,62,742,22,14,8
DKI JAKARTA,JAKARTA BARAT,PALMERAH,KOTA BAMBU SELATAN,3173071006,2020-10-09,807,62,745,3,0,3
DKI JAKARTA,JAKARTA BARAT,PALMERAH,KOTA BAMBU SELATAN,3173071006,2020-10-10,817,62,755,10,0,10
DKI JAKARTA,JAKARTA BARAT,PALMERAH,KOTA BAMBU SELATAN,3173071006,2020-10-11,824,68,756,7,6,1
DKI JAKARTA,JAKARTA BARAT,PALMERAH,KOTA BAMBU SELATAN,3173071006,2020-10-12,828,65,763,4,-3,7
DKI JAKARTA,JAKARTA BARAT,PALMERAH,KOTA BAMBU SELATAN,3173071006,2020-10-13,831,60,771,3,-5,8
DKI JAKARTA,JAKARTA BARAT,PALMERAH,KOTA BAMBU SELATAN,3173071006,2020-10-14,835,56,779,4,-4,8
DKI JAKARTA,JAKARTA BARAT,PALMERAH,KOTA BAMBU SELATAN,3173071006,2020-10-15,839,49,790,4,-7,11
DKI JAKARTA,JAKARTA BARAT,PALMERAH,KOTA BAMBU SELATAN,3173071006,2020-10-16,840,47,793,1,-2,3
DKI JAKARTA,JAKARTA BARAT,PALMERAH,KOTA BAMBU SELATAN,3173071006,2020-10-17,846,53,793,6,6,0
DKI JAKARTA,JAKARTA BARAT,PALMERAH,KOTA BAMBU SELATAN,3173071006,2020-10-18,850,54,796,4,1,3
DKI JAKARTA,JAKARTA BARAT,PALMERAH,KOTA BAMBU SELATAN,3173071006,2020-10-19,850,45,805,0,-9,9
DKI JAKARTA,JAKARTA BARAT,PALMERAH,KOTA BAMBU SELATAN,3173071006,2020-10-20,851,34,817,1,-11,12
DKI JAKARTA,JAKARTA BARAT,PALMERAH,KOTA BAMBU SELATAN,3173071006,2020-10-21,862,41,821,11,7,4
DKI JAKARTA,JAKARTA BARAT,PALMERAH,KOTA BAMBU SELATAN,3173071006,2020-10-22,863,32,831,1,-9,10
DKI JAKARTA,JAKARTA BARAT,PALMERAH,KOTA BAMBU SELATAN,3173071006,2020-10-23,871,40,831,8,8,0
DKI JAKARTA,JAKARTA BARAT,PALMERAH,KOTA BAMBU SELATAN,3173071006,2020-10-24,876,40,836,5,0,5
DKI JAKARTA,JAKARTA BARAT,PALMERAH,KOTA BAMBU SELATAN,3173071006,2020-10-25,879,39,840,3,-1,4
DKI JAKARTA,JAKARTA BARAT,PALMERAH,KOTA BAMBU SELATAN,3173071006,2020-10-26,882,37,845,3,-2,5
DKI JAKARTA,JAKARTA BARAT,PALMERAH,KOTA BAMBU SELATAN,3173071006,2020-10-27,886,38,848,4,1,3
DKI JAKARTA,JAKARTA BARAT,PALMERAH,KOTA BAMBU SELATAN,3173071006,2020-10-28,888,37,851,2,-1,3
DKI JAKARTA,JAKARTA BARAT,PALMERAH,KOTA BAMBU SELATAN,3173071006,2020-10-29,894,30,864,6,-7,13
DKI JAKARTA,JAKARTA BARAT,PALMERAH,KOTA BAMBU SELATAN,3173071006,2020-10-30,899,35,864,5,5,0
DKI JAKARTA,JAKARTA BARAT,PALMERAH,KOTA BAMBU SELATAN,3173071006,2020-10-31,900,33,867,1,-2,3
DKI JAKARTA,JAKARTA BARAT,PALMERAH,KOTA BAMBU UTARA,3173071003,2020-10-01,507,31,476,0,0,0
DKI JAKARTA,JAKARTA BARAT,PALMERAH,KOTA BAMBU UTARA,3173071003,2020-10-02,509,31,478,2,0,2
DKI JAKARTA,JAKARTA BARAT,PALMERAH,KOTA BAMBU UTARA,3173071003,2020-10-03,509,30,479,0,-1,1
DKI JAKARTA,JAKARTA BARAT,PALMERAH,KOTA BAMBU UTARA,3173071003,2020-10-04,511,29,482,2,-1,3
DKI JAKARTA,JAKARTA BARAT,PALMERAH,KOTA BAMBU UTARA,3173071003,2020-10-05,512,26,486,1,-3,4
DKI JAKARTA,JAKARTA BARAT,PALMERAH,KOTA BAMBU UTARA,3173071003,2020-10-06,523,28,495,11,2,9
DKI JAKARTA,JAKARTA BARAT,PALMERAH,KOTA BAMBU UTARA,3173071003,2020-10-07,533,35,498,10,7,3
DKI JAKARTA,JAKARTA BARAT,PALMERAH,KOTA BAMBU UTARA,3173071003,2020-10-08,540,36,504,7,1,6
DKI JAKARTA,JAKARTA BARAT,PALMERAH,KOTA BAMBU UTARA,3173071003,2020-10-09,542,38,504,2,2,0
DKI JAKARTA,JAKARTA BARAT,PALMERAH,KOTA BAMBU UTARA,3173071003,2020-10-10,551,40,511,9,2,7
DKI JAKARTA,JAKARTA BARAT,PALMERAH,KOTA BAMBU UTARA,3173071003,2020-10-11,553,39,514,2,-1,3
DKI JAKARTA,JAKARTA BARAT,PALMERAH,KOTA BAMBU UTARA,3173071003,2020-10-12,553,37,516,0,-2,2
DKI JAKARTA,JAKARTA BARAT,PALMERAH,KOTA BAMBU UTARA,3173071003,2020-10-13,553,33,520,0,-4,4
DKI JAKARTA,JAKARTA BARAT,PALMERAH,KOTA BAMBU UTARA,3173071003,2020-10-14,558,34,524,5,1,4
DKI JAKARTA,JAKARTA BARAT,PALMERAH,KOTA BAMBU UTARA,3173071003,2020-10-15,562,31,531,4,-3,7
DKI JAKARTA,JAKARTA BARAT,PALMERAH,KOTA BAMBU UTARA,3173071003,2020-10-16,564,24,540,2,-7,9
DKI JAKARTA,JAKARTA BARAT,PALMERAH,KOTA BAMBU UTARA,3173071003,2020-10-17,566,23,543,2,-1,3
DKI JAKARTA,JAKARTA BARAT,PALMERAH,KOTA BAMBU UTARA,3173071003,2020-10-18,572,27,545,6,4,2
DKI JAKARTA,JAKARTA BARAT,PALMERAH,KOTA BAMBU UTARA,3173071003,2020-10-19,572,23,549,0,-4,4
DKI JAKARTA,JAKARTA BARAT,PALMERAH,KOTA BAMBU UTARA,3173071003,2020-10-20,574,25,549,2,2,0
DKI JAKARTA,JAKARTA BARAT,PALMERAH,KOTA BAMBU UTARA,3173071003,2020-10-21,575,22,553,1,-3,4
DKI JAKARTA,JAKARTA BARAT,PALMERAH,KOTA BAMBU UTARA,3173071003,2020-10-22,576,21,555,1,-1,2
DKI JAKARTA,JAKARTA BARAT,PALMERAH,KOTA BAMBU UTARA,3173071003,2020-10-23,579,24,555,3,3,0
DKI JAKARTA,JAKARTA BARAT,PALMERAH,KOTA BAMBU UTARA,3173071003,2020-10-24,581,24,557,2,0,2
DKI JAKARTA,JAKARTA BARAT,PALMERAH,KOTA BAMBU UTARA,3173071003,2020-10-25,581,24,557,0,0,0
DKI JAKARTA,JAKARTA BARAT,PALMERAH,KOTA BAMBU UTARA,3173071003,2020-10-26,582,19,563,1,-5,6
DKI JAKARTA,JAKARTA BARAT,PALMERAH,KOTA BAMBU UTARA,3173071003,2020-10-27,586,20,566,4,1,3
DKI JAKARTA,JAKARTA BARAT,PALMERAH,KOTA BAMBU UTARA,3173071003,2020-10-28,589,17,572,3,-3,6
DKI JAKARTA,JAKARTA BARAT,PALMERAH,KOTA BAMBU UTARA,3173071003,2020-10-29,593,16,577,4,-1,5
DKI JAKARTA,JAKARTA BARAT,PALMERAH,KOTA BAMBU UTARA,3173071003,2020-10-30,597,20,577,4,4,0
DKI JAKARTA,JAKARTA BARAT,PALMERAH,KOTA BAMBU UTARA,3173071003,2020-10-31,599,21,578,2,1,1
DKI JAKARTA,JAKARTA BARAT,PALMERAH,PALMERAH,3173071001,2020-10-01,1533,166,1367,0,0,0
DKI JAKARTA,JAKARTA BARAT,PALMERAH,PALMERAH,3173071001,2020-10-02,1543,163,1380,10,-3,13
DKI JAKARTA,JAKARTA BARAT,PALMERAH,PALMERAH,3173071001,2020-10-03,1553,170,1383,10,7,3
DKI JAKARTA,JAKARTA BARAT,PALMERAH,PALMERAH,3173071001,2020-10-04,1560,171,1389,7,1,6
DKI JAKARTA,JAKARTA BARAT,PALMERAH,PALMERAH,3173071001,2020-10-05,1565,159,1406,5,-12,17
DKI JAKARTA,JAKARTA BARAT,PALMERAH,PALMERAH,3173071001,2020-10-06,1612,185,1427,47,26,21
DKI JAKARTA,JAKARTA BARAT,PALMERAH,PALMERAH,3173071001,2020-10-07,1650,191,1459,38,6,32
DKI JAKARTA,JAKARTA BARAT,PALMERAH,PALMERAH,3173071001,2020-10-08,1687,208,1479,37,17,20
DKI JAKARTA,JAKARTA BARAT,PALMERAH,PALMERAH,3173071001,2020-10-09,1691,211,1480,4,3,1
DKI JAKARTA,JAKARTA BARAT,PALMERAH,PALMERAH,3173071001,2020-10-10,1701,187,1514,10,-24,34
DKI JAKARTA,JAKARTA BARAT,PALMERAH,PALMERAH,3173071001,2020-10-11,1759,240,1519,58,53,5
DKI JAKARTA,JAKARTA BARAT,PALMERAH,PALMERAH,3173071001,2020-10-12,1765,210,1555,6,-30,36
DKI JAKARTA,JAKARTA BARAT,PALMERAH,PALMERAH,3173071001,2020-10-13,1772,181,1591,7,-29,36
DKI JAKARTA,JAKARTA BARAT,PALMERAH,PALMERAH,3173071001,2020-10-14,1795,189,1606,23,8,15
DKI JAKARTA,JAKARTA BARAT,PALMERAH,PALMERAH,3173071001,2020-10-15,1823,189,1634,28,0,28
DKI JAKARTA,JAKARTA BARAT,PALMERAH,PALMERAH,3173071001,2020-10-16,1832,168,1664,9,-21,30
DKI JAKARTA,JAKARTA BARAT,PALMERAH,PALMERAH,3173071001,2020-10-17,1846,178,1668,14,10,4
DKI JAKARTA,JAKARTA BARAT,PALMERAH,PALMERAH,3173071001,2020-10-18,1851,175,1676,5,-3,8
DKI JAKARTA,JAKARTA BARAT,PALMERAH,PALMERAH,3173071001,2020-10-19,1853,150,1703,2,-25,27
DKI JAKARTA,JAKARTA BARAT,PALMERAH,PALMERAH,3173071001,2020-10-20,1867,138,1729,14,-12,26
DKI JAKARTA,JAKARTA BARAT,PALMERAH,PALMERAH,3173071001,2020-10-21,1882,120,1762,15,-18,33
DKI JAKARTA,JAKARTA BARAT,PALMERAH,PALMERAH,3173071001,2020-10-22,1888,109,1779,6,-11,17
DKI JAKARTA,JAKARTA BARAT,PALMERAH,PALMERAH,3173071001,2020-10-23,1903,123,1780,15,14,1
DKI JAKARTA,JAKARTA BARAT,PALMERAH,PALMERAH,3173071001,2020-10-24,1920,120,1800,17,-3,20
DKI JAKARTA,JAKARTA BARAT,PALMERAH,PALMERAH,3173071001,2020-10-25,1930,122,1808,10,2,8
DKI JAKARTA,JAKARTA BARAT,PALMERAH,PALMERAH,3173071001,2020-10-26,1936,102,1834,6,-20,26
DKI JAKARTA,JAKARTA BARAT,PALMERAH,PALMERAH,3173071001,2020-10-27,1946,94,1852,10,-8,18
DKI JAKARTA,JAKARTA BARAT,PALMERAH,PALMERAH,3173071001,2020-10-28,1956,85,1871,10,-9,19
DKI JAKARTA,JAKARTA BARAT,PALMERAH,PALMERAH,3173071001,2020-10-29,1970,82,1888,14,-3,17
DKI JAKARTA,JAKARTA BARAT,PALMERAH,PALMERAH,3173071001,2020-10-30,1976,84,1892,6,2,4
DKI JAKARTA,JAKARTA BARAT,PALMERAH,PALMERAH,3173071001,2020-10-31,1985,90,1895,9,6,3
DKI JAKARTA,JAKARTA BARAT,PALMERAH,SLIPI,3173071002,2020-10-01,829,86,743,0,0,0
DKI JAKARTA,JAKARTA BARAT,PALMERAH,SLIPI,3173071002,2020-10-02,848,97,751,19,11,8
DKI JAKARTA,JAKARTA BARAT,PALMERAH,SLIPI,3173071002,2020-10-03,874,115,759,26,18,8
DKI JAKARTA,JAKARTA BARAT,PALMERAH,SLIPI,3173071002,2020-10-04,882,110,772,8,-5,13
DKI JAKARTA,JAKARTA BARAT,PALMERAH,SLIPI,3173071002,2020-10-05,884,100,784,2,-10,12
DKI JAKARTA,JAKARTA BARAT,PALMERAH,SLIPI,3173071002,2020-10-06,888,95,793,4,-5,9
DKI JAKARTA,JAKARTA BARAT,PALMERAH,SLIPI,3173071002,2020-10-07,900,100,800,12,5,7
DKI JAKARTA,JAKARTA BARAT,PALMERAH,SLIPI,3173071002,2020-10-08,920,111,809,20,11,9
DKI JAKARTA,JAKARTA BARAT,PALMERAH,SLIPI,3173071002,2020-10-09,921,112,809,1,1,0
DKI JAKARTA,JAKARTA BARAT,PALMERAH,SLIPI,3173071002,2020-10-10,923,101,822,2,-11,13
DKI JAKARTA,JAKARTA BARAT,PALMERAH,SLIPI,3173071002,2020-10-11,946,117,829,23,16,7
DKI JAKARTA,JAKARTA BARAT,PALMERAH,SLIPI,3173071002,2020-10-12,947,100,847,1,-17,18
DKI JAKARTA,JAKARTA BARAT,PALMERAH,SLIPI,3173071002,2020-10-13,951,91,860,4,-9,13
DKI JAKARTA,JAKARTA BARAT,PALMERAH,SLIPI,3173071002,2020-10-14,961,97,864,10,6,4
DKI JAKARTA,JAKARTA BARAT,PALMERAH,SLIPI,3173071002,2020-10-15,969,78,891,8,-19,27
DKI JAKARTA,JAKARTA BARAT,PALMERAH,SLIPI,3173071002,2020-10-16,972,77,895,3,-1,4
DKI JAKARTA,JAKARTA BARAT,PALMERAH,SLIPI,3173071002,2020-10-17,977,77,900,5,0,5
DKI JAKARTA,JAKARTA BARAT,PALMERAH,SLIPI,3173071002,2020-10-18,983,79,904,6,2,4
DKI JAKARTA,JAKARTA BARAT,PALMERAH,SLIPI,3173071002,2020-10-19,983,66,917,0,-13,13
DKI JAKARTA,JAKARTA BARAT,PALMERAH,SLIPI,3173071002,2020-10-20,994,64,930,11,-2,13
DKI JAKARTA,JAKARTA BARAT,PALMERAH,SLIPI,3173071002,2020-10-21,1005,64,941,11,0,11
DKI JAKARTA,JAKARTA BARAT,PALMERAH,SLIPI,3173071002,2020-10-22,1008,57,951,3,-7,10
DKI JAKARTA,JAKARTA BARAT,PALMERAH,SLIPI,3173071002,2020-10-23,1012,59,953,4,2,2
DKI JAKARTA,JAKARTA BARAT,PALMERAH,SLIPI,3173071002,2020-10-24,1024,63,961,12,4,8
DKI JAKARTA,JAKARTA BARAT,PALMERAH,SLIPI,3173071002,2020-10-25,1026,63,963,2,0,2
DKI JAKARTA,JAKARTA BARAT,PALMERAH,SLIPI,3173071002,2020-10-26,1028,50,978,2,-13,15
DKI JAKARTA,JAKARTA BARAT,PALMERAH,SLIPI,3173071002,2020-10-27,1031,48,983,3,-2,5
DKI JAKARTA,JAKARTA BARAT,PALMERAH,SLIPI,3173071002,2020-10-28,1033,46,987,2,-2,4
DKI JAKARTA,JAKARTA BARAT,PALMERAH,SLIPI,3173071002,2020-10-29,1036,41,995,3,-5,8
DKI JAKARTA,JAKARTA BARAT,PALMERAH,SLIPI,3173071002,2020-10-30,1044,41,1003,8,0,8
DKI JAKARTA,JAKARTA BARAT,PALMERAH,SLIPI,3173071002,2020-10-31,1045,41,1004,1,0,1
DKI JAKARTA,JAKARTA BARAT,TAMAN SARI,GLODOK,3173031007,2020-10-01,150,30,120,0,0,0
DKI JAKARTA,JAKARTA BARAT,TAMAN SARI,GLODOK,3173031007,2020-10-02,154,34,120,4,4,0
DKI JAKARTA,JAKARTA BARAT,TAMAN SARI,GLODOK,3173031007,2020-10-03,154,34,120,0,0,0
DKI JAKARTA,JAKARTA BARAT,TAMAN SARI,GLODOK,3173031007,2020-10-04,155,35,120,1,1,0
DKI JAKARTA,JAKARTA BARAT,TAMAN SARI,GLODOK,3173031007,2020-10-05,155,35,120,0,0,0
DKI JAKARTA,JAKARTA BARAT,TAMAN SARI,GLODOK,3173031007,2020-10-06,158,38,120,3,3,0
DKI JAKARTA,JAKARTA BARAT,TAMAN SARI,GLODOK,3173031007,2020-10-07,159,28,131,1,-10,11
DKI JAKARTA,JAKARTA BARAT,TAMAN SARI,GLODOK,3173031007,2020-10-08,159,16,143,0,-12,12
DKI JAKARTA,JAKARTA BARAT,TAMAN SARI,GLODOK,3173031007,2020-10-09,159,16,143,0,0,0
DKI JAKARTA,JAKARTA BARAT,TAMAN SARI,GLODOK,3173031007,2020-10-10,160,14,146,1,-2,3
DKI JAKARTA,JAKARTA BARAT,TAMAN SARI,GLODOK,3173031007,2020-10-11,160,14,146,0,0,0
DKI JAKARTA,JAKARTA BARAT,TAMAN SARI,GLODOK,3173031007,2020-10-12,161,11,150,1,-3,4
DKI JAKARTA,JAKARTA BARAT,TAMAN SARI,GLODOK,3173031007,2020-10-13,162,8,154,1,-3,4
DKI JAKARTA,JAKARTA BARAT,TAMAN SARI,GLODOK,3173031007,2020-10-14,162,8,154,0,0,0
DKI JAKARTA,JAKARTA BARAT,TAMAN SARI,GLODOK,3173031007,2020-10-15,162,7,155,0,-1,1
DKI JAKARTA,JAKARTA BARAT,TAMAN SARI,GLODOK,3173031007,2020-10-16,162,3,159,0,-4,4
DKI JAKARTA,JAKARTA BARAT,TAMAN SARI,GLODOK,3173031007,2020-10-17,163,4,159,1,1,0
DKI JAKARTA,JAKARTA BARAT,TAMAN SARI,GLODOK,3173031007,2020-10-18,165,6,159,2,2,0
DKI JAKARTA,JAKARTA BARAT,TAMAN SARI,GLODOK,3173031007,2020-10-19,165,4,161,0,-2,2
DKI JAKARTA,JAKARTA BARAT,TAMAN SARI,GLODOK,3173031007,2020-10-20,166,4,162,1,0,1
DKI JAKARTA,JAKARTA BARAT,TAMAN SARI,GLODOK,3173031007,2020-10-21,166,4,162,0,0,0
DKI JAKARTA,JAKARTA BARAT,TAMAN SARI,GLODOK,3173031007,2020-10-22,166,3,163,0,-1,1
DKI JAKARTA,JAKARTA BARAT,TAMAN SARI,GLODOK,3173031007,2020-10-23,166,3,163,0,0,0
DKI JAKARTA,JAKARTA BARAT,TAMAN SARI,GLODOK,3173031007,2020-10-24,166,3,163,0,0,0
DKI JAKARTA,JAKARTA BARAT,TAMAN SARI,GLODOK,3173031007,2020-10-25,167,2,165,1,-1,2
DKI JAKARTA,JAKARTA BARAT,TAMAN SARI,GLODOK,3173031007,2020-10-26,167,2,165,0,0,0
DKI JAKARTA,JAKARTA BARAT,TAMAN SARI,GLODOK,3173031007,2020-10-27,168,3,165,1,1,0
DKI JAKARTA,JAKARTA BARAT,TAMAN SARI,GLODOK,3173031007,2020-10-28,171,5,166,3,2,1
DKI JAKARTA,JAKARTA BARAT,TAMAN SARI,GLODOK,3173031007,2020-10-29,171,3,168,0,-2,2
DKI JAKARTA,JAKARTA BARAT,TAMAN SARI,GLODOK,3173031007,2020-10-30,173,5,168,2,2,0
DKI JAKARTA,JAKARTA BARAT,TAMAN SARI,GLODOK,3173031007,2020-10-31,173,5,168,0,0,0
DKI JAKARTA,JAKARTA BARAT,TAMAN SARI,KEAGUNGAN,3173031006,2020-10-01,449,53,396,0,0,0
DKI JAKARTA,JAKARTA BARAT,TAMAN SARI,KEAGUNGAN,3173031006,2020-10-02,452,48,404,3,-5,8
DKI JAKARTA,JAKARTA BARAT,TAMAN SARI,KEAGUNGAN,3173031006,2020-10-03,452,47,405,0,-1,1
DKI JAKARTA,JAKARTA BARAT,TAMAN SARI,KEAGUNGAN,3173031006,2020-10-04,457,51,406,5,4,1
DKI JAKARTA,JAKARTA BARAT,TAMAN SARI,KEAGUNGAN,3173031006,2020-10-05,459,35,424,2,-16,18
DKI JAKARTA,JAKARTA BARAT,TAMAN SARI,KEAGUNGAN,3173031006,2020-10-06,461,26,435,2,-9,11
DKI JAKARTA,JAKARTA BARAT,TAMAN SARI,KEAGUNGAN,3173031006,2020-10-07,468,32,436,7,6,1
DKI JAKARTA,JAKARTA BARAT,TAMAN SARI,KEAGUNGAN,3173031006,2020-10-08,468,26,442,0,-6,6
DKI JAKARTA,JAKARTA BARAT,TAMAN SARI,KEAGUNGAN,3173031006,2020-10-09,470,28,442,2,2,0
DKI JAKARTA,JAKARTA BARAT,TAMAN SARI,KEAGUNGAN,3173031006,2020-10-10,473,28,445,3,0,3
DKI JAKARTA,JAKARTA BARAT,TAMAN SARI,KEAGUNGAN,3173031006,2020-10-11,473,26,447,0,-2,2
DKI JAKARTA,JAKARTA BARAT,TAMAN SARI,KEAGUNGAN,3173031006,2020-10-12,474,19,455,1,-7,8
DKI JAKARTA,JAKARTA BARAT,TAMAN SARI,KEAGUNGAN,3173031006,2020-10-13,474,18,456,0,-1,1
DKI JAKARTA,JAKARTA BARAT,TAMAN SARI,KEAGUNGAN,3173031006,2020-10-14,475,15,460,1,-3,4
DKI JAKARTA,JAKARTA BARAT,TAMAN SARI,KEAGUNGAN,3173031006,2020-10-15,479,16,463,4,1,3
DKI JAKARTA,JAKARTA BARAT,TAMAN SARI,KEAGUNGAN,3173031006,2020-10-16,480,15,465,1,-1,2
DKI JAKARTA,JAKARTA BARAT,TAMAN SARI,KEAGUNGAN,3173031006,2020-10-17,482,12,470,2,-3,5
DKI JAKARTA,JAKARTA BARAT,TAMAN SARI,KEAGUNGAN,3173031006,2020-10-18,484,14,470,2,2,0
DKI JAKARTA,JAKARTA BARAT,TAMAN SARI,KEAGUNGAN,3173031006,2020-10-19,485,14,471,1,0,1
DKI JAKARTA,JAKARTA BARAT,TAMAN SARI,KEAGUNGAN,3173031006,2020-10-20,489,15,474,4,1,3
DKI JAKARTA,JAKARTA BARAT,TAMAN SARI,KEAGUNGAN,3173031006,2020-10-21,494,19,475,5,4,1
DKI JAKARTA,JAKARTA BARAT,TAMAN SARI,KEAGUNGAN,3173031006,2020-10-22,496,18,478,2,-1,3
DKI JAKARTA,JAKARTA BARAT,TAMAN SARI,KEAGUNGAN,3173031006,2020-10-23,496,18,478,0,0,0
DKI JAKARTA,JAKARTA BARAT,TAMAN SARI,KEAGUNGAN,3173031006,2020-10-24,497,19,478,1,1,0
DKI JAKARTA,JAKARTA BARAT,TAMAN SARI,KEAGUNGAN,3173031006,2020-10-25,501,23,478,4,4,0
DKI JAKARTA,JAKARTA BARAT,TAMAN SARI,KEAGUNGAN,3173031006,2020-10-26,502,22,480,1,-1,2
DKI JAKARTA,JAKARTA BARAT,TAMAN SARI,KEAGUNGAN,3173031006,2020-10-27,505,23,482,3,1,2
DKI JAKARTA,JAKARTA BARAT,TAMAN SARI,KEAGUNGAN,3173031006,2020-10-28,506,23,483,1,0,1
DKI JAKARTA,JAKARTA BARAT,TAMAN SARI,KEAGUNGAN,3173031006,2020-10-29,508,22,486,2,-1,3
DKI JAKARTA,JAKARTA BARAT,TAMAN SARI,KEAGUNGAN,3173031006,2020-10-30,509,19,490,1,-3,4
DKI JAKARTA,JAKARTA BARAT,TAMAN SARI,KEAGUNGAN,3173031006,2020-10-31,510,19,491,1,0,1
DKI JAKARTA,JAKARTA BARAT,TAMAN SARI,KRUKUT,3173031002,2020-10-01,367,50,317,0,0,0
DKI JAKARTA,JAKARTA BARAT,TAMAN SARI,KRUKUT,3173031002,2020-10-02,377,51,326,10,1,9
DKI JAKARTA,JAKARTA BARAT,TAMAN SARI,KRUKUT,3173031002,2020-10-03,380,53,327,3,2,1
DKI JAKARTA,JAKARTA BARAT,TAMAN SARI,KRUKUT,3173031002,2020-10-04,389,60,329,9,7,2
DKI JAKARTA,JAKARTA BARAT,TAMAN SARI,KRUKUT,3173031002,2020-10-05,389,59,330,0,-1,1
DKI JAKARTA,JAKARTA BARAT,TAMAN SARI,KRUKUT,3173031002,2020-10-06,398,65,333,9,6,3
DKI JAKARTA,JAKARTA BARAT,TAMAN SARI,KRUKUT,3173031002,2020-10-07,400,61,339,2,-4,6
DKI JAKARTA,JAKARTA BARAT,TAMAN SARI,KRUKUT,3173031002,2020-10-08,411,64,347,11,3,8
DKI JAKARTA,JAKARTA BARAT,TAMAN SARI,KRUKUT,3173031002,2020-10-09,413,66,347,2,2,0
DKI JAKARTA,JAKARTA BARAT,TAMAN SARI,KRUKUT,3173031002,2020-10-10,417,67,350,4,1,3
DKI JAKARTA,JAKARTA BARAT,TAMAN SARI,KRUKUT,3173031002,2020-10-11,418,67,351,1,0,1
DKI JAKARTA,JAKARTA BARAT,TAMAN SARI,KRUKUT,3173031002,2020-10-12,421,54,367,3,-13,16
DKI JAKARTA,JAKARTA BARAT,TAMAN SARI,KRUKUT,3173031002,2020-10-13,422,41,381,1,-13,14
DKI JAKARTA,JAKARTA BARAT,TAMAN SARI,KRUKUT,3173031002,2020-10-14,424,32,392,2,-9,11
DKI JAKARTA,JAKARTA BARAT,TAMAN SARI,KRUKUT,3173031002,2020-10-15,432,38,394,8,6,2
DKI JAKARTA,JAKARTA BARAT,TAMAN SARI,KRUKUT,3173031002,2020-10-16,435,30,405,3,-8,11
DKI JAKARTA,JAKARTA BARAT,TAMAN SARI,KRUKUT,3173031002,2020-10-17,439,34,405,4,4,0
DKI JAKARTA,JAKARTA BARAT,TAMAN SARI,KRUKUT,3173031002,2020-10-18,452,46,406,13,12,1
DKI JAKARTA,JAKARTA BARAT,TAMAN SARI,KRUKUT,3173031002,2020-10-19,453,43,410,1,-3,4
DKI JAKARTA,JAKARTA BARAT,TAMAN SARI,KRUKUT,3173031002,2020-10-20,458,42,416,5,-1,6
DKI JAKARTA,JAKARTA BARAT,TAMAN SARI,KRUKUT,3173031002,2020-10-21,458,38,420,0,-4,4
DKI JAKARTA,JAKARTA BARAT,TAMAN SARI,KRUKUT,3173031002,2020-10-22,458,34,424,0,-4,4
DKI JAKARTA,JAKARTA BARAT,TAMAN SARI,KRUKUT,3173031002,2020-10-23,463,38,425,5,4,1
DKI JAKARTA,JAKARTA BARAT,TAMAN SARI,KRUKUT,3173031002,2020-10-24,468,41,427,5,3,2
DKI JAKARTA,JAKARTA BARAT,TAMAN SARI,KRUKUT,3173031002,2020-10-25,468,40,428,0,-1,1
DKI JAKARTA,JAKARTA BARAT,TAMAN SARI,KRUKUT,3173031002,2020-10-26,470,38,432,2,-2,4
DKI JAKARTA,JAKARTA BARAT,TAMAN SARI,KRUKUT,3173031002,2020-10-27,479,34,445,9,-4,13
DKI JAKARTA,JAKARTA BARAT,TAMAN SARI,KRUKUT,3173031002,2020-10-28,479,31,448,0,-3,3
DKI JAKARTA,JAKARTA BARAT,TAMAN SARI,KRUKUT,3173031002,2020-10-29,480,28,452,1,-3,4
DKI JAKARTA,JAKARTA BARAT,TAMAN SARI,KRUKUT,3173031002,2020-10-30,485,19,466,5,-9,14
DKI JAKARTA,JAKARTA BARAT,TAMAN SARI,KRUKUT,3173031002,2020-10-31,488,21,467,3,2,1
DKI JAKARTA,JAKARTA BARAT,TAMAN SARI,MANGGA BESAR,3173031005,2020-10-01,139,4,135,0,0,0
DKI JAKARTA,JAKARTA BARAT,TAMAN SARI,MANGGA BESAR,3173031005,2020-10-02,144,8,136,5,4,1
DKI JAKARTA,JAKARTA BARAT,TAMAN SARI,MANGGA BESAR,3173031005,2020-10-03,145,9,136,1,1,0
DKI JAKARTA,JAKARTA BARAT,TAMAN SARI,MANGGA BESAR,3173031005,2020-10-04,146,9,137,1,0,1
DKI JAKARTA,JAKARTA BARAT,TAMAN SARI,MANGGA BESAR,3173031005,2020-10-05,146,9,137,0,0,0
DKI JAKARTA,JAKARTA BARAT,TAMAN SARI,MANGGA BESAR,3173031005,2020-10-06,146,9,137,0,0,0
DKI JAKARTA,JAKARTA BARAT,TAMAN SARI,MANGGA BESAR,3173031005,2020-10-07,150,12,138,4,3,1
DKI JAKARTA,JAKARTA BARAT,TAMAN SARI,MANGGA BESAR,3173031005,2020-10-08,152,14,138,2,2,0
DKI JAKARTA,JAKARTA BARAT,TAMAN SARI,MANGGA BESAR,3173031005,2020-10-09,154,14,140,2,0,2
DKI JAKARTA,JAKARTA BARAT,TAMAN SARI,MANGGA BESAR,3173031005,2020-10-10,156,12,144,2,-2,4
DKI JAKARTA,JAKARTA BARAT,TAMAN SARI,MANGGA BESAR,3173031005,2020-10-11,156,11,145,0,-1,1
DKI JAKARTA,JAKARTA BARAT,TAMAN SARI,MANGGA BESAR,3173031005,2020-10-12,158,12,146,2,1,1
DKI JAKARTA,JAKARTA BARAT,TAMAN SARI,MANGGA BESAR,3173031005,2020-10-13,160,11,149,2,-1,3
DKI JAKARTA,JAKARTA BARAT,TAMAN SARI,MANGGA BESAR,3173031005,2020-10-14,160,9,151,0,-2,2
DKI JAKARTA,JAKARTA BARAT,TAMAN SARI,MANGGA BESAR,3173031005,2020-10-15,164,13,151,4,4,0
DKI JAKARTA,JAKARTA BARAT,TAMAN SARI,MANGGA BESAR,3173031005,2020-10-16,164,13,151,0,0,0
DKI JAKARTA,JAKARTA BARAT,TAMAN SARI,MANGGA BESAR,3173031005,2020-10-17,168,15,153,4,2,2
DKI JAKARTA,JAKARTA BARAT,TAMAN SARI,MANGGA BESAR,3173031005,2020-10-18,170,17,153,2,2,0
DKI JAKARTA,JAKARTA BARAT,TAMAN SARI,MANGGA BESAR,3173031005,2020-10-19,170,17,153,0,0,0
DKI JAKARTA,JAKARTA BARAT,TAMAN SARI,MANGGA BESAR,3173031005,2020-10-20,172,18,154,2,1,1
DKI JAKARTA,JAKARTA BARAT,TAMAN SARI,MANGGA BESAR,3173031005,2020-10-21,182,26,156,10,8,2
DKI JAKARTA,JAKARTA BARAT,TAMAN SARI,MANGGA BESAR,3173031005,2020-10-22,183,24,159,1,-2,3
DKI JAKARTA,JAKARTA BARAT,TAMAN SARI,MANGGA BESAR,3173031005,2020-10-23,184,25,159,1,1,0
DKI JAKARTA,JAKARTA BARAT,TAMAN SARI,MANGGA BESAR,3173031005,2020-10-24,184,21,163,0,-4,4
DKI JAKARTA,JAKARTA BARAT,TAMAN SARI,MANGGA BESAR,3173031005,2020-10-25,186,20,166,2,-1,3
DKI JAKARTA,JAKARTA BARAT,TAMAN SARI,MANGGA BESAR,3173031005,2020-10-26,186,16,170,0,-4,4
DKI JAKARTA,JAKARTA BARAT,TAMAN SARI,MANGGA BESAR,3173031005,2020-10-27,187,15,172,1,-1,2
DKI JAKARTA,JAKARTA BARAT,TAMAN SARI,MANGGA BESAR,3173031005,2020-10-28,188,15,173,1,0,1
DKI JAKARTA,JAKARTA BARAT,TAMAN SARI,MANGGA BESAR,3173031005,2020-10-29,188,11,177,0,-4,4
DKI JAKARTA,JAKARTA BARAT,TAMAN SARI,MANGGA BESAR,3173031005,2020-10-30,196,14,182,8,3,5
DKI JAKARTA,JAKARTA BARAT,TAMAN SARI,MANGGA BESAR,3173031005,2020-10-31,197,15,182,1,1,0
DKI JAKARTA,JAKARTA BARAT,TAMAN SARI,MAPHAR,3173031003,2020-10-01,329,26,303,0,0,0
DKI JAKARTA,JAKARTA BARAT,TAMAN SARI,MAPHAR,3173031003,2020-10-02,333,29,304,4,3,1
DKI JAKARTA,JAKARTA BARAT,TAMAN SARI,MAPHAR,3173031003,2020-10-03,337,32,305,4,3,1
DKI JAKARTA,JAKARTA BARAT,TAMAN SARI,MAPHAR,3173031003,2020-10-04,337,31,306,0,-1,1
DKI JAKARTA,JAKARTA BARAT,TAMAN SARI,MAPHAR,3173031003,2020-10-05,338,29,309,1,-2,3
DKI JAKARTA,JAKARTA BARAT,TAMAN SARI,MAPHAR,3173031003,2020-10-06,339,27,312,1,-2,3
DKI JAKARTA,JAKARTA BARAT,TAMAN SARI,MAPHAR,3173031003,2020-10-07,348,31,317,9,4,5
DKI JAKARTA,JAKARTA BARAT,TAMAN SARI,MAPHAR,3173031003,2020-10-08,360,42,318,12,11,1
DKI JAKARTA,JAKARTA BARAT,TAMAN SARI,MAPHAR,3173031003,2020-10-09,362,44,318,2,2,0
DKI JAKARTA,JAKARTA BARAT,TAMAN SARI,MAPHAR,3173031003,2020-10-10,363,43,320,1,-1,2
DKI JAKARTA,JAKARTA BARAT,TAMAN SARI,MAPHAR,3173031003,2020-10-11,364,44,320,1,1,0
DKI JAKARTA,JAKARTA BARAT,TAMAN SARI,MAPHAR,3173031003,2020-10-12,367,40,327,3,-4,7
DKI JAKARTA,JAKARTA BARAT,TAMAN SARI,MAPHAR,3173031003,2020-10-13,368,31,337,1,-9,10
DKI JAKARTA,JAKARTA BARAT,TAMAN SARI,MAPHAR,3173031003,2020-10-14,370,32,338,2,1,1
DKI JAKARTA,JAKARTA BARAT,TAMAN SARI,MAPHAR,3173031003,2020-10-15,372,33,339,2,1,1
DKI JAKARTA,JAKARTA BARAT,TAMAN SARI,MAPHAR,3173031003,2020-10-16,377,35,342,5,2,3
DKI JAKARTA,JAKARTA BARAT,TAMAN SARI,MAPHAR,3173031003,2020-10-17,379,36,343,2,1,1
DKI JAKARTA,JAKARTA BARAT,TAMAN SARI,MAPHAR,3173031003,2020-10-18,379,35,344,0,-1,1
DKI JAKARTA,JAKARTA BARAT,TAMAN SARI,MAPHAR,3173031003,2020-10-19,380,27,353,1,-8,9
DKI JAKARTA,JAKARTA BARAT,TAMAN SARI,MAPHAR,3173031003,2020-10-20,383,21,362,3,-6,9
DKI JAKARTA,JAKARTA BARAT,TAMAN SARI,MAPHAR,3173031003,2020-10-21,383,16,367,0,-5,5
DKI JAKARTA,JAKARTA BARAT,TAMAN SARI,MAPHAR,3173031003,2020-10-22,384,13,371,1,-3,4
DKI JAKARTA,JAKARTA BARAT,TAMAN SARI,MAPHAR,3173031003,2020-10-23,386,14,372,2,1,1
DKI JAKARTA,JAKARTA BARAT,TAMAN SARI,MAPHAR,3173031003,2020-10-24,393,18,375,7,4,3
DKI JAKARTA,JAKARTA BARAT,TAMAN SARI,MAPHAR,3173031003,2020-10-25,394,17,377,1,-1,2
DKI JAKARTA,JAKARTA BARAT,TAMAN SARI,MAPHAR,3173031003,2020-10-26,395,18,377,1,1,0
DKI JAKARTA,JAKARTA BARAT,TAMAN SARI,MAPHAR,3173031003,2020-10-27,398,15,383,3,-3,6
DKI JAKARTA,JAKARTA BARAT,TAMAN SARI,MAPHAR,3173031003,2020-10-28,399,11,388,1,-4,5
DKI JAKARTA,JAKARTA BARAT,TAMAN SARI,MAPHAR,3173031003,2020-10-29,402,10,392,3,-1,4
DKI JAKARTA,JAKARTA BARAT,TAMAN SARI,MAPHAR,3173031003,2020-10-30,405,10,395,3,0,3
DKI JAKARTA,JAKARTA BARAT,TAMAN SARI,MAPHAR,3173031003,2020-10-31,406,11,395,1,1,0
DKI JAKARTA,JAKARTA BARAT,TAMAN SARI,PINANGSIA,3173031008,2020-10-01,206,35,171,0,0,0
DKI JAKARTA,JAKARTA BARAT,TAMAN SARI,PINANGSIA,3173031008,2020-10-02,206,31,175,0,-4,4
DKI JAKARTA,JAKARTA BARAT,TAMAN SARI,PINANGSIA,3173031008,2020-10-03,206,32,174,0,1,-1
DKI JAKARTA,JAKARTA BARAT,TAMAN SARI,PINANGSIA,3173031008,2020-10-04,208,33,175,2,1,1
DKI JAKARTA,JAKARTA BARAT,TAMAN SARI,PINANGSIA,3173031008,2020-10-05,208,23,185,0,-10,10
DKI JAKARTA,JAKARTA BARAT,TAMAN SARI,PINANGSIA,3173031008,2020-10-06,210,20,190,2,-3,5
DKI JAKARTA,JAKARTA BARAT,TAMAN SARI,PINANGSIA,3173031008,2020-10-07,215,12,203,5,-8,13
DKI JAKARTA,JAKARTA BARAT,TAMAN SARI,PINANGSIA,3173031008,2020-10-08,217,14,203,2,2,0
DKI JAKARTA,JAKARTA BARAT,TAMAN SARI,PINANGSIA,3173031008,2020-10-09,218,15,203,1,1,0
DKI JAKARTA,JAKARTA BARAT,TAMAN SARI,PINANGSIA,3173031008,2020-10-10,220,15,205,2,0,2
DKI JAKARTA,JAKARTA BARAT,TAMAN SARI,PINANGSIA,3173031008,2020-10-11,222,17,205,2,2,0
DKI JAKARTA,JAKARTA BARAT,TAMAN SARI,PINANGSIA,3173031008,2020-10-12,225,19,206,3,2,1
DKI JAKARTA,JAKARTA BARAT,TAMAN SARI,PINANGSIA,3173031008,2020-10-13,225,19,206,0,0,0
DKI JAKARTA,JAKARTA BARAT,TAMAN SARI,PINANGSIA,3173031008,2020-10-14,230,21,209,5,2,3
DKI JAKARTA,JAKARTA BARAT,TAMAN SARI,PINANGSIA,3173031008,2020-10-15,236,27,209,6,6,0
DKI JAKARTA,JAKARTA BARAT,TAMAN SARI,PINANGSIA,3173031008,2020-10-16,236,23,213,0,-4,4
DKI JAKARTA,JAKARTA BARAT,TAMAN SARI,PINANGSIA,3173031008,2020-10-17,238,22,216,2,-1,3
DKI JAKARTA,JAKARTA BARAT,TAMAN SARI,PINANGSIA,3173031008,2020-10-18,239,22,217,1,0,1
DKI JAKARTA,JAKARTA BARAT,TAMAN SARI,PINANGSIA,3173031008,2020-10-19,239,22,217,0,0,0
DKI JAKARTA,JAKARTA BARAT,TAMAN SARI,PINANGSIA,3173031008,2020-10-20,242,23,219,3,1,2
DKI JAKARTA,JAKARTA BARAT,TAMAN SARI,PINANGSIA,3173031008,2020-10-21,242,18,224,0,-5,5
DKI JAKARTA,JAKARTA BARAT,TAMAN SARI,PINANGSIA,3173031008,2020-10-22,242,18,224,0,0,0
DKI JAKARTA,JAKARTA BARAT,TAMAN SARI,PINANGSIA,3173031008,2020-10-23,246,19,227,4,1,3
DKI JAKARTA,JAKARTA BARAT,TAMAN SARI,PINANGSIA,3173031008,2020-10-24,246,15,231,0,-4,4
DKI JAKARTA,JAKARTA BARAT,TAMAN SARI,PINANGSIA,3173031008,2020-10-25,247,16,231,1,1,0
DKI JAKARTA,JAKARTA BARAT,TAMAN SARI,PINANGSIA,3173031008,2020-10-26,247,10,237,0,-6,6
DKI JAKARTA,JAKARTA BARAT,TAMAN SARI,PINANGSIA,3173031008,2020-10-27,250,8,242,3,-2,5
DKI JAKARTA,JAKARTA BARAT,TAMAN SARI,PINANGSIA,3173031008,2020-10-28,250,6,244,0,-2,2
DKI JAKARTA,JAKARTA BARAT,TAMAN SARI,PINANGSIA,3173031008,2020-10-29,252,7,245,2,1,1
DKI JAKARTA,JAKARTA BARAT,TAMAN SARI,PINANGSIA,3173031008,2020-10-30,254,7,247,2,0,2
DKI JAKARTA,JAKARTA BARAT,TAMAN SARI,PINANGSIA,3173031008,2020-10-31,254,7,247,0,0,0
DKI JAKARTA,JAKARTA BARAT,TAMAN SARI,TAMAN SARI,3173031001,2020-10-01,332,47,285,0,0,0
DKI JAKARTA,JAKARTA BARAT,TAMAN SARI,TAMAN SARI,3173031001,2020-10-02,340,47,293,8,0,8
DKI JAKARTA,JAKARTA BARAT,TAMAN SARI,TAMAN SARI,3173031001,2020-10-03,342,48,294,2,1,1
DKI JAKARTA,JAKARTA BARAT,TAMAN SARI,TAMAN SARI,3173031001,2020-10-04,348,53,295,6,5,1
DKI JAKARTA,JAKARTA BARAT,TAMAN SARI,TAMAN SARI,3173031001,2020-10-05,348,46,302,0,-7,7
DKI JAKARTA,JAKARTA BARAT,TAMAN SARI,TAMAN SARI,3173031001,2020-10-06,353,50,303,5,4,1
DKI JAKARTA,JAKARTA BARAT,TAMAN SARI,TAMAN SARI,3173031001,2020-10-07,357,52,305,4,2,2
DKI JAKARTA,JAKARTA BARAT,TAMAN SARI,TAMAN SARI,3173031001,2020-10-08,362,49,313,5,-3,8
DKI JAKARTA,JAKARTA BARAT,TAMAN SARI,TAMAN SARI,3173031001,2020-10-09,365,52,313,3,3,0
DKI JAKARTA,JAKARTA BARAT,TAMAN SARI,TAMAN SARI,3173031001,2020-10-10,368,47,321,3,-5,8
DKI JAKARTA,JAKARTA BARAT,TAMAN SARI,TAMAN SARI,3173031001,2020-10-11,370,49,321,2,2,0
DKI JAKARTA,JAKARTA BARAT,TAMAN SARI,TAMAN SARI,3173031001,2020-10-12,374,45,329,4,-4,8
DKI JAKARTA,JAKARTA BARAT,TAMAN SARI,TAMAN SARI,3173031001,2020-10-13,375,29,346,1,-16,17
DKI JAKARTA,JAKARTA BARAT,TAMAN SARI,TAMAN SARI,3173031001,2020-10-14,382,33,349,7,4,3
DKI JAKARTA,JAKARTA BARAT,TAMAN SARI,TAMAN SARI,3173031001,2020-10-15,388,37,351,6,4,2
DKI JAKARTA,JAKARTA BARAT,TAMAN SARI,TAMAN SARI,3173031001,2020-10-16,389,30,359,1,-7,8
DKI JAKARTA,JAKARTA BARAT,TAMAN SARI,TAMAN SARI,3173031001,2020-10-17,398,36,362,9,6,3
DKI JAKARTA,JAKARTA BARAT,TAMAN SARI,TAMAN SARI,3173031001,2020-10-18,407,43,364,9,7,2
DKI JAKARTA,JAKARTA BARAT,TAMAN SARI,TAMAN SARI,3173031001,2020-10-19,407,40,367,0,-3,3
DKI JAKARTA,JAKARTA BARAT,TAMAN SARI,TAMAN SARI,3173031001,2020-10-20,409,36,373,2,-4,6
DKI JAKARTA,JAKARTA BARAT,TAMAN SARI,TAMAN SARI,3173031001,2020-10-21,409,35,374,0,-1,1
DKI JAKARTA,JAKARTA BARAT,TAMAN SARI,TAMAN SARI,3173031001,2020-10-22,412,35,377,3,0,3
DKI JAKARTA,JAKARTA BARAT,TAMAN SARI,TAMAN SARI,3173031001,2020-10-23,421,37,384,9,2,7
DKI JAKARTA,JAKARTA BARAT,TAMAN SARI,TAMAN SARI,3173031001,2020-10-24,421,35,386,0,-2,2
DKI JAKARTA,JAKARTA BARAT,TAMAN SARI,TAMAN SARI,3173031001,2020-10-25,424,34,390,3,-1,4
DKI JAKARTA,JAKARTA BARAT,TAMAN SARI,TAMAN SARI,3173031001,2020-10-26,424,22,402,0,-12,12
DKI JAKARTA,JAKARTA BARAT,TAMAN SARI,TAMAN SARI,3173031001,2020-10-27,438,32,406,14,10,4
DKI JAKARTA,JAKARTA BARAT,TAMAN SARI,TAMAN SARI,3173031001,2020-10-28,439,30,409,1,-2,3
DKI JAKARTA,JAKARTA BARAT,TAMAN SARI,TAMAN SARI,3173031001,2020-10-29,439,25,414,0,-5,5
DKI JAKARTA,JAKARTA BARAT,TAMAN SARI,TAMAN SARI,3173031001,2020-10-30,441,18,423,2,-7,9
DKI JAKARTA,JAKARTA BARAT,TAMAN SARI,TAMAN SARI,3173031001,2020-10-31,444,20,424,3,2,1
DKI JAKARTA,JAKARTA BARAT,TAMAN SARI,TANGKI,3173031004,2020-10-01,253,16,237,0,0,0
DKI JAKARTA,JAKARTA BARAT,TAMAN SARI,TANGKI,3173031004,2020-10-02,261,21,240,8,5,3
DKI JAKARTA,JAKARTA BARAT,TAMAN SARI,TANGKI,3173031004,2020-10-03,262,21,241,1,0,1
DKI JAKARTA,JAKARTA BARAT,TAMAN SARI,TANGKI,3173031004,2020-10-04,266,25,241,4,4,0
DKI JAKARTA,JAKARTA BARAT,TAMAN SARI,TANGKI,3173031004,2020-10-05,267,22,245,1,-3,4
DKI JAKARTA,JAKARTA BARAT,TAMAN SARI,TANGKI,3173031004,2020-10-06,267,22,245,0,0,0
DKI JAKARTA,JAKARTA BARAT,TAMAN SARI,TANGKI,3173031004,2020-10-07,271,25,246,4,3,1
DKI JAKARTA,JAKARTA BARAT,TAMAN SARI,TANGKI,3173031004,2020-10-08,278,29,249,7,4,3
DKI JAKARTA,JAKARTA BARAT,TAMAN SARI,TANGKI,3173031004,2020-10-09,278,29,249,0,0,0
DKI JAKARTA,JAKARTA BARAT,TAMAN SARI,TANGKI,3173031004,2020-10-10,279,26,253,1,-3,4
DKI JAKARTA,JAKARTA BARAT,TAMAN SARI,TANGKI,3173031004,2020-10-11,281,27,254,2,1,1
DKI JAKARTA,JAKARTA BARAT,TAMAN SARI,TANGKI,3173031004,2020-10-12,282,21,261,1,-6,7
DKI JAKARTA,JAKARTA BARAT,TAMAN SARI,TANGKI,3173031004,2020-10-13,285,22,263,3,1,2
DKI JAKARTA,JAKARTA BARAT,TAMAN SARI,TANGKI,3173031004,2020-10-14,285,17,268,0,-5,5
DKI JAKARTA,JAKARTA BARAT,TAMAN SARI,TANGKI,3173031004,2020-10-15,291,23,268,6,6,0
DKI JAKARTA,JAKARTA BARAT,TAMAN SARI,TANGKI,3173031004,2020-10-16,292,24,268,1,1,0
DKI JAKARTA,JAKARTA BARAT,TAMAN SARI,TANGKI,3173031004,2020-10-17,295,27,268,3,3,0
DKI JAKARTA,JAKARTA BARAT,TAMAN SARI,TANGKI,3173031004,2020-10-18,297,29,268,2,2,0
DKI JAKARTA,JAKARTA BARAT,TAMAN SARI,TANGKI,3173031004,2020-10-19,297,24,273,0,-5,5
DKI JAKARTA,JAKARTA BARAT,TAMAN SARI,TANGKI,3173031004,2020-10-20,301,22,279,4,-2,6
DKI JAKARTA,JAKARTA BARAT,TAMAN SARI,TANGKI,3173031004,2020-10-21,307,24,283,6,2,4
DKI JAKARTA,JAKARTA BARAT,TAMAN SARI,TANGKI,3173031004,2020-10-22,307,20,287,0,-4,4
DKI JAKARTA,JAKARTA BARAT,TAMAN SARI,TANGKI,3173031004,2020-10-23,310,23,287,3,3,0
DKI JAKARTA,JAKARTA BARAT,TAMAN SARI,TANGKI,3173031004,2020-10-24,312,23,289,2,0,2
DKI JAKARTA,JAKARTA BARAT,TAMAN SARI,TANGKI,3173031004,2020-10-25,312,23,289,0,0,0
DKI JAKARTA,JAKARTA BARAT,TAMAN SARI,TANGKI,3173031004,2020-10-26,315,23,292,3,0,3
DKI JAKARTA,JAKARTA BARAT,TAMAN SARI,TANGKI,3173031004,2020-10-27,320,25,295,5,2,3
DKI JAKARTA,JAKARTA BARAT,TAMAN SARI,TANGKI,3173031004,2020-10-28,320,21,299,0,-4,4
DKI JAKARTA,JAKARTA BARAT,TAMAN SARI,TANGKI,3173031004,2020-10-29,323,18,305,3,-3,6
DKI JAKARTA,JAKARTA BARAT,TAMAN SARI,TANGKI,3173031004,2020-10-30,328,21,307,5,3,2
DKI JAKARTA,JAKARTA BARAT,TAMAN SARI,TANGKI,3173031004,2020-10-31,329,18,311,1,-3,4
DKI JAKARTA,JAKARTA BARAT,TAMBORA,ANGKE,3173041007,2020-10-01,435,18,417,0,0,0
DKI JAKARTA,JAKARTA BARAT,TAMBORA,ANGKE,3173041007,2020-10-02,439,20,419,4,2,2
DKI JAKARTA,JAKARTA BARAT,TAMBORA,ANGKE,3173041007,2020-10-03,440,18,422,1,-2,3
DKI JAKARTA,JAKARTA BARAT,TAMBORA,ANGKE,3173041007,2020-10-04,442,19,423,2,1,1
DKI JAKARTA,JAKARTA BARAT,TAMBORA,ANGKE,3173041007,2020-10-05,444,17,427,2,-2,4
DKI JAKARTA,JAKARTA BARAT,TAMBORA,ANGKE,3173041007,2020-10-06,444,16,428,0,-1,1
DKI JAKARTA,JAKARTA BARAT,TAMBORA,ANGKE,3173041007,2020-10-07,448,17,431,4,1,3
DKI JAKARTA,JAKARTA BARAT,TAMBORA,ANGKE,3173041007,2020-10-08,450,16,434,2,-1,3
DKI JAKARTA,JAKARTA BARAT,TAMBORA,ANGKE,3173041007,2020-10-09,451,17,434,1,1,0
DKI JAKARTA,JAKARTA BARAT,TAMBORA,ANGKE,3173041007,2020-10-10,453,15,438,2,-2,4
DKI JAKARTA,JAKARTA BARAT,TAMBORA,ANGKE,3173041007,2020-10-11,453,12,441,0,-3,3
DKI JAKARTA,JAKARTA BARAT,TAMBORA,ANGKE,3173041007,2020-10-12,456,10,446,3,-2,5
DKI JAKARTA,JAKARTA BARAT,TAMBORA,ANGKE,3173041007,2020-10-13,458,9,449,2,-1,3
DKI JAKARTA,JAKARTA BARAT,TAMBORA,ANGKE,3173041007,2020-10-14,458,9,449,0,0,0
DKI JAKARTA,JAKARTA BARAT,TAMBORA,ANGKE,3173041007,2020-10-15,461,8,453,3,-1,4
DKI JAKARTA,JAKARTA BARAT,TAMBORA,ANGKE,3173041007,2020-10-16,462,9,453,1,1,0
DKI JAKARTA,JAKARTA BARAT,TAMBORA,ANGKE,3173041007,2020-10-17,463,10,453,1,1,0
DKI JAKARTA,JAKARTA BARAT,TAMBORA,ANGKE,3173041007,2020-10-18,466,11,455,3,1,2
DKI JAKARTA,JAKARTA BARAT,TAMBORA,ANGKE,3173041007,2020-10-19,466,6,460,0,-5,5
DKI JAKARTA,JAKARTA BARAT,TAMBORA,ANGKE,3173041007,2020-10-20,468,8,460,2,2,0
DKI JAKARTA,JAKARTA BARAT,TAMBORA,ANGKE,3173041007,2020-10-21,469,9,460,1,1,0
DKI JAKARTA,JAKARTA BARAT,TAMBORA,ANGKE,3173041007,2020-10-22,472,9,463,3,0,3
DKI JAKARTA,JAKARTA BARAT,TAMBORA,ANGKE,3173041007,2020-10-23,472,9,463,0,0,0
DKI JAKARTA,JAKARTA BARAT,TAMBORA,ANGKE,3173041007,2020-10-24,473,7,466,1,-2,3
DKI JAKARTA,JAKARTA BARAT,TAMBORA,ANGKE,3173041007,2020-10-25,476,8,468,3,1,2
DKI JAKARTA,JAKARTA BARAT,TAMBORA,ANGKE,3173041007,2020-10-26,476,8,468,0,0,0
DKI JAKARTA,JAKARTA BARAT,TAMBORA,ANGKE,3173041007,2020-10-27,480,10,470,4,2,2
DKI JAKARTA,JAKARTA BARAT,TAMBORA,ANGKE,3173041007,2020-10-28,480,9,471,0,-1,1
DKI JAKARTA,JAKARTA BARAT,TAMBORA,ANGKE,3173041007,2020-10-29,484,12,472,4,3,1
DKI JAKARTA,JAKARTA BARAT,TAMBORA,ANGKE,3173041007,2020-10-30,492,18,474,8,6,2
DKI JAKARTA,JAKARTA BARAT,TAMBORA,ANGKE,3173041007,2020-10-31,495,20,475,3,2,1
DKI JAKARTA,JAKARTA BARAT,TAMBORA,DURI SELATAN,3173041011,2020-10-01,126,7,119,0,0,0
DKI JAKARTA,JAKARTA BARAT,TAMBORA,DURI SELATAN,3173041011,2020-10-02,128,8,120,2,1,1
DKI JAKARTA,JAKARTA BARAT,TAMBORA,DURI SELATAN,3173041011,2020-10-03,128,7,121,0,-1,1
DKI JAKARTA,JAKARTA BARAT,TAMBORA,DURI SELATAN,3173041011,2020-10-04,133,10,123,5,3,2
DKI JAKARTA,JAKARTA BARAT,TAMBORA,DURI SELATAN,3173041011,2020-10-05,133,7,126,0,-3,3
DKI JAKARTA,JAKARTA BARAT,TAMBORA,DURI SELATAN,3173041011,2020-10-06,133,7,126,0,0,0
DKI JAKARTA,JAKARTA BARAT,TAMBORA,DURI SELATAN,3173041011,2020-10-07,135,9,126,2,2,0
DKI JAKARTA,JAKARTA BARAT,TAMBORA,DURI SELATAN,3173041011,2020-10-08,137,11,126,2,2,0
DKI JAKARTA,JAKARTA BARAT,TAMBORA,DURI SELATAN,3173041011,2020-10-09,138,12,126,1,1,0
DKI JAKARTA,JAKARTA BARAT,TAMBORA,DURI SELATAN,3173041011,2020-10-10,140,10,130,2,-2,4
DKI JAKARTA,JAKARTA BARAT,TAMBORA,DURI SELATAN,3173041011,2020-10-11,140,10,130,0,0,0
DKI JAKARTA,JAKARTA BARAT,TAMBORA,DURI SELATAN,3173041011,2020-10-12,141,10,131,1,0,1
DKI JAKARTA,JAKARTA BARAT,TAMBORA,DURI SELATAN,3173041011,2020-10-13,144,12,132,3,2,1
DKI JAKARTA,JAKARTA BARAT,TAMBORA,DURI SELATAN,3173041011,2020-10-14,144,12,132,0,0,0
DKI JAKARTA,JAKARTA BARAT,TAMBORA,DURI SELATAN,3173041011,2020-10-15,145,12,133,1,0,1
DKI JAKARTA,JAKARTA BARAT,TAMBORA,DURI SELATAN,3173041011,2020-10-16,152,12,140,7,0,7
DKI JAKARTA,JAKARTA BARAT,TAMBORA,DURI SELATAN,3173041011,2020-10-17,155,12,143,3,0,3
DKI JAKARTA,JAKARTA BARAT,TAMBORA,DURI SELATAN,3173041011,2020-10-18,156,13,143,1,1,0
DKI JAKARTA,JAKARTA BARAT,TAMBORA,DURI SELATAN,3173041011,2020-10-19,156,12,144,0,-1,1
DKI JAKARTA,JAKARTA BARAT,TAMBORA,DURI SELATAN,3173041011,2020-10-20,157,10,147,1,-2,3
DKI JAKARTA,JAKARTA BARAT,TAMBORA,DURI SELATAN,3173041011,2020-10-21,157,10,147,0,0,0
DKI JAKARTA,JAKARTA BARAT,TAMBORA,DURI SELATAN,3173041011,2020-10-22,157,9,148,0,-1,1
DKI JAKARTA,JAKARTA BARAT,TAMBORA,DURI SELATAN,3173041011,2020-10-23,157,9,148,0,0,0
DKI JAKARTA,JAKARTA BARAT,TAMBORA,DURI SELATAN,3173041011,2020-10-24,157,8,149,0,-1,1
DKI JAKARTA,JAKARTA BARAT,TAMBORA,DURI SELATAN,3173041011,2020-10-25,159,7,152,2,-1,3
DKI JAKARTA,JAKARTA BARAT,TAMBORA,DURI SELATAN,3173041011,2020-10-26,162,9,153,3,2,1
DKI JAKARTA,JAKARTA BARAT,TAMBORA,DURI SELATAN,3173041011,2020-10-27,169,11,158,7,2,5
DKI JAKARTA,JAKARTA BARAT,TAMBORA,DURI SELATAN,3173041011,2020-10-28,169,2,167,0,-9,9
DKI JAKARTA,JAKARTA BARAT,TAMBORA,DURI SELATAN,3173041011,2020-10-29,170,3,167,1,1,0
DKI JAKARTA,JAKARTA BARAT,TAMBORA,DURI SELATAN,3173041011,2020-10-30,173,4,169,3,1,2
DKI JAKARTA,JAKARTA BARAT,TAMBORA,DURI SELATAN,3173041011,2020-10-31,178,9,169,5,5,0
DKI JAKARTA,JAKARTA BARAT,TAMBORA,DURI UTARA,3173041003,2020-10-01,185,7,178,0,0,0
DKI JAKARTA,JAKARTA BARAT,TAMBORA,DURI UTARA,3173041003,2020-10-02,192,7,185,7,0,7
DKI JAKARTA,JAKARTA BARAT,TAMBORA,DURI UTARA,3173041003,2020-10-03,192,6,186,0,-1,1
DKI JAKARTA,JAKARTA BARAT,TAMBORA,DURI UTARA,3173041003,2020-10-04,198,11,187,6,5,1
DKI JAKARTA,JAKARTA BARAT,TAMBORA,DURI UTARA,3173041003,2020-10-05,198,10,188,0,-1,1
DKI JAKARTA,JAKARTA BARAT,TAMBORA,DURI UTARA,3173041003,2020-10-06,198,10,188,0,0,0
DKI JAKARTA,JAKARTA BARAT,TAMBORA,DURI UTARA,3173041003,2020-10-07,199,10,189,1,0,1
DKI JAKARTA,JAKARTA BARAT,TAMBORA,DURI UTARA,3173041003,2020-10-08,202,12,190,3,2,1
DKI JAKARTA,JAKARTA BARAT,TAMBORA,DURI UTARA,3173041003,2020-10-09,205,13,192,3,1,2
DKI JAKARTA,JAKARTA BARAT,TAMBORA,DURI UTARA,3173041003,2020-10-10,206,13,193,1,0,1
DKI JAKARTA,JAKARTA BARAT,TAMBORA,DURI UTARA,3173041003,2020-10-11,207,12,195,1,-1,2
DKI JAKARTA,JAKARTA BARAT,TAMBORA,DURI UTARA,3173041003,2020-10-12,207,12,195,0,0,0
DKI JAKARTA,JAKARTA BARAT,TAMBORA,DURI UTARA,3173041003,2020-10-13,213,18,195,6,6,0
DKI JAKARTA,JAKARTA BARAT,TAMBORA,DURI UTARA,3173041003,2020-10-14,213,14,199,0,-4,4
DKI JAKARTA,JAKARTA BARAT,TAMBORA,DURI UTARA,3173041003,2020-10-15,213,13,200,0,-1,1
DKI JAKARTA,JAKARTA BARAT,TAMBORA,DURI UTARA,3173041003,2020-10-16,225,18,207,12,5,7
DKI JAKARTA,JAKARTA BARAT,TAMBORA,DURI UTARA,3173041003,2020-10-17,229,22,207,4,4,0
DKI JAKARTA,JAKARTA BARAT,TAMBORA,DURI UTARA,3173041003,2020-10-18,230,22,208,1,0,1
DKI JAKARTA,JAKARTA BARAT,TAMBORA,DURI UTARA,3173041003,2020-10-19,230,18,212,0,-4,4
DKI JAKARTA,JAKARTA BARAT,TAMBORA,DURI UTARA,3173041003,2020-10-20,231,17,214,1,-1,2
DKI JAKARTA,JAKARTA BARAT,TAMBORA,DURI UTARA,3173041003,2020-10-21,231,17,214,0,0,0
DKI JAKARTA,JAKARTA BARAT,TAMBORA,DURI UTARA,3173041003,2020-10-22,231,15,216,0,-2,2
DKI JAKARTA,JAKARTA BARAT,TAMBORA,DURI UTARA,3173041003,2020-10-23,232,16,216,1,1,0
DKI JAKARTA,JAKARTA BARAT,TAMBORA,DURI UTARA,3173041003,2020-10-24,232,13,219,0,-3,3
DKI JAKARTA,JAKARTA BARAT,TAMBORA,DURI UTARA,3173041003,2020-10-25,232,12,220,0,-1,1
DKI JAKARTA,JAKARTA BARAT,TAMBORA,DURI UTARA,3173041003,2020-10-26,232,7,225,0,-5,5
DKI JAKARTA,JAKARTA BARAT,TAMBORA,DURI UTARA,3173041003,2020-10-27,236,6,230,4,-1,5
DKI JAKARTA,JAKARTA BARAT,TAMBORA,DURI UTARA,3173041003,2020-10-28,236,5,231,0,-1,1
DKI JAKARTA,JAKARTA BARAT,TAMBORA,DURI UTARA,3173041003,2020-10-29,236,2,234,0,-3,3
DKI JAKARTA,JAKARTA BARAT,TAMBORA,DURI UTARA,3173041003,2020-10-30,238,3,235,2,1,1
DKI JAKARTA,JAKARTA BARAT,TAMBORA,DURI UTARA,3173041003,2020-10-31,241,6,235,3,3,0
DKI JAKARTA,JAKARTA BARAT,TAMBORA,JEMBATAN BESI,3173041006,2020-10-01,439,17,422,0,0,0
DKI JAKARTA,JAKARTA BARAT,TAMBORA,JEMBATAN BESI,3173041006,2020-10-02,443,15,428,4,-2,6
DKI JAKARTA,JAKARTA BARAT,TAMBORA,JEMBATAN BESI,3173041006,2020-10-03,446,16,430,3,1,2
DKI JAKARTA,JAKARTA BARAT,TAMBORA,JEMBATAN BESI,3173041006,2020-10-04,446,16,430,0,0,0
DKI JAKARTA,JAKARTA BARAT,TAMBORA,JEMBATAN BESI,3173041006,2020-10-05,446,15,431,0,-1,1
DKI JAKARTA,JAKARTA BARAT,TAMBORA,JEMBATAN BESI,3173041006,2020-10-06,446,14,432,0,-1,1
DKI JAKARTA,JAKARTA BARAT,TAMBORA,JEMBATAN BESI,3173041006,2020-10-07,448,12,436,2,-2,4
DKI JAKARTA,JAKARTA BARAT,TAMBORA,JEMBATAN BESI,3173041006,2020-10-08,449,6,443,1,-6,7
DKI JAKARTA,JAKARTA BARAT,TAMBORA,JEMBATAN BESI,3173041006,2020-10-09,451,8,443,2,2,0
DKI JAKARTA,JAKARTA BARAT,TAMBORA,JEMBATAN BESI,3173041006,2020-10-10,453,10,443,2,2,0
DKI JAKARTA,JAKARTA BARAT,TAMBORA,JEMBATAN BESI,3173041006,2020-10-11,455,11,444,2,1,1
DKI JAKARTA,JAKARTA BARAT,TAMBORA,JEMBATAN BESI,3173041006,2020-10-12,462,17,445,7,6,1
DKI JAKARTA,JAKARTA BARAT,TAMBORA,JEMBATAN BESI,3173041006,2020-10-13,464,17,447,2,0,2
DKI JAKARTA,JAKARTA BARAT,TAMBORA,JEMBATAN BESI,3173041006,2020-10-14,465,15,450,1,-2,3
DKI JAKARTA,JAKARTA BARAT,TAMBORA,JEMBATAN BESI,3173041006,2020-10-15,468,14,454,3,-1,4
DKI JAKARTA,JAKARTA BARAT,TAMBORA,JEMBATAN BESI,3173041006,2020-10-16,470,15,455,2,1,1
DKI JAKARTA,JAKARTA BARAT,TAMBORA,JEMBATAN BESI,3173041006,2020-10-17,473,17,456,3,2,1
DKI JAKARTA,JAKARTA BARAT,TAMBORA,JEMBATAN BESI,3173041006,2020-10-18,476,19,457,3,2,1
DKI JAKARTA,JAKARTA BARAT,TAMBORA,JEMBATAN BESI,3173041006,2020-10-19,477,18,459,1,-1,2
DKI JAKARTA,JAKARTA BARAT,TAMBORA,JEMBATAN BESI,3173041006,2020-10-20,479,18,461,2,0,2
DKI JAKARTA,JAKARTA BARAT,TAMBORA,JEMBATAN BESI,3173041006,2020-10-21,480,18,462,1,0,1
DKI JAKARTA,JAKARTA BARAT,TAMBORA,JEMBATAN BESI,3173041006,2020-10-22,483,17,466,3,-1,4
DKI JAKARTA,JAKARTA BARAT,TAMBORA,JEMBATAN BESI,3173041006,2020-10-23,486,18,468,3,1,2
DKI JAKARTA,JAKARTA BARAT,TAMBORA,JEMBATAN BESI,3173041006,2020-10-24,487,14,473,1,-4,5
DKI JAKARTA,JAKARTA BARAT,TAMBORA,JEMBATAN BESI,3173041006,2020-10-25,488,13,475,1,-1,2
DKI JAKARTA,JAKARTA BARAT,TAMBORA,JEMBATAN BESI,3173041006,2020-10-26,489,12,477,1,-1,2
DKI JAKARTA,JAKARTA BARAT,TAMBORA,JEMBATAN BESI,3173041006,2020-10-27,496,15,481,7,3,4
DKI JAKARTA,JAKARTA BARAT,TAMBORA,JEMBATAN BESI,3173041006,2020-10-28,497,14,483,1,-1,2
DKI JAKARTA,JAKARTA BARAT,TAMBORA,JEMBATAN BESI,3173041006,2020-10-29,502,14,488,5,0,5
DKI JAKARTA,JAKARTA BARAT,TAMBORA,JEMBATAN BESI,3173041006,2020-10-30,506,17,489,4,3,1
DKI JAKARTA,JAKARTA BARAT,TAMBORA,JEMBATAN BESI,3173041006,2020-10-31,507,17,490,1,0,1
DKI JAKARTA,JAKARTA BARAT,TAMBORA,JEMBATAN LIMA,3173041008,2020-10-01,173,4,169,0,0,0
DKI JAKARTA,JAKARTA BARAT,TAMBORA,JEMBATAN LIMA,3173041008,2020-10-02,180,10,170,7,6,1
DKI JAKARTA,JAKARTA BARAT,TAMBORA,JEMBATAN LIMA,3173041008,2020-10-03,186,11,175,6,1,5
DKI JAKARTA,JAKARTA BARAT,TAMBORA,JEMBATAN LIMA,3173041008,2020-10-04,189,14,175,3,3,0
DKI JAKARTA,JAKARTA BARAT,TAMBORA,JEMBATAN LIMA,3173041008,2020-10-05,190,14,176,1,0,1
DKI JAKARTA,JAKARTA BARAT,TAMBORA,JEMBATAN LIMA,3173041008,2020-10-06,190,13,177,0,-1,1
DKI JAKARTA,JAKARTA BARAT,TAMBORA,JEMBATAN LIMA,3173041008,2020-10-07,192,15,177,2,2,0
DKI JAKARTA,JAKARTA BARAT,TAMBORA,JEMBATAN LIMA,3173041008,2020-10-08,192,15,177,0,0,0
DKI JAKARTA,JAKARTA BARAT,TAMBORA,JEMBATAN LIMA,3173041008,2020-10-09,192,15,177,0,0,0
DKI JAKARTA,JAKARTA BARAT,TAMBORA,JEMBATAN LIMA,3173041008,2020-10-10,194,17,177,2,2,0
DKI JAKARTA,JAKARTA BARAT,TAMBORA,JEMBATAN LIMA,3173041008,2020-10-11,194,16,178,0,-1,1
DKI JAKARTA,JAKARTA BARAT,TAMBORA,JEMBATAN LIMA,3173041008,2020-10-12,195,15,180,1,-1,2
DKI JAKARTA,JAKARTA BARAT,TAMBORA,JEMBATAN LIMA,3173041008,2020-10-13,196,13,183,1,-2,3
DKI JAKARTA,JAKARTA BARAT,TAMBORA,JEMBATAN LIMA,3173041008,2020-10-14,196,8,188,0,-5,5
DKI JAKARTA,JAKARTA BARAT,TAMBORA,JEMBATAN LIMA,3173041008,2020-10-15,197,7,190,1,-1,2
DKI JAKARTA,JAKARTA BARAT,TAMBORA,JEMBATAN LIMA,3173041008,2020-10-16,199,9,190,2,2,0
DKI JAKARTA,JAKARTA BARAT,TAMBORA,JEMBATAN LIMA,3173041008,2020-10-17,205,14,191,6,5,1
DKI JAKARTA,JAKARTA BARAT,TAMBORA,JEMBATAN LIMA,3173041008,2020-10-18,208,16,192,3,2,1
DKI JAKARTA,JAKARTA BARAT,TAMBORA,JEMBATAN LIMA,3173041008,2020-10-19,208,15,193,0,-1,1
DKI JAKARTA,JAKARTA BARAT,TAMBORA,JEMBATAN LIMA,3173041008,2020-10-20,209,16,193,1,1,0
DKI JAKARTA,JAKARTA BARAT,TAMBORA,JEMBATAN LIMA,3173041008,2020-10-21,209,14,195,0,-2,2
DKI JAKARTA,JAKARTA BARAT,TAMBORA,JEMBATAN LIMA,3173041008,2020-10-22,209,13,196,0,-1,1
DKI JAKARTA,JAKARTA BARAT,TAMBORA,JEMBATAN LIMA,3173041008,2020-10-23,209,13,196,0,0,0
DKI JAKARTA,JAKARTA BARAT,TAMBORA,JEMBATAN LIMA,3173041008,2020-10-24,210,12,198,1,-1,2
DKI JAKARTA,JAKARTA BARAT,TAMBORA,JEMBATAN LIMA,3173041008,2020-10-25,210,12,198,0,0,0
DKI JAKARTA,JAKARTA BARAT,TAMBORA,JEMBATAN LIMA,3173041008,2020-10-26,211,9,202,1,-3,4
DKI JAKARTA,JAKARTA BARAT,TAMBORA,JEMBATAN LIMA,3173041008,2020-10-27,216,13,203,5,4,1
DKI JAKARTA,JAKARTA BARAT,TAMBORA,JEMBATAN LIMA,3173041008,2020-10-28,218,12,206,2,-1,3
DKI JAKARTA,JAKARTA BARAT,TAMBORA,JEMBATAN LIMA,3173041008,2020-10-29,218,7,211,0,-5,5
DKI JAKARTA,JAKARTA BARAT,TAMBORA,JEMBATAN LIMA,3173041008,2020-10-30,221,6,215,3,-1,4
DKI JAKARTA,JAKARTA BARAT,TAMBORA,JEMBATAN LIMA,3173041008,2020-10-31,221,5,216,0,-1,1
DKI JAKARTA,JAKARTA BARAT,TAMBORA,KALI ANYAR,3173041002,2020-10-01,329,21,308,0,0,0
DKI JAKARTA,JAKARTA BARAT,TAMBORA,KALI ANYAR,3173041002,2020-10-02,330,16,314,1,-5,6
DKI JAKARTA,JAKARTA BARAT,TAMBORA,KALI ANYAR,3173041002,2020-10-03,331,16,315,1,0,1
DKI JAKARTA,JAKARTA BARAT,TAMBORA,KALI ANYAR,3173041002,2020-10-04,333,17,316,2,1,1
DKI JAKARTA,JAKARTA BARAT,TAMBORA,KALI ANYAR,3173041002,2020-10-05,334,14,320,1,-3,4
DKI JAKARTA,JAKARTA BARAT,TAMBORA,KALI ANYAR,3173041002,2020-10-06,334,11,323,0,-3,3
DKI JAKARTA,JAKARTA BARAT,TAMBORA,KALI ANYAR,3173041002,2020-10-07,334,11,323,0,0,0
DKI JAKARTA,JAKARTA BARAT,TAMBORA,KALI ANYAR,3173041002,2020-10-08,336,11,325,2,0,2
DKI JAKARTA,JAKARTA BARAT,TAMBORA,KALI ANYAR,3173041002,2020-10-09,337,12,325,1,1,0
DKI JAKARTA,JAKARTA BARAT,TAMBORA,KALI ANYAR,3173041002,2020-10-10,338,9,329,1,-3,4
DKI JAKARTA,JAKARTA BARAT,TAMBORA,KALI ANYAR,3173041002,2020-10-11,339,10,329,1,1,0
DKI JAKARTA,JAKARTA BARAT,TAMBORA,KALI ANYAR,3173041002,2020-10-12,340,11,329,1,1,0
DKI JAKARTA,JAKARTA BARAT,TAMBORA,KALI ANYAR,3173041002,2020-10-13,342,12,330,2,1,1
DKI JAKARTA,JAKARTA BARAT,TAMBORA,KALI ANYAR,3173041002,2020-10-14,342,10,332,0,-2,2
DKI JAKARTA,JAKARTA BARAT,TAMBORA,KALI ANYAR,3173041002,2020-10-15,343,8,335,1,-2,3
DKI JAKARTA,JAKARTA BARAT,TAMBORA,KALI ANYAR,3173041002,2020-10-16,346,11,335,3,3,0
DKI JAKARTA,JAKARTA BARAT,TAMBORA,KALI ANYAR,3173041002,2020-10-17,348,13,335,2,2,0
DKI JAKARTA,JAKARTA BARAT,TAMBORA,KALI ANYAR,3173041002,2020-10-18,348,13,335,0,0,0
DKI JAKARTA,JAKARTA BARAT,TAMBORA,KALI ANYAR,3173041002,2020-10-19,348,13,335,0,0,0
DKI JAKARTA,JAKARTA BARAT,TAMBORA,KALI ANYAR,3173041002,2020-10-20,349,12,337,1,-1,2
DKI JAKARTA,JAKARTA BARAT,TAMBORA,KALI ANYAR,3173041002,2020-10-21,359,12,347,10,0,10
DKI JAKARTA,JAKARTA BARAT,TAMBORA,KALI ANYAR,3173041002,2020-10-22,350,10,340,-9,-2,-7
DKI JAKARTA,JAKARTA BARAT,TAMBORA,KALI ANYAR,3173041002,2020-10-23,352,12,340,2,2,0
DKI JAKARTA,JAKARTA BARAT,TAMBORA,KALI ANYAR,3173041002,2020-10-24,352,10,342,0,-2,2
DKI JAKARTA,JAKARTA BARAT,TAMBORA,KALI ANYAR,3173041002,2020-10-25,353,11,342,1,1,0
DKI JAKARTA,JAKARTA BARAT,TAMBORA,KALI ANYAR,3173041002,2020-10-26,354,8,346,1,-3,4
DKI JAKARTA,JAKARTA BARAT,TAMBORA,KALI ANYAR,3173041002,2020-10-27,357,9,348,3,1,2
DKI JAKARTA,JAKARTA BARAT,TAMBORA,KALI ANYAR,3173041002,2020-10-28,358,8,350,1,-1,2
DKI JAKARTA,JAKARTA BARAT,TAMBORA,KALI ANYAR,3173041002,2020-10-29,358,5,353,0,-3,3
DKI JAKARTA,JAKARTA BARAT,TAMBORA,KALI ANYAR,3173041002,2020-10-30,361,8,353,3,3,0
DKI JAKARTA,JAKARTA BARAT,TAMBORA,KALI ANYAR,3173041002,2020-10-31,363,8,355,2,0,2
DKI JAKARTA,JAKARTA BARAT,TAMBORA,KERENDANG,3173041005,2020-10-01,175,14,161,0,0,0
DKI JAKARTA,JAKARTA BARAT,TAMBORA,KERENDANG,3173041005,2020-10-02,181,20,161,6,6,0
DKI JAKARTA,JAKARTA BARAT,TAMBORA,KERENDANG,3173041005,2020-10-03,184,23,161,3,3,0
DKI JAKARTA,JAKARTA BARAT,TAMBORA,KERENDANG,3173041005,2020-10-04,185,24,161,1,1,0
DKI JAKARTA,JAKARTA BARAT,TAMBORA,KERENDANG,3173041005,2020-10-05,187,25,162,2,1,1
DKI JAKARTA,JAKARTA BARAT,TAMBORA,KERENDANG,3173041005,2020-10-06,188,23,165,1,-2,3
DKI JAKARTA,JAKARTA BARAT,TAMBORA,KERENDANG,3173041005,2020-10-07,190,23,167,2,0,2
DKI JAKARTA,JAKARTA BARAT,TAMBORA,KERENDANG,3173041005,2020-10-08,193,23,170,3,0,3
DKI JAKARTA,JAKARTA BARAT,TAMBORA,KERENDANG,3173041005,2020-10-09,193,23,170,0,0,0
DKI JAKARTA,JAKARTA BARAT,TAMBORA,KERENDANG,3173041005,2020-10-10,199,25,174,6,2,4
DKI JAKARTA,JAKARTA BARAT,TAMBORA,KERENDANG,3173041005,2020-10-11,199,25,174,0,0,0
DKI JAKARTA,JAKARTA BARAT,TAMBORA,KERENDANG,3173041005,2020-10-12,201,22,179,2,-3,5
DKI JAKARTA,JAKARTA BARAT,TAMBORA,KERENDANG,3173041005,2020-10-13,205,22,183,4,0,4
DKI JAKARTA,JAKARTA BARAT,TAMBORA,KERENDANG,3173041005,2020-10-14,205,18,187,0,-4,4
DKI JAKARTA,JAKARTA BARAT,TAMBORA,KERENDANG,3173041005,2020-10-15,208,16,192,3,-2,5
DKI JAKARTA,JAKARTA BARAT,TAMBORA,KERENDANG,3173041005,2020-10-16,212,17,195,4,1,3
DKI JAKARTA,JAKARTA BARAT,TAMBORA,KERENDANG,3173041005,2020-10-17,212,16,196,0,-1,1
DKI JAKARTA,JAKARTA BARAT,TAMBORA,KERENDANG,3173041005,2020-10-18,216,20,196,4,4,0
DKI JAKARTA,JAKARTA BARAT,TAMBORA,KERENDANG,3173041005,2020-10-19,216,17,199,0,-3,3
DKI JAKARTA,JAKARTA BARAT,TAMBORA,KERENDANG,3173041005,2020-10-20,218,15,203,2,-2,4
DKI JAKARTA,JAKARTA BARAT,TAMBORA,KERENDANG,3173041005,2020-10-21,220,13,207,2,-2,4
DKI JAKARTA,JAKARTA BARAT,TAMBORA,KERENDANG,3173041005,2020-10-22,221,11,210,1,-2,3
DKI JAKARTA,JAKARTA BARAT,TAMBORA,KERENDANG,3173041005,2020-10-23,221,11,210,0,0,0
DKI JAKARTA,JAKARTA BARAT,TAMBORA,KERENDANG,3173041005,2020-10-24,221,10,211,0,-1,1
DKI JAKARTA,JAKARTA BARAT,TAMBORA,KERENDANG,3173041005,2020-10-25,222,10,212,1,0,1
DKI JAKARTA,JAKARTA BARAT,TAMBORA,KERENDANG,3173041005,2020-10-26,222,10,212,0,0,0
DKI JAKARTA,JAKARTA BARAT,TAMBORA,KERENDANG,3173041005,2020-10-27,223,9,214,1,-1,2
DKI JAKARTA,JAKARTA BARAT,TAMBORA,KERENDANG,3173041005,2020-10-28,223,6,217,0,-3,3
DKI JAKARTA,JAKARTA BARAT,TAMBORA,KERENDANG,3173041005,2020-10-29,224,5,219,1,-1,2
DKI JAKARTA,JAKARTA BARAT,TAMBORA,KERENDANG,3173041005,2020-10-30,224,4,220,0,-1,1
DKI JAKARTA,JAKARTA BARAT,TAMBORA,KERENDANG,3173041005,2020-10-31,224,4,220,0,0,0
DKI JAKARTA,JAKARTA BARAT,TAMBORA,PEKOJAN,3173041009,2020-10-01,221,21,200,0,0,0
DKI JAKARTA,JAKARTA BARAT,TAMBORA,PEKOJAN,3173041009,2020-10-02,224,21,203,3,0,3
DKI JAKARTA,JAKARTA BARAT,TAMBORA,PEKOJAN,3173041009,2020-10-03,225,21,204,1,0,1
DKI JAKARTA,JAKARTA BARAT,TAMBORA,PEKOJAN,3173041009,2020-10-04,228,23,205,3,2,1
DKI JAKARTA,JAKARTA BARAT,TAMBORA,PEKOJAN,3173041009,2020-10-05,229,17,212,1,-6,7
DKI JAKARTA,JAKARTA BARAT,TAMBORA,PEKOJAN,3173041009,2020-10-06,229,15,214,0,-2,2
DKI JAKARTA,JAKARTA BARAT,TAMBORA,PEKOJAN,3173041009,2020-10-07,233,14,219,4,-1,5
DKI JAKARTA,JAKARTA BARAT,TAMBORA,PEKOJAN,3173041009,2020-10-08,235,14,221,2,0,2
DKI JAKARTA,JAKARTA BARAT,TAMBORA,PEKOJAN,3173041009,2020-10-09,237,15,222,2,1,1
DKI JAKARTA,JAKARTA BARAT,TAMBORA,PEKOJAN,3173041009,2020-10-10,241,16,225,4,1,3
DKI JAKARTA,JAKARTA BARAT,TAMBORA,PEKOJAN,3173041009,2020-10-11,247,20,227,6,4,2
DKI JAKARTA,JAKARTA BARAT,TAMBORA,PEKOJAN,3173041009,2020-10-12,250,18,232,3,-2,5
DKI JAKARTA,JAKARTA BARAT,TAMBORA,PEKOJAN,3173041009,2020-10-13,250,16,234,0,-2,2
DKI JAKARTA,JAKARTA BARAT,TAMBORA,PEKOJAN,3173041009,2020-10-14,251,16,235,1,0,1
DKI JAKARTA,JAKARTA BARAT,TAMBORA,PEKOJAN,3173041009,2020-10-15,252,17,235,1,1,0
DKI JAKARTA,JAKARTA BARAT,TAMBORA,PEKOJAN,3173041009,2020-10-16,255,17,238,3,0,3
DKI JAKARTA,JAKARTA BARAT,TAMBORA,PEKOJAN,3173041009,2020-10-17,260,20,240,5,3,2
DKI JAKARTA,JAKARTA BARAT,TAMBORA,PEKOJAN,3173041009,2020-10-18,262,19,243,2,-1,3
DKI JAKARTA,JAKARTA BARAT,TAMBORA,PEKOJAN,3173041009,2020-10-19,262,18,244,0,-1,1
DKI JAKARTA,JAKARTA BARAT,TAMBORA,PEKOJAN,3173041009,2020-10-20,263,15,248,1,-3,4
DKI JAKARTA,JAKARTA BARAT,TAMBORA,PEKOJAN,3173041009,2020-10-21,263,13,250,0,-2,2
DKI JAKARTA,JAKARTA BARAT,TAMBORA,PEKOJAN,3173041009,2020-10-22,263,10,253,0,-3,3
DKI JAKARTA,JAKARTA BARAT,TAMBORA,PEKOJAN,3173041009,2020-10-23,264,11,253,1,1,0
DKI JAKARTA,JAKARTA BARAT,TAMBORA,PEKOJAN,3173041009,2020-10-24,264,11,253,0,0,0
DKI JAKARTA,JAKARTA BARAT,TAMBORA,PEKOJAN,3173041009,2020-10-25,267,14,253,3,3,0
DKI JAKARTA,JAKARTA BARAT,TAMBORA,PEKOJAN,3173041009,2020-10-26,267,13,254,0,-1,1
DKI JAKARTA,JAKARTA BARAT,TAMBORA,PEKOJAN,3173041009,2020-10-27,272,13,259,5,0,5
DKI JAKARTA,JAKARTA BARAT,TAMBORA,PEKOJAN,3173041009,2020-10-28,272,10,262,0,-3,3
DKI JAKARTA,JAKARTA BARAT,TAMBORA,PEKOJAN,3173041009,2020-10-29,273,6,267,1,-4,5
DKI JAKARTA,JAKARTA BARAT,TAMBORA,PEKOJAN,3173041009,2020-10-30,274,7,267,1,1,0
DKI JAKARTA,JAKARTA BARAT,TAMBORA,PEKOJAN,3173041009,2020-10-31,274,7,267,0,0,0
DKI JAKARTA,JAKARTA BARAT,TAMBORA,ROA MALAKA,3173041010,2020-10-01,34,2,32,0,0,0
DKI JAKARTA,JAKARTA BARAT,TAMBORA,ROA MALAKA,3173041010,2020-10-02,37,3,34,3,1,2
DKI JAKARTA,JAKARTA BARAT,TAMBORA,ROA MALAKA,3173041010,2020-10-03,37,3,34,0,0,0
DKI JAKARTA,JAKARTA BARAT,TAMBORA,ROA MALAKA,3173041010,2020-10-04,37,3,34,0,0,0
DKI JAKARTA,JAKARTA BARAT,TAMBORA,ROA MALAKA,3173041010,2020-10-05,37,1,36,0,-2,2
DKI JAKARTA,JAKARTA BARAT,TAMBORA,ROA MALAKA,3173041010,2020-10-06,37,1,36,0,0,0
DKI JAKARTA,JAKARTA BARAT,TAMBORA,ROA MALAKA,3173041010,2020-10-07,37,1,36,0,0,0
DKI JAKARTA,JAKARTA BARAT,TAMBORA,ROA MALAKA,3173041010,2020-10-08,41,4,37,4,3,1
DKI JAKARTA,JAKARTA BARAT,TAMBORA,ROA MALAKA,3173041010,2020-10-09,41,4,37,0,0,0
DKI JAKARTA,JAKARTA BARAT,TAMBORA,ROA MALAKA,3173041010,2020-10-10,42,5,37,1,1,0
DKI JAKARTA,JAKARTA BARAT,TAMBORA,ROA MALAKA,3173041010,2020-10-11,42,4,38,0,-1,1
DKI JAKARTA,JAKARTA BARAT,TAMBORA,ROA MALAKA,3173041010,2020-10-12,44,5,39,2,1,1
DKI JAKARTA,JAKARTA BARAT,TAMBORA,ROA MALAKA,3173041010,2020-10-13,44,5,39,0,0,0
DKI JAKARTA,JAKARTA BARAT,TAMBORA,ROA MALAKA,3173041010,2020-10-14,44,2,42,0,-3,3
DKI JAKARTA,JAKARTA BARAT,TAMBORA,ROA MALAKA,3173041010,2020-10-15,45,3,42,1,1,0
DKI JAKARTA,JAKARTA BARAT,TAMBORA,ROA MALAKA,3173041010,2020-10-16,45,3,42,0,0,0
DKI JAKARTA,JAKARTA BARAT,TAMBORA,ROA MALAKA,3173041010,2020-10-17,45,3,42,0,0,0
DKI JAKARTA,JAKARTA BARAT,TAMBORA,ROA MALAKA,3173041010,2020-10-18,45,3,42,0,0,0
DKI JAKARTA,JAKARTA BARAT,TAMBORA,ROA MALAKA,3173041010,2020-10-19,45,3,42,0,0,0
DKI JAKARTA,JAKARTA BARAT,TAMBORA,ROA MALAKA,3173041010,2020-10-20,45,3,42,0,0,0
DKI JAKARTA,JAKARTA BARAT,TAMBORA,ROA MALAKA,3173041010,2020-10-21,45,3,42,0,0,0
DKI JAKARTA,JAKARTA BARAT,TAMBORA,ROA MALAKA,3173041010,2020-10-22,45,2,43,0,-1,1
DKI JAKARTA,JAKARTA BARAT,TAMBORA,ROA MALAKA,3173041010,2020-10-23,45,2,43,0,0,0
DKI JAKARTA,JAKARTA BARAT,TAMBORA,ROA MALAKA,3173041010,2020-10-24,45,1,44,0,-1,1
DKI JAKARTA,JAKARTA BARAT,TAMBORA,ROA MALAKA,3173041010,2020-10-25,45,1,44,0,0,0
DKI JAKARTA,JAKARTA BARAT,TAMBORA,ROA MALAKA,3173041010,2020-10-26,45,0,45,0,-1,1
DKI JAKARTA,JAKARTA BARAT,TAMBORA,ROA MALAKA,3173041010,2020-10-27,45,0,45,0,0,0
DKI JAKARTA,JAKARTA BARAT,TAMBORA,ROA MALAKA,3173041010,2020-10-28,45,0,45,0,0,0
DKI JAKARTA,JAKARTA BARAT,TAMBORA,ROA MALAKA,3173041010,2020-10-29,45,1,45,0,1,0
DKI JAKARTA,JAKARTA BARAT,TAMBORA,ROA MALAKA,3173041010,2020-10-30,45,1,45,0,0,0
DKI JAKARTA,JAKARTA BARAT,TAMBORA,ROA MALAKA,3173041010,2020-10-31,46,2,45,1,1,0
DKI JAKARTA,JAKARTA BARAT,TAMBORA,TAMBORA,3173041001,2020-10-01,262,9,253,0,0,0
DKI JAKARTA,JAKARTA BARAT,TAMBORA,TAMBORA,3173041001,2020-10-02,264,8,256,2,-1,3
DKI JAKARTA,JAKARTA BARAT,TAMBORA,TAMBORA,3173041001,2020-10-03,265,9,256,1,1,0
DKI JAKARTA,JAKARTA BARAT,TAMBORA,TAMBORA,3173041001,2020-10-04,266,10,256,1,1,0
DKI JAKARTA,JAKARTA BARAT,TAMBORA,TAMBORA,3173041001,2020-10-05,266,8,258,0,-2,2
DKI JAKARTA,JAKARTA BARAT,TAMBORA,TAMBORA,3173041001,2020-10-06,266,8,258,0,0,0
DKI JAKARTA,JAKARTA BARAT,TAMBORA,TAMBORA,3173041001,2020-10-07,269,8,261,3,0,3
DKI JAKARTA,JAKARTA BARAT,TAMBORA,TAMBORA,3173041001,2020-10-08,272,11,261,3,3,0
DKI JAKARTA,JAKARTA BARAT,TAMBORA,TAMBORA,3173041001,2020-10-09,275,14,261,3,3,0
DKI JAKARTA,JAKARTA BARAT,TAMBORA,TAMBORA,3173041001,2020-10-10,277,13,264,2,-1,3
DKI JAKARTA,JAKARTA BARAT,TAMBORA,TAMBORA,3173041001,2020-10-11,277,13,264,0,0,0
DKI JAKARTA,JAKARTA BARAT,TAMBORA,TAMBORA,3173041001,2020-10-12,282,14,268,5,1,4
DKI JAKARTA,JAKARTA BARAT,TAMBORA,TAMBORA,3173041001,2020-10-13,282,14,268,0,0,0
DKI JAKARTA,JAKARTA BARAT,TAMBORA,TAMBORA,3173041001,2020-10-14,282,14,268,0,0,0
DKI JAKARTA,JAKARTA BARAT,TAMBORA,TAMBORA,3173041001,2020-10-15,292,19,273,10,5,5
DKI JAKARTA,JAKARTA BARAT,TAMBORA,TAMBORA,3173041001,2020-10-16,293,20,273,1,1,0
DKI JAKARTA,JAKARTA BARAT,TAMBORA,TAMBORA,3173041001,2020-10-17,295,22,273,2,2,0
DKI JAKARTA,JAKARTA BARAT,TAMBORA,TAMBORA,3173041001,2020-10-18,300,27,273,5,5,0
DKI JAKARTA,JAKARTA BARAT,TAMBORA,TAMBORA,3173041001,2020-10-19,300,27,273,0,0,0
DKI JAKARTA,JAKARTA BARAT,TAMBORA,TAMBORA,3173041001,2020-10-20,304,27,277,4,0,4
DKI JAKARTA,JAKARTA BARAT,TAMBORA,TAMBORA,3173041001,2020-10-21,305,23,282,1,-4,5
DKI JAKARTA,JAKARTA BARAT,TAMBORA,TAMBORA,3173041001,2020-10-22,305,22,283,0,-1,1
DKI JAKARTA,JAKARTA BARAT,TAMBORA,TAMBORA,3173041001,2020-10-23,306,22,284,1,0,1
DKI JAKARTA,JAKARTA BARAT,TAMBORA,TAMBORA,3173041001,2020-10-24,306,21,285,0,-1,1
DKI JAKARTA,JAKARTA BARAT,TAMBORA,TAMBORA,3173041001,2020-10-25,310,22,288,4,1,3
DKI JAKARTA,JAKARTA BARAT,TAMBORA,TAMBORA,3173041001,2020-10-26,311,13,298,1,-9,10
DKI JAKARTA,JAKARTA BARAT,TAMBORA,TAMBORA,3173041001,2020-10-27,313,14,299,2,1,1
DKI JAKARTA,JAKARTA BARAT,TAMBORA,TAMBORA,3173041001,2020-10-28,313,14,299,0,0,0
DKI JAKARTA,JAKARTA BARAT,TAMBORA,TAMBORA,3173041001,2020-10-29,315,12,303,2,-2,4
DKI JAKARTA,JAKARTA BARAT,TAMBORA,TAMBORA,3173041001,2020-10-30,318,10,308,3,-2,5
DKI JAKARTA,JAKARTA BARAT,TAMBORA,TAMBORA,3173041001,2020-10-31,320,12,308,2,2,0
DKI JAKARTA,JAKARTA BARAT,TAMBORA,TANAH SEREAL,3173041004,2020-10-01,229,15,214,0,0,0
DKI JAKARTA,JAKARTA BARAT,TAMBORA,TANAH SEREAL,3173041004,2020-10-02,232,17,215,3,2,1
DKI JAKARTA,JAKARTA BARAT,TAMBORA,TANAH SEREAL,3173041004,2020-10-03,233,15,218,1,-2,3
DKI JAKARTA,JAKARTA BARAT,TAMBORA,TANAH SEREAL,3173041004,2020-10-04,236,17,219,3,2,1
DKI JAKARTA,JAKARTA BARAT,TAMBORA,TANAH SEREAL,3173041004,2020-10-05,237,17,220,1,0,1
DKI JAKARTA,JAKARTA BARAT,TAMBORA,TANAH SEREAL,3173041004,2020-10-06,237,12,225,0,-5,5
DKI JAKARTA,JAKARTA BARAT,TAMBORA,TANAH SEREAL,3173041004,2020-10-07,240,15,225,3,3,0
DKI JAKARTA,JAKARTA BARAT,TAMBORA,TANAH SEREAL,3173041004,2020-10-08,242,17,225,2,2,0
DKI JAKARTA,JAKARTA BARAT,TAMBORA,TANAH SEREAL,3173041004,2020-10-09,243,17,226,1,0,1
DKI JAKARTA,JAKARTA BARAT,TAMBORA,TANAH SEREAL,3173041004,2020-10-10,244,18,226,1,1,0
DKI JAKARTA,JAKARTA BARAT,TAMBORA,TANAH SEREAL,3173041004,2020-10-11,245,17,228,1,-1,2
DKI JAKARTA,JAKARTA BARAT,TAMBORA,TANAH SEREAL,3173041004,2020-10-12,248,15,233,3,-2,5
DKI JAKARTA,JAKARTA BARAT,TAMBORA,TANAH SEREAL,3173041004,2020-10-13,251,14,237,3,-1,4
DKI JAKARTA,JAKARTA BARAT,TAMBORA,TANAH SEREAL,3173041004,2020-10-14,252,12,240,1,-2,3
DKI JAKARTA,JAKARTA BARAT,TAMBORA,TANAH SEREAL,3173041004,2020-10-15,255,12,243,3,0,3
DKI JAKARTA,JAKARTA BARAT,TAMBORA,TANAH SEREAL,3173041004,2020-10-16,261,16,245,6,4,2
DKI JAKARTA,JAKARTA BARAT,TAMBORA,TANAH SEREAL,3173041004,2020-10-17,266,20,246,5,4,1
DKI JAKARTA,JAKARTA BARAT,TAMBORA,TANAH SEREAL,3173041004,2020-10-18,268,21,247,2,1,1
DKI JAKARTA,JAKARTA BARAT,TAMBORA,TANAH SEREAL,3173041004,2020-10-19,268,21,247,0,0,0
DKI JAKARTA,JAKARTA BARAT,TAMBORA,TANAH SEREAL,3173041004,2020-10-20,272,23,249,4,2,2
DKI JAKARTA,JAKARTA BARAT,TAMBORA,TANAH SEREAL,3173041004,2020-10-21,272,22,250,0,-1,1
DKI JAKARTA,JAKARTA BARAT,TAMBORA,TANAH SEREAL,3173041004,2020-10-22,273,21,252,1,-1,2
DKI JAKARTA,JAKARTA BARAT,TAMBORA,TANAH SEREAL,3173041004,2020-10-23,274,22,252,1,1,0
DKI JAKARTA,JAKARTA BARAT,TAMBORA,TANAH SEREAL,3173041004,2020-10-24,274,20,254,0,-2,2
DKI JAKARTA,JAKARTA BARAT,TAMBORA,TANAH SEREAL,3173041004,2020-10-25,275,16,259,1,-4,5
DKI JAKARTA,JAKARTA BARAT,TAMBORA,TANAH SEREAL,3173041004,2020-10-26,276,14,262,1,-2,3
DKI JAKARTA,JAKARTA BARAT,TAMBORA,TANAH SEREAL,3173041004,2020-10-27,283,17,266,7,3,4
DKI JAKARTA,JAKARTA BARAT,TAMBORA,TANAH SEREAL,3173041004,2020-10-28,286,16,270,3,-1,4
DKI JAKARTA,JAKARTA BARAT,TAMBORA,TANAH SEREAL,3173041004,2020-10-29,286,11,275,0,-5,5
DKI JAKARTA,JAKARTA BARAT,TAMBORA,TANAH SEREAL,3173041004,2020-10-30,291,12,279,5,1,4
DKI JAKARTA,JAKARTA BARAT,TAMBORA,TANAH SEREAL,3173041004,2020-10-31,291,12,279,0,0,0
DKI JAKARTA,JAKARTA PUSAT,CEMPAKA PUTIH,CEMPAKA PUTIH BARAT,3171051002,2020-10-01,1635,71,1564,0,0,0
DKI JAKARTA,JAKARTA PUSAT,CEMPAKA PUTIH,CEMPAKA PUTIH BARAT,3171051002,2020-10-02,1657,85,1572,22,14,8
DKI JAKARTA,JAKARTA PUSAT,CEMPAKA PUTIH,CEMPAKA PUTIH BARAT,3171051002,2020-10-03,1660,88,1572,3,3,0
DKI JAKARTA,JAKARTA PUSAT,CEMPAKA PUTIH,CEMPAKA PUTIH BARAT,3171051002,2020-10-04,1689,111,1578,29,23,6
DKI JAKARTA,JAKARTA PUSAT,CEMPAKA PUTIH,CEMPAKA PUTIH BARAT,3171051002,2020-10-05,1714,122,1592,25,11,14
DKI JAKARTA,JAKARTA PUSAT,CEMPAKA PUTIH,CEMPAKA PUTIH BARAT,3171051002,2020-10-06,1730,115,1615,16,-7,23
DKI JAKARTA,JAKARTA PUSAT,CEMPAKA PUTIH,CEMPAKA PUTIH BARAT,3171051002,2020-10-07,1751,113,1638,21,-2,23
DKI JAKARTA,JAKARTA PUSAT,CEMPAKA PUTIH,CEMPAKA PUTIH BARAT,3171051002,2020-10-08,1771,124,1647,20,11,9
DKI JAKARTA,JAKARTA PUSAT,CEMPAKA PUTIH,CEMPAKA PUTIH BARAT,3171051002,2020-10-09,1782,133,1649,11,9,2
DKI JAKARTA,JAKARTA PUSAT,CEMPAKA PUTIH,CEMPAKA PUTIH BARAT,3171051002,2020-10-10,1791,133,1658,9,0,9
DKI JAKARTA,JAKARTA PUSAT,CEMPAKA PUTIH,CEMPAKA PUTIH BARAT,3171051002,2020-10-11,1801,138,1663,10,5,5
DKI JAKARTA,JAKARTA PUSAT,CEMPAKA PUTIH,CEMPAKA PUTIH BARAT,3171051002,2020-10-12,1805,122,1683,4,-16,20
DKI JAKARTA,JAKARTA PUSAT,CEMPAKA PUTIH,CEMPAKA PUTIH BARAT,3171051002,2020-10-13,1824,122,1702,19,0,19
DKI JAKARTA,JAKARTA PUSAT,CEMPAKA PUTIH,CEMPAKA PUTIH BARAT,3171051002,2020-10-14,1830,101,1729,6,-21,27
DKI JAKARTA,JAKARTA PUSAT,CEMPAKA PUTIH,CEMPAKA PUTIH BARAT,3171051002,2020-10-15,1847,96,1751,17,-5,22
DKI JAKARTA,JAKARTA PUSAT,CEMPAKA PUTIH,CEMPAKA PUTIH BARAT,3171051002,2020-10-16,1853,79,1774,6,-17,23
DKI JAKARTA,JAKARTA PUSAT,CEMPAKA PUTIH,CEMPAKA PUTIH BARAT,3171051002,2020-10-17,1865,83,1782,12,4,8
DKI JAKARTA,JAKARTA PUSAT,CEMPAKA PUTIH,CEMPAKA PUTIH BARAT,3171051002,2020-10-18,1881,95,1786,16,12,4
DKI JAKARTA,JAKARTA PUSAT,CEMPAKA PUTIH,CEMPAKA PUTIH BARAT,3171051002,2020-10-19,1884,83,1801,3,-12,15
DKI JAKARTA,JAKARTA PUSAT,CEMPAKA PUTIH,CEMPAKA PUTIH BARAT,3171051002,2020-10-20,1890,75,1815,6,-8,14
DKI JAKARTA,JAKARTA PUSAT,CEMPAKA PUTIH,CEMPAKA PUTIH BARAT,3171051002,2020-10-21,1906,79,1827,16,4,12
DKI JAKARTA,JAKARTA PUSAT,CEMPAKA PUTIH,CEMPAKA PUTIH BARAT,3171051002,2020-10-22,1915,79,1836,9,0,9
DKI JAKARTA,JAKARTA PUSAT,CEMPAKA PUTIH,CEMPAKA PUTIH BARAT,3171051002,2020-10-23,1924,82,1842,9,3,6
DKI JAKARTA,JAKARTA PUSAT,CEMPAKA PUTIH,CEMPAKA PUTIH BARAT,3171051002,2020-10-24,1943,80,1863,19,-2,21
DKI JAKARTA,JAKARTA PUSAT,CEMPAKA PUTIH,CEMPAKA PUTIH BARAT,3171051002,2020-10-25,1950,86,1864,7,6,1
DKI JAKARTA,JAKARTA PUSAT,CEMPAKA PUTIH,CEMPAKA PUTIH BARAT,3171051002,2020-10-26,1956,81,1875,6,-5,11
DKI JAKARTA,JAKARTA PUSAT,CEMPAKA PUTIH,CEMPAKA PUTIH BARAT,3171051002,2020-10-27,1968,80,1888,12,-1,13
DKI JAKARTA,JAKARTA PUSAT,CEMPAKA PUTIH,CEMPAKA PUTIH BARAT,3171051002,2020-10-28,1998,105,1893,30,25,5
DKI JAKARTA,JAKARTA PUSAT,CEMPAKA PUTIH,CEMPAKA PUTIH BARAT,3171051002,2020-10-29,2011,100,1911,13,-5,18
DKI JAKARTA,JAKARTA PUSAT,CEMPAKA PUTIH,CEMPAKA PUTIH BARAT,3171051002,2020-10-30,2023,102,1921,12,2,10
DKI JAKARTA,JAKARTA PUSAT,CEMPAKA PUTIH,CEMPAKA PUTIH BARAT,3171051002,2020-10-31,2026,101,1925,3,-1,4
DKI JAKARTA,JAKARTA PUSAT,CEMPAKA PUTIH,CEMPAKA PUTIH TIMUR,3171051001,2020-10-01,1161,52,1109,0,0,0
DKI JAKARTA,JAKARTA PUSAT,CEMPAKA PUTIH,CEMPAKA PUTIH TIMUR,3171051001,2020-10-02,1176,59,1117,15,7,8
DKI JAKARTA,JAKARTA PUSAT,CEMPAKA PUTIH,CEMPAKA PUTIH TIMUR,3171051001,2020-10-03,1183,62,1121,7,3,4
DKI JAKARTA,JAKARTA PUSAT,CEMPAKA PUTIH,CEMPAKA PUTIH TIMUR,3171051001,2020-10-04,1196,69,1127,13,7,6
DKI JAKARTA,JAKARTA PUSAT,CEMPAKA PUTIH,CEMPAKA PUTIH TIMUR,3171051001,2020-10-05,1201,65,1136,5,-4,9
DKI JAKARTA,JAKARTA PUSAT,CEMPAKA PUTIH,CEMPAKA PUTIH TIMUR,3171051001,2020-10-06,1231,66,1165,30,1,29
DKI JAKARTA,JAKARTA PUSAT,CEMPAKA PUTIH,CEMPAKA PUTIH TIMUR,3171051001,2020-10-07,1241,57,1184,10,-9,19
DKI JAKARTA,JAKARTA PUSAT,CEMPAKA PUTIH,CEMPAKA PUTIH TIMUR,3171051001,2020-10-08,1255,64,1191,14,7,7
DKI JAKARTA,JAKARTA PUSAT,CEMPAKA PUTIH,CEMPAKA PUTIH TIMUR,3171051001,2020-10-09,1262,71,1191,7,7,0
DKI JAKARTA,JAKARTA PUSAT,CEMPAKA PUTIH,CEMPAKA PUTIH TIMUR,3171051001,2020-10-10,1272,74,1198,10,3,7
DKI JAKARTA,JAKARTA PUSAT,CEMPAKA PUTIH,CEMPAKA PUTIH TIMUR,3171051001,2020-10-11,1278,76,1202,6,2,4
DKI JAKARTA,JAKARTA PUSAT,CEMPAKA PUTIH,CEMPAKA PUTIH TIMUR,3171051001,2020-10-12,1287,80,1207,9,4,5
DKI JAKARTA,JAKARTA PUSAT,CEMPAKA PUTIH,CEMPAKA PUTIH TIMUR,3171051001,2020-10-13,1303,84,1219,16,4,12
DKI JAKARTA,JAKARTA PUSAT,CEMPAKA PUTIH,CEMPAKA PUTIH TIMUR,3171051001,2020-10-14,1309,68,1241,6,-16,22
DKI JAKARTA,JAKARTA PUSAT,CEMPAKA PUTIH,CEMPAKA PUTIH TIMUR,3171051001,2020-10-15,1320,72,1248,11,4,7
DKI JAKARTA,JAKARTA PUSAT,CEMPAKA PUTIH,CEMPAKA PUTIH TIMUR,3171051001,2020-10-16,1334,75,1259,14,3,11
DKI JAKARTA,JAKARTA PUSAT,CEMPAKA PUTIH,CEMPAKA PUTIH TIMUR,3171051001,2020-10-17,1343,82,1261,9,7,2
DKI JAKARTA,JAKARTA PUSAT,CEMPAKA PUTIH,CEMPAKA PUTIH TIMUR,3171051001,2020-10-18,1350,86,1264,7,4,3
DKI JAKARTA,JAKARTA PUSAT,CEMPAKA PUTIH,CEMPAKA PUTIH TIMUR,3171051001,2020-10-19,1350,78,1272,0,-8,8
DKI JAKARTA,JAKARTA PUSAT,CEMPAKA PUTIH,CEMPAKA PUTIH TIMUR,3171051001,2020-10-20,1356,67,1289,6,-11,17
DKI JAKARTA,JAKARTA PUSAT,CEMPAKA PUTIH,CEMPAKA PUTIH TIMUR,3171051001,2020-10-21,1360,64,1296,4,-3,7
DKI JAKARTA,JAKARTA PUSAT,CEMPAKA PUTIH,CEMPAKA PUTIH TIMUR,3171051001,2020-10-22,1364,60,1304,4,-4,8
DKI JAKARTA,JAKARTA PUSAT,CEMPAKA PUTIH,CEMPAKA PUTIH TIMUR,3171051001,2020-10-23,1373,64,1309,9,4,5
DKI JAKARTA,JAKARTA PUSAT,CEMPAKA PUTIH,CEMPAKA PUTIH TIMUR,3171051001,2020-10-24,1390,55,1335,17,-9,26
DKI JAKARTA,JAKARTA PUSAT,CEMPAKA PUTIH,CEMPAKA PUTIH TIMUR,3171051001,2020-10-25,1408,72,1336,18,17,1
DKI JAKARTA,JAKARTA PUSAT,CEMPAKA PUTIH,CEMPAKA PUTIH TIMUR,3171051001,2020-10-26,1416,63,1353,8,-9,17
DKI JAKARTA,JAKARTA PUSAT,CEMPAKA PUTIH,CEMPAKA PUTIH TIMUR,3171051001,2020-10-27,1430,67,1363,14,4,10
DKI JAKARTA,JAKARTA PUSAT,CEMPAKA PUTIH,CEMPAKA PUTIH TIMUR,3171051001,2020-10-28,1437,65,1372,7,-2,9
DKI JAKARTA,JAKARTA PUSAT,CEMPAKA PUTIH,CEMPAKA PUTIH TIMUR,3171051001,2020-10-29,1443,63,1380,6,-2,8
DKI JAKARTA,JAKARTA PUSAT,CEMPAKA PUTIH,CEMPAKA PUTIH TIMUR,3171051001,2020-10-30,1457,71,1386,14,8,6
DKI JAKARTA,JAKARTA PUSAT,CEMPAKA PUTIH,CEMPAKA PUTIH TIMUR,3171051001,2020-10-31,1461,72,1389,4,1,3
DKI JAKARTA,JAKARTA PUSAT,CEMPAKA PUTIH,RAWASARI,3171051003,2020-10-01,1081,66,1015,0,0,0
DKI JAKARTA,JAKARTA PUSAT,CEMPAKA PUTIH,RAWASARI,3171051003,2020-10-02,1111,89,1022,30,23,7
DKI JAKARTA,JAKARTA PUSAT,CEMPAKA PUTIH,RAWASARI,3171051003,2020-10-03,1118,96,1022,7,7,0
DKI JAKARTA,JAKARTA PUSAT,CEMPAKA PUTIH,RAWASARI,3171051003,2020-10-04,1144,108,1036,26,12,14
DKI JAKARTA,JAKARTA PUSAT,CEMPAKA PUTIH,RAWASARI,3171051003,2020-10-05,1158,109,1049,14,1,13
DKI JAKARTA,JAKARTA PUSAT,CEMPAKA PUTIH,RAWASARI,3171051003,2020-10-06,1179,110,1069,21,1,20
DKI JAKARTA,JAKARTA PUSAT,CEMPAKA PUTIH,RAWASARI,3171051003,2020-10-07,1189,111,1078,10,1,9
DKI JAKARTA,JAKARTA PUSAT,CEMPAKA PUTIH,RAWASARI,3171051003,2020-10-08,1211,112,1099,22,1,21
DKI JAKARTA,JAKARTA PUSAT,CEMPAKA PUTIH,RAWASARI,3171051003,2020-10-09,1217,118,1099,6,6,0
DKI JAKARTA,JAKARTA PUSAT,CEMPAKA PUTIH,RAWASARI,3171051003,2020-10-10,1225,115,1110,8,-3,11
DKI JAKARTA,JAKARTA PUSAT,CEMPAKA PUTIH,RAWASARI,3171051003,2020-10-11,1229,116,1113,4,1,3
DKI JAKARTA,JAKARTA PUSAT,CEMPAKA PUTIH,RAWASARI,3171051003,2020-10-12,1238,108,1130,9,-8,17
DKI JAKARTA,JAKARTA PUSAT,CEMPAKA PUTIH,RAWASARI,3171051003,2020-10-13,1243,94,1149,5,-14,19
DKI JAKARTA,JAKARTA PUSAT,CEMPAKA PUTIH,RAWASARI,3171051003,2020-10-14,1245,72,1173,2,-22,24
DKI JAKARTA,JAKARTA PUSAT,CEMPAKA PUTIH,RAWASARI,3171051003,2020-10-15,1262,75,1187,17,3,14
DKI JAKARTA,JAKARTA PUSAT,CEMPAKA PUTIH,RAWASARI,3171051003,2020-10-16,1268,70,1198,6,-5,11
DKI JAKARTA,JAKARTA PUSAT,CEMPAKA PUTIH,RAWASARI,3171051003,2020-10-17,1277,74,1203,9,4,5
DKI JAKARTA,JAKARTA PUSAT,CEMPAKA PUTIH,RAWASARI,3171051003,2020-10-18,1302,98,1204,25,24,1
DKI JAKARTA,JAKARTA PUSAT,CEMPAKA PUTIH,RAWASARI,3171051003,2020-10-19,1307,88,1219,5,-10,15
DKI JAKARTA,JAKARTA PUSAT,CEMPAKA PUTIH,RAWASARI,3171051003,2020-10-20,1313,85,1228,6,-3,9
DKI JAKARTA,JAKARTA PUSAT,CEMPAKA PUTIH,RAWASARI,3171051003,2020-10-21,1323,81,1242,10,-4,14
DKI JAKARTA,JAKARTA PUSAT,CEMPAKA PUTIH,RAWASARI,3171051003,2020-10-22,1318,69,1249,-5,-12,7
DKI JAKARTA,JAKARTA PUSAT,CEMPAKA PUTIH,RAWASARI,3171051003,2020-10-23,1327,73,1254,9,4,5
DKI JAKARTA,JAKARTA PUSAT,CEMPAKA PUTIH,RAWASARI,3171051003,2020-10-24,1342,68,1274,15,-5,20
DKI JAKARTA,JAKARTA PUSAT,CEMPAKA PUTIH,RAWASARI,3171051003,2020-10-25,1358,83,1275,16,15,1
DKI JAKARTA,JAKARTA PUSAT,CEMPAKA PUTIH,RAWASARI,3171051003,2020-10-26,1366,83,1283,8,0,8
DKI JAKARTA,JAKARTA PUSAT,CEMPAKA PUTIH,RAWASARI,3171051003,2020-10-27,1374,75,1299,8,-8,16
DKI JAKARTA,JAKARTA PUSAT,CEMPAKA PUTIH,RAWASARI,3171051003,2020-10-28,1385,77,1308,11,2,9
DKI JAKARTA,JAKARTA PUSAT,CEMPAKA PUTIH,RAWASARI,3171051003,2020-10-29,1391,67,1324,6,-10,16
DKI JAKARTA,JAKARTA PUSAT,CEMPAKA PUTIH,RAWASARI,3171051003,2020-10-30,1419,77,1342,28,10,18
DKI JAKARTA,JAKARTA PUSAT,CEMPAKA PUTIH,RAWASARI,3171051003,2020-10-31,1428,82,1346,9,5,4
DKI JAKARTA,JAKARTA PUSAT,GAMBIR,CIDENG,3171011002,2020-10-01,484,57,427,0,0,0
DKI JAKARTA,JAKARTA PUSAT,GAMBIR,CIDENG,3171011002,2020-10-02,496,52,444,12,-5,17
DKI JAKARTA,JAKARTA PUSAT,GAMBIR,CIDENG,3171011002,2020-10-03,504,54,450,8,2,6
DKI JAKARTA,JAKARTA PUSAT,GAMBIR,CIDENG,3171011002,2020-10-04,507,57,450,3,3,0
DKI JAKARTA,JAKARTA PUSAT,GAMBIR,CIDENG,3171011002,2020-10-05,507,55,452,0,-2,2
DKI JAKARTA,JAKARTA PUSAT,GAMBIR,CIDENG,3171011002,2020-10-06,512,54,458,5,-1,6
DKI JAKARTA,JAKARTA PUSAT,GAMBIR,CIDENG,3171011002,2020-10-07,517,55,462,5,1,4
DKI JAKARTA,JAKARTA PUSAT,GAMBIR,CIDENG,3171011002,2020-10-08,528,60,468,11,5,6
DKI JAKARTA,JAKARTA PUSAT,GAMBIR,CIDENG,3171011002,2020-10-09,532,64,468,4,4,0
DKI JAKARTA,JAKARTA PUSAT,GAMBIR,CIDENG,3171011002,2020-10-10,540,58,482,8,-6,14
DKI JAKARTA,JAKARTA PUSAT,GAMBIR,CIDENG,3171011002,2020-10-11,545,63,482,5,5,0
DKI JAKARTA,JAKARTA PUSAT,GAMBIR,CIDENG,3171011002,2020-10-12,551,61,490,6,-2,8
DKI JAKARTA,JAKARTA PUSAT,GAMBIR,CIDENG,3171011002,2020-10-13,551,45,506,0,-16,16
DKI JAKARTA,JAKARTA PUSAT,GAMBIR,CIDENG,3171011002,2020-10-14,561,50,511,10,5,5
DKI JAKARTA,JAKARTA PUSAT,GAMBIR,CIDENG,3171011002,2020-10-15,572,56,516,11,6,5
DKI JAKARTA,JAKARTA PUSAT,GAMBIR,CIDENG,3171011002,2020-10-16,576,57,519,4,1,3
DKI JAKARTA,JAKARTA PUSAT,GAMBIR,CIDENG,3171011002,2020-10-17,581,59,522,5,2,3
DKI JAKARTA,JAKARTA PUSAT,GAMBIR,CIDENG,3171011002,2020-10-18,587,64,523,6,5,1
DKI JAKARTA,JAKARTA PUSAT,GAMBIR,CIDENG,3171011002,2020-10-19,591,63,528,4,-1,5
DKI JAKARTA,JAKARTA PUSAT,GAMBIR,CIDENG,3171011002,2020-10-20,602,65,537,11,2,9
DKI JAKARTA,JAKARTA PUSAT,GAMBIR,CIDENG,3171011002,2020-10-21,603,59,544,1,-6,7
DKI JAKARTA,JAKARTA PUSAT,GAMBIR,CIDENG,3171011002,2020-10-22,606,55,551,3,-4,7
DKI JAKARTA,JAKARTA PUSAT,GAMBIR,CIDENG,3171011002,2020-10-23,607,55,552,1,0,1
DKI JAKARTA,JAKARTA PUSAT,GAMBIR,CIDENG,3171011002,2020-10-24,609,42,567,2,-13,15
DKI JAKARTA,JAKARTA PUSAT,GAMBIR,CIDENG,3171011002,2020-10-25,613,44,569,4,2,2
DKI JAKARTA,JAKARTA PUSAT,GAMBIR,CIDENG,3171011002,2020-10-26,613,33,580,0,-11,11
DKI JAKARTA,JAKARTA PUSAT,GAMBIR,CIDENG,3171011002,2020-10-27,616,28,588,3,-5,8
DKI JAKARTA,JAKARTA PUSAT,GAMBIR,CIDENG,3171011002,2020-10-28,618,23,595,2,-5,7
DKI JAKARTA,JAKARTA PUSAT,GAMBIR,CIDENG,3171011002,2020-10-29,618,11,607,0,-12,12
DKI JAKARTA,JAKARTA PUSAT,GAMBIR,CIDENG,3171011002,2020-10-30,625,16,609,7,5,2
DKI JAKARTA,JAKARTA PUSAT,GAMBIR,CIDENG,3171011002,2020-10-31,625,16,609,0,0,0
DKI JAKARTA,JAKARTA PUSAT,GAMBIR,DURI PULO,3171011006,2020-10-01,321,38,283,0,0,0
DKI JAKARTA,JAKARTA PUSAT,GAMBIR,DURI PULO,3171011006,2020-10-02,326,26,300,5,-12,17
DKI JAKARTA,JAKARTA PUSAT,GAMBIR,DURI PULO,3171011006,2020-10-03,328,26,302,2,0,2
DKI JAKARTA,JAKARTA PUSAT,GAMBIR,DURI PULO,3171011006,2020-10-04,335,33,302,7,7,0
DKI JAKARTA,JAKARTA PUSAT,GAMBIR,DURI PULO,3171011006,2020-10-05,338,33,305,3,0,3
DKI JAKARTA,JAKARTA PUSAT,GAMBIR,DURI PULO,3171011006,2020-10-06,344,36,308,6,3,3
DKI JAKARTA,JAKARTA PUSAT,GAMBIR,DURI PULO,3171011006,2020-10-07,355,41,314,11,5,6
DKI JAKARTA,JAKARTA PUSAT,GAMBIR,DURI PULO,3171011006,2020-10-08,370,51,319,15,10,5
DKI JAKARTA,JAKARTA PUSAT,GAMBIR,DURI PULO,3171011006,2020-10-09,373,53,320,3,2,1
DKI JAKARTA,JAKARTA PUSAT,GAMBIR,DURI PULO,3171011006,2020-10-10,389,62,327,16,9,7
DKI JAKARTA,JAKARTA PUSAT,GAMBIR,DURI PULO,3171011006,2020-10-11,406,79,327,17,17,0
DKI JAKARTA,JAKARTA PUSAT,GAMBIR,DURI PULO,3171011006,2020-10-12,417,86,331,11,7,4
DKI JAKARTA,JAKARTA PUSAT,GAMBIR,DURI PULO,3171011006,2020-10-13,420,85,335,3,-1,4
DKI JAKARTA,JAKARTA PUSAT,GAMBIR,DURI PULO,3171011006,2020-10-14,428,88,340,8,3,5
DKI JAKARTA,JAKARTA PUSAT,GAMBIR,DURI PULO,3171011006,2020-10-15,436,85,351,8,-3,11
DKI JAKARTA,JAKARTA PUSAT,GAMBIR,DURI PULO,3171011006,2020-10-16,442,81,361,6,-4,10
DKI JAKARTA,JAKARTA PUSAT,GAMBIR,DURI PULO,3171011006,2020-10-17,445,81,364,3,0,3
DKI JAKARTA,JAKARTA PUSAT,GAMBIR,DURI PULO,3171011006,2020-10-18,461,95,366,16,14,2
DKI JAKARTA,JAKARTA PUSAT,GAMBIR,DURI PULO,3171011006,2020-10-19,470,91,379,9,-4,13
DKI JAKARTA,JAKARTA PUSAT,GAMBIR,DURI PULO,3171011006,2020-10-20,475,89,386,5,-2,7
DKI JAKARTA,JAKARTA PUSAT,GAMBIR,DURI PULO,3171011006,2020-10-21,483,86,397,8,-3,11
DKI JAKARTA,JAKARTA PUSAT,GAMBIR,DURI PULO,3171011006,2020-10-22,490,69,421,7,-17,24
DKI JAKARTA,JAKARTA PUSAT,GAMBIR,DURI PULO,3171011006,2020-10-23,491,70,421,1,1,0
DKI JAKARTA,JAKARTA PUSAT,GAMBIR,DURI PULO,3171011006,2020-10-24,497,58,439,6,-12,18
DKI JAKARTA,JAKARTA PUSAT,GAMBIR,DURI PULO,3171011006,2020-10-25,500,58,442,3,0,3
DKI JAKARTA,JAKARTA PUSAT,GAMBIR,DURI PULO,3171011006,2020-10-26,500,56,444,0,-2,2
DKI JAKARTA,JAKARTA PUSAT,GAMBIR,DURI PULO,3171011006,2020-10-27,502,47,455,2,-9,11
DKI JAKARTA,JAKARTA PUSAT,GAMBIR,DURI PULO,3171011006,2020-10-28,507,45,462,5,-2,7
DKI JAKARTA,JAKARTA PUSAT,GAMBIR,DURI PULO,3171011006,2020-10-29,509,34,475,2,-11,13
DKI JAKARTA,JAKARTA PUSAT,GAMBIR,DURI PULO,3171011006,2020-10-30,517,29,488,8,-5,13
DKI JAKARTA,JAKARTA PUSAT,GAMBIR,DURI PULO,3171011006,2020-10-31,517,29,488,0,0,0
DKI JAKARTA,JAKARTA PUSAT,GAMBIR,GAMBIR,3171011001,2020-10-01,271,11,260,0,0,0
DKI JAKARTA,JAKARTA PUSAT,GAMBIR,GAMBIR,3171011001,2020-10-02,275,13,262,4,2,2
DKI JAKARTA,JAKARTA PUSAT,GAMBIR,GAMBIR,3171011001,2020-10-03,276,12,264,1,-1,2
DKI JAKARTA,JAKARTA PUSAT,GAMBIR,GAMBIR,3171011001,2020-10-04,283,17,266,7,5,2
DKI JAKARTA,JAKARTA PUSAT,GAMBIR,GAMBIR,3171011001,2020-10-05,284,17,267,1,0,1
DKI JAKARTA,JAKARTA PUSAT,GAMBIR,GAMBIR,3171011001,2020-10-06,284,16,268,0,-1,1
DKI JAKARTA,JAKARTA PUSAT,GAMBIR,GAMBIR,3171011001,2020-10-07,284,14,270,0,-2,2
DKI JAKARTA,JAKARTA PUSAT,GAMBIR,GAMBIR,3171011001,2020-10-08,342,12,330,58,-2,60
DKI JAKARTA,JAKARTA PUSAT,GAMBIR,GAMBIR,3171011001,2020-10-09,394,12,382,52,0,52
DKI JAKARTA,JAKARTA PUSAT,GAMBIR,GAMBIR,3171011001,2020-10-10,395,11,384,1,-1,2
DKI JAKARTA,JAKARTA PUSAT,GAMBIR,GAMBIR,3171011001,2020-10-11,396,12,384,1,1,0
DKI JAKARTA,JAKARTA PUSAT,GAMBIR,GAMBIR,3171011001,2020-10-12,397,12,385,1,0,1
DKI JAKARTA,JAKARTA PUSAT,GAMBIR,GAMBIR,3171011001,2020-10-13,397,12,385,0,0,0
DKI JAKARTA,JAKARTA PUSAT,GAMBIR,GAMBIR,3171011001,2020-10-14,399,12,387,2,0,2
DKI JAKARTA,JAKARTA PUSAT,GAMBIR,GAMBIR,3171011001,2020-10-15,404,14,390,5,2,3
DKI JAKARTA,JAKARTA PUSAT,GAMBIR,GAMBIR,3171011001,2020-10-16,404,9,395,0,-5,5
DKI JAKARTA,JAKARTA PUSAT,GAMBIR,GAMBIR,3171011001,2020-10-17,406,11,395,2,2,0
DKI JAKARTA,JAKARTA PUSAT,GAMBIR,GAMBIR,3171011001,2020-10-18,406,11,395,0,0,0
DKI JAKARTA,JAKARTA PUSAT,GAMBIR,GAMBIR,3171011001,2020-10-19,407,12,395,1,1,0
DKI JAKARTA,JAKARTA PUSAT,GAMBIR,GAMBIR,3171011001,2020-10-20,408,13,395,1,1,0
DKI JAKARTA,JAKARTA PUSAT,GAMBIR,GAMBIR,3171011001,2020-10-21,408,13,395,0,0,0
DKI JAKARTA,JAKARTA PUSAT,GAMBIR,GAMBIR,3171011001,2020-10-22,410,14,396,2,1,1
DKI JAKARTA,JAKARTA PUSAT,GAMBIR,GAMBIR,3171011001,2020-10-23,414,16,398,4,2,2
DKI JAKARTA,JAKARTA PUSAT,GAMBIR,GAMBIR,3171011001,2020-10-24,414,13,401,0,-3,3
DKI JAKARTA,JAKARTA PUSAT,GAMBIR,GAMBIR,3171011001,2020-10-25,415,13,402,1,0,1
DKI JAKARTA,JAKARTA PUSAT,GAMBIR,GAMBIR,3171011001,2020-10-26,416,10,406,1,-3,4
DKI JAKARTA,JAKARTA PUSAT,GAMBIR,GAMBIR,3171011001,2020-10-27,417,9,408,1,-1,2
DKI JAKARTA,JAKARTA PUSAT,GAMBIR,GAMBIR,3171011001,2020-10-28,420,12,408,3,3,0
DKI JAKARTA,JAKARTA PUSAT,GAMBIR,GAMBIR,3171011001,2020-10-29,420,10,410,0,-2,2
DKI JAKARTA,JAKARTA PUSAT,GAMBIR,GAMBIR,3171011001,2020-10-30,423,12,411,3,2,1
DKI JAKARTA,JAKARTA PUSAT,GAMBIR,GAMBIR,3171011001,2020-10-31,423,11,412,0,-1,1
DKI JAKARTA,JAKARTA PUSAT,GAMBIR,KEBON KELAPA,3171011005,2020-10-01,224,36,188,0,0,0
DKI JAKARTA,JAKARTA PUSAT,GAMBIR,KEBON KELAPA,3171011005,2020-10-02,234,43,191,10,7,3
DKI JAKARTA,JAKARTA PUSAT,GAMBIR,KEBON KELAPA,3171011005,2020-10-03,236,45,191,2,2,0
DKI JAKARTA,JAKARTA PUSAT,GAMBIR,KEBON KELAPA,3171011005,2020-10-04,236,45,191,0,0,0
DKI JAKARTA,JAKARTA PUSAT,GAMBIR,KEBON KELAPA,3171011005,2020-10-05,236,45,191,0,0,0
DKI JAKARTA,JAKARTA PUSAT,GAMBIR,KEBON KELAPA,3171011005,2020-10-06,242,36,206,6,-9,15
DKI JAKARTA,JAKARTA PUSAT,GAMBIR,KEBON KELAPA,3171011005,2020-10-07,243,32,211,1,-4,5
DKI JAKARTA,JAKARTA PUSAT,GAMBIR,KEBON KELAPA,3171011005,2020-10-08,252,38,214,9,6,3
DKI JAKARTA,JAKARTA PUSAT,GAMBIR,KEBON KELAPA,3171011005,2020-10-09,256,42,214,4,4,0
DKI JAKARTA,JAKARTA PUSAT,GAMBIR,KEBON KELAPA,3171011005,2020-10-10,256,39,217,0,-3,3
DKI JAKARTA,JAKARTA PUSAT,GAMBIR,KEBON KELAPA,3171011005,2020-10-11,257,39,218,1,0,1
DKI JAKARTA,JAKARTA PUSAT,GAMBIR,KEBON KELAPA,3171011005,2020-10-12,263,30,233,6,-9,15
DKI JAKARTA,JAKARTA PUSAT,GAMBIR,KEBON KELAPA,3171011005,2020-10-13,263,24,239,0,-6,6
DKI JAKARTA,JAKARTA PUSAT,GAMBIR,KEBON KELAPA,3171011005,2020-10-14,275,31,244,12,7,5
DKI JAKARTA,JAKARTA PUSAT,GAMBIR,KEBON KELAPA,3171011005,2020-10-15,282,37,245,7,6,1
DKI JAKARTA,JAKARTA PUSAT,GAMBIR,KEBON KELAPA,3171011005,2020-10-16,287,40,247,5,3,2
DKI JAKARTA,JAKARTA PUSAT,GAMBIR,KEBON KELAPA,3171011005,2020-10-17,288,41,247,1,1,0
DKI JAKARTA,JAKARTA PUSAT,GAMBIR,KEBON KELAPA,3171011005,2020-10-18,290,42,248,2,1,1
DKI JAKARTA,JAKARTA PUSAT,GAMBIR,KEBON KELAPA,3171011005,2020-10-19,291,42,249,1,0,1
DKI JAKARTA,JAKARTA PUSAT,GAMBIR,KEBON KELAPA,3171011005,2020-10-20,294,33,261,3,-9,12
DKI JAKARTA,JAKARTA PUSAT,GAMBIR,KEBON KELAPA,3171011005,2020-10-21,296,33,263,2,0,2
DKI JAKARTA,JAKARTA PUSAT,GAMBIR,KEBON KELAPA,3171011005,2020-10-22,302,36,266,6,3,3
DKI JAKARTA,JAKARTA PUSAT,GAMBIR,KEBON KELAPA,3171011005,2020-10-23,304,38,266,2,2,0
DKI JAKARTA,JAKARTA PUSAT,GAMBIR,KEBON KELAPA,3171011005,2020-10-24,305,29,276,1,-9,10
DKI JAKARTA,JAKARTA PUSAT,GAMBIR,KEBON KELAPA,3171011005,2020-10-25,306,30,276,1,1,0
DKI JAKARTA,JAKARTA PUSAT,GAMBIR,KEBON KELAPA,3171011005,2020-10-26,311,22,289,5,-8,13
DKI JAKARTA,JAKARTA PUSAT,GAMBIR,KEBON KELAPA,3171011005,2020-10-27,313,16,297,2,-6,8
DKI JAKARTA,JAKARTA PUSAT,GAMBIR,KEBON KELAPA,3171011005,2020-10-28,314,15,299,1,-1,2
DKI JAKARTA,JAKARTA PUSAT,GAMBIR,KEBON KELAPA,3171011005,2020-10-29,314,14,300,0,-1,1
DKI JAKARTA,JAKARTA PUSAT,GAMBIR,KEBON KELAPA,3171011005,2020-10-30,317,17,300,3,3,0
DKI JAKARTA,JAKARTA PUSAT,GAMBIR,KEBON KELAPA,3171011005,2020-10-31,317,17,300,0,0,0
DKI JAKARTA,JAKARTA PUSAT,GAMBIR,PETOJO SELATAN,3171011004,2020-10-01,625,89,536,0,0,0
DKI JAKARTA,JAKARTA PUSAT,GAMBIR,PETOJO SELATAN,3171011004,2020-10-02,651,101,550,26,12,14
DKI JAKARTA,JAKARTA PUSAT,GAMBIR,PETOJO SELATAN,3171011004,2020-10-03,660,109,551,9,8,1
DKI JAKARTA,JAKARTA PUSAT,GAMBIR,PETOJO SELATAN,3171011004,2020-10-04,662,111,551,2,2,0
DKI JAKARTA,JAKARTA PUSAT,GAMBIR,PETOJO SELATAN,3171011004,2020-10-05,663,101,562,1,-10,11
DKI JAKARTA,JAKARTA PUSAT,GAMBIR,PETOJO SELATAN,3171011004,2020-10-06,687,107,580,24,6,18
DKI JAKARTA,JAKARTA PUSAT,GAMBIR,PETOJO SELATAN,3171011004,2020-10-07,695,95,600,8,-12,20
DKI JAKARTA,JAKARTA PUSAT,GAMBIR,PETOJO SELATAN,3171011004,2020-10-08,703,96,607,8,1,7
DKI JAKARTA,JAKARTA PUSAT,GAMBIR,PETOJO SELATAN,3171011004,2020-10-09,704,97,607,1,1,0
DKI JAKARTA,JAKARTA PUSAT,GAMBIR,PETOJO SELATAN,3171011004,2020-10-10,706,82,624,2,-15,17
DKI JAKARTA,JAKARTA PUSAT,GAMBIR,PETOJO SELATAN,3171011004,2020-10-11,713,86,627,7,4,3
DKI JAKARTA,JAKARTA PUSAT,GAMBIR,PETOJO SELATAN,3171011004,2020-10-12,717,80,637,4,-6,10
DKI JAKARTA,JAKARTA PUSAT,GAMBIR,PETOJO SELATAN,3171011004,2020-10-13,718,51,667,1,-29,30
DKI JAKARTA,JAKARTA PUSAT,GAMBIR,PETOJO SELATAN,3171011004,2020-10-14,731,41,690,13,-10,23
DKI JAKARTA,JAKARTA PUSAT,GAMBIR,PETOJO SELATAN,3171011004,2020-10-15,749,58,691,18,17,1
DKI JAKARTA,JAKARTA PUSAT,GAMBIR,PETOJO SELATAN,3171011004,2020-10-16,754,57,697,5,-1,6
DKI JAKARTA,JAKARTA PUSAT,GAMBIR,PETOJO SELATAN,3171011004,2020-10-17,755,57,698,1,0,1
DKI JAKARTA,JAKARTA PUSAT,GAMBIR,PETOJO SELATAN,3171011004,2020-10-18,761,62,699,6,5,1
DKI JAKARTA,JAKARTA PUSAT,GAMBIR,PETOJO SELATAN,3171011004,2020-10-19,762,57,705,1,-5,6
DKI JAKARTA,JAKARTA PUSAT,GAMBIR,PETOJO SELATAN,3171011004,2020-10-20,766,56,710,4,-1,5
DKI JAKARTA,JAKARTA PUSAT,GAMBIR,PETOJO SELATAN,3171011004,2020-10-21,767,52,715,1,-4,5
DKI JAKARTA,JAKARTA PUSAT,GAMBIR,PETOJO SELATAN,3171011004,2020-10-22,769,49,720,2,-3,5
DKI JAKARTA,JAKARTA PUSAT,GAMBIR,PETOJO SELATAN,3171011004,2020-10-23,774,50,724,5,1,4
DKI JAKARTA,JAKARTA PUSAT,GAMBIR,PETOJO SELATAN,3171011004,2020-10-24,779,48,731,5,-2,7
DKI JAKARTA,JAKARTA PUSAT,GAMBIR,PETOJO SELATAN,3171011004,2020-10-25,779,47,732,0,-1,1
DKI JAKARTA,JAKARTA PUSAT,GAMBIR,PETOJO SELATAN,3171011004,2020-10-26,785,25,760,6,-22,28
DKI JAKARTA,JAKARTA PUSAT,GAMBIR,PETOJO SELATAN,3171011004,2020-10-27,788,20,768,3,-5,8
DKI JAKARTA,JAKARTA PUSAT,GAMBIR,PETOJO SELATAN,3171011004,2020-10-28,793,18,775,5,-2,7
DKI JAKARTA,JAKARTA PUSAT,GAMBIR,PETOJO SELATAN,3171011004,2020-10-29,795,11,784,2,-7,9
DKI JAKARTA,JAKARTA PUSAT,GAMBIR,PETOJO SELATAN,3171011004,2020-10-30,802,17,785,7,6,1
DKI JAKARTA,JAKARTA PUSAT,GAMBIR,PETOJO SELATAN,3171011004,2020-10-31,804,18,786,2,1,1
DKI JAKARTA,JAKARTA PUSAT,GAMBIR,PETOJO UTARA,3171011003,2020-10-01,324,33,291,0,0,0
DKI JAKARTA,JAKARTA PUSAT,GAMBIR,PETOJO UTARA,3171011003,2020-10-02,333,36,297,9,3,6
DKI JAKARTA,JAKARTA PUSAT,GAMBIR,PETOJO UTARA,3171011003,2020-10-03,335,34,301,2,-2,4
DKI JAKARTA,JAKARTA PUSAT,GAMBIR,PETOJO UTARA,3171011003,2020-10-04,344,41,303,9,7,2
DKI JAKARTA,JAKARTA PUSAT,GAMBIR,PETOJO UTARA,3171011003,2020-10-05,346,39,307,2,-2,4
DKI JAKARTA,JAKARTA PUSAT,GAMBIR,PETOJO UTARA,3171011003,2020-10-06,353,43,310,7,4,3
DKI JAKARTA,JAKARTA PUSAT,GAMBIR,PETOJO UTARA,3171011003,2020-10-07,357,45,312,4,2,2
DKI JAKARTA,JAKARTA PUSAT,GAMBIR,PETOJO UTARA,3171011003,2020-10-08,367,45,322,10,0,10
DKI JAKARTA,JAKARTA PUSAT,GAMBIR,PETOJO UTARA,3171011003,2020-10-09,368,46,322,1,1,0
DKI JAKARTA,JAKARTA PUSAT,GAMBIR,PETOJO UTARA,3171011003,2020-10-10,370,42,328,2,-4,6
DKI JAKARTA,JAKARTA PUSAT,GAMBIR,PETOJO UTARA,3171011003,2020-10-11,372,43,329,2,1,1
DKI JAKARTA,JAKARTA PUSAT,GAMBIR,PETOJO UTARA,3171011003,2020-10-12,375,36,339,3,-7,10
DKI JAKARTA,JAKARTA PUSAT,GAMBIR,PETOJO UTARA,3171011003,2020-10-13,375,33,342,0,-3,3
DKI JAKARTA,JAKARTA PUSAT,GAMBIR,PETOJO UTARA,3171011003,2020-10-14,377,32,345,2,-1,3
DKI JAKARTA,JAKARTA PUSAT,GAMBIR,PETOJO UTARA,3171011003,2020-10-15,379,28,351,2,-4,6
DKI JAKARTA,JAKARTA PUSAT,GAMBIR,PETOJO UTARA,3171011003,2020-10-16,382,23,359,3,-5,8
DKI JAKARTA,JAKARTA PUSAT,GAMBIR,PETOJO UTARA,3171011003,2020-10-17,388,28,360,6,5,1
DKI JAKARTA,JAKARTA PUSAT,GAMBIR,PETOJO UTARA,3171011003,2020-10-18,391,30,361,3,2,1
DKI JAKARTA,JAKARTA PUSAT,GAMBIR,PETOJO UTARA,3171011003,2020-10-19,393,26,367,2,-4,6
DKI JAKARTA,JAKARTA PUSAT,GAMBIR,PETOJO UTARA,3171011003,2020-10-20,394,20,374,1,-6,7
DKI JAKARTA,JAKARTA PUSAT,GAMBIR,PETOJO UTARA,3171011003,2020-10-21,400,23,377,6,3,3
DKI JAKARTA,JAKARTA PUSAT,GAMBIR,PETOJO UTARA,3171011003,2020-10-22,403,23,380,3,0,3
DKI JAKARTA,JAKARTA PUSAT,GAMBIR,PETOJO UTARA,3171011003,2020-10-23,404,24,380,1,1,0
DKI JAKARTA,JAKARTA PUSAT,GAMBIR,PETOJO UTARA,3171011003,2020-10-24,409,26,383,5,2,3
DKI JAKARTA,JAKARTA PUSAT,GAMBIR,PETOJO UTARA,3171011003,2020-10-25,410,27,383,1,1,0
DKI JAKARTA,JAKARTA PUSAT,GAMBIR,PETOJO UTARA,3171011003,2020-10-26,415,29,386,5,2,3
DKI JAKARTA,JAKARTA PUSAT,GAMBIR,PETOJO UTARA,3171011003,2020-10-27,418,29,389,3,0,3
DKI JAKARTA,JAKARTA PUSAT,GAMBIR,PETOJO UTARA,3171011003,2020-10-28,421,30,391,3,1,2
DKI JAKARTA,JAKARTA PUSAT,GAMBIR,PETOJO UTARA,3171011003,2020-10-29,422,25,397,1,-5,6
DKI JAKARTA,JAKARTA PUSAT,GAMBIR,PETOJO UTARA,3171011003,2020-10-30,426,26,400,4,1,3
DKI JAKARTA,JAKARTA PUSAT,GAMBIR,PETOJO UTARA,3171011003,2020-10-31,431,28,403,5,2,3
DKI JAKARTA,JAKARTA PUSAT,JOHAR BARU,GALUR,3171081003,2020-10-01,404,31,373,0,0,0
DKI JAKARTA,JAKARTA PUSAT,JOHAR BARU,GALUR,3171081003,2020-10-02,407,22,385,3,-9,12
DKI JAKARTA,JAKARTA PUSAT,JOHAR BARU,GALUR,3171081003,2020-10-03,409,21,388,2,-1,3
DKI JAKARTA,JAKARTA PUSAT,JOHAR BARU,GALUR,3171081003,2020-10-04,420,28,392,11,7,4
DKI JAKARTA,JAKARTA PUSAT,JOHAR BARU,GALUR,3171081003,2020-10-05,434,41,393,14,13,1
DKI JAKARTA,JAKARTA PUSAT,JOHAR BARU,GALUR,3171081003,2020-10-06,438,40,398,4,-1,5
DKI JAKARTA,JAKARTA PUSAT,JOHAR BARU,GALUR,3171081003,2020-10-07,452,53,399,14,13,1
DKI JAKARTA,JAKARTA PUSAT,JOHAR BARU,GALUR,3171081003,2020-10-08,472,56,416,20,3,17
DKI JAKARTA,JAKARTA PUSAT,JOHAR BARU,GALUR,3171081003,2020-10-09,474,57,417,2,1,1
DKI JAKARTA,JAKARTA PUSAT,JOHAR BARU,GALUR,3171081003,2020-10-10,481,61,420,7,4,3
DKI JAKARTA,JAKARTA PUSAT,JOHAR BARU,GALUR,3171081003,2020-10-11,491,71,420,10,10,0
DKI JAKARTA,JAKARTA PUSAT,JOHAR BARU,GALUR,3171081003,2020-10-12,491,69,422,0,-2,2
DKI JAKARTA,JAKARTA PUSAT,JOHAR BARU,GALUR,3171081003,2020-10-13,491,66,425,0,-3,3
DKI JAKARTA,JAKARTA PUSAT,JOHAR BARU,GALUR,3171081003,2020-10-14,502,58,444,11,-8,19
DKI JAKARTA,JAKARTA PUSAT,JOHAR BARU,GALUR,3171081003,2020-10-15,506,50,456,4,-8,12
DKI JAKARTA,JAKARTA PUSAT,JOHAR BARU,GALUR,3171081003,2020-10-16,509,39,470,3,-11,14
DKI JAKARTA,JAKARTA PUSAT,JOHAR BARU,GALUR,3171081003,2020-10-17,518,41,477,9,2,7
DKI JAKARTA,JAKARTA PUSAT,JOHAR BARU,GALUR,3171081003,2020-10-18,522,45,477,4,4,0
DKI JAKARTA,JAKARTA PUSAT,JOHAR BARU,GALUR,3171081003,2020-10-19,522,35,487,0,-10,10
DKI JAKARTA,JAKARTA PUSAT,JOHAR BARU,GALUR,3171081003,2020-10-20,523,22,501,1,-13,14
DKI JAKARTA,JAKARTA PUSAT,JOHAR BARU,GALUR,3171081003,2020-10-21,523,21,502,0,-1,1
DKI JAKARTA,JAKARTA PUSAT,JOHAR BARU,GALUR,3171081003,2020-10-22,523,12,511,0,-9,9
DKI JAKARTA,JAKARTA PUSAT,JOHAR BARU,GALUR,3171081003,2020-10-23,528,17,511,5,5,0
DKI JAKARTA,JAKARTA PUSAT,JOHAR BARU,GALUR,3171081003,2020-10-24,528,15,513,0,-2,2
DKI JAKARTA,JAKARTA PUSAT,JOHAR BARU,GALUR,3171081003,2020-10-25,530,15,515,2,0,2
DKI JAKARTA,JAKARTA PUSAT,JOHAR BARU,GALUR,3171081003,2020-10-26,531,16,515,1,1,0
DKI JAKARTA,JAKARTA PUSAT,JOHAR BARU,GALUR,3171081003,2020-10-27,533,13,520,2,-3,5
DKI JAKARTA,JAKARTA PUSAT,JOHAR BARU,GALUR,3171081003,2020-10-28,533,10,523,0,-3,3
DKI JAKARTA,JAKARTA PUSAT,JOHAR BARU,GALUR,3171081003,2020-10-29,537,12,525,4,2,2
DKI JAKARTA,JAKARTA PUSAT,JOHAR BARU,GALUR,3171081003,2020-10-30,549,22,527,12,10,2
DKI JAKARTA,JAKARTA PUSAT,JOHAR BARU,GALUR,3171081003,2020-10-31,551,17,534,2,-5,7
DKI JAKARTA,JAKARTA PUSAT,JOHAR BARU,JOHAR BARU,3171081001,2020-10-01,1469,84,1385,0,0,0
DKI JAKARTA,JAKARTA PUSAT,JOHAR BARU,JOHAR BARU,3171081001,2020-10-02,1487,79,1408,18,-5,23
DKI JAKARTA,JAKARTA PUSAT,JOHAR BARU,JOHAR BARU,3171081001,2020-10-03,1496,84,1412,9,5,4
DKI JAKARTA,JAKARTA PUSAT,JOHAR BARU,JOHAR BARU,3171081001,2020-10-04,1525,110,1415,29,26,3
DKI JAKARTA,JAKARTA PUSAT,JOHAR BARU,JOHAR BARU,3171081001,2020-10-05,1554,123,1431,29,13,16
DKI JAKARTA,JAKARTA PUSAT,JOHAR BARU,JOHAR BARU,3171081001,2020-10-06,1572,111,1461,18,-12,30
DKI JAKARTA,JAKARTA PUSAT,JOHAR BARU,JOHAR BARU,3171081001,2020-10-07,1596,123,1473,24,12,12
DKI JAKARTA,JAKARTA PUSAT,JOHAR BARU,JOHAR BARU,3171081001,2020-10-08,1616,118,1498,20,-5,25
DKI JAKARTA,JAKARTA PUSAT,JOHAR BARU,JOHAR BARU,3171081001,2020-10-09,1630,131,1499,14,13,1
DKI JAKARTA,JAKARTA PUSAT,JOHAR BARU,JOHAR BARU,3171081001,2020-10-10,1641,131,1510,11,0,11
DKI JAKARTA,JAKARTA PUSAT,JOHAR BARU,JOHAR BARU,3171081001,2020-10-11,1683,170,1513,42,39,3
DKI JAKARTA,JAKARTA PUSAT,JOHAR BARU,JOHAR BARU,3171081001,2020-10-12,1705,182,1523,22,12,10
DKI JAKARTA,JAKARTA PUSAT,JOHAR BARU,JOHAR BARU,3171081001,2020-10-13,1709,175,1534,4,-7,11
DKI JAKARTA,JAKARTA PUSAT,JOHAR BARU,JOHAR BARU,3171081001,2020-10-14,1736,153,1583,27,-22,49
DKI JAKARTA,JAKARTA PUSAT,JOHAR BARU,JOHAR BARU,3171081001,2020-10-15,1757,105,1652,21,-48,69
DKI JAKARTA,JAKARTA PUSAT,JOHAR BARU,JOHAR BARU,3171081001,2020-10-16,1763,89,1674,6,-16,22
DKI JAKARTA,JAKARTA PUSAT,JOHAR BARU,JOHAR BARU,3171081001,2020-10-17,1782,99,1683,19,10,9
DKI JAKARTA,JAKARTA PUSAT,JOHAR BARU,JOHAR BARU,3171081001,2020-10-18,1790,106,1684,8,7,1
DKI JAKARTA,JAKARTA PUSAT,JOHAR BARU,JOHAR BARU,3171081001,2020-10-19,1792,95,1697,2,-11,13
DKI JAKARTA,JAKARTA PUSAT,JOHAR BARU,JOHAR BARU,3171081001,2020-10-20,1813,88,1725,21,-7,28
DKI JAKARTA,JAKARTA PUSAT,JOHAR BARU,JOHAR BARU,3171081001,2020-10-21,1825,84,1741,12,-4,16
DKI JAKARTA,JAKARTA PUSAT,JOHAR BARU,JOHAR BARU,3171081001,2020-10-22,1829,74,1755,4,-10,14
DKI JAKARTA,JAKARTA PUSAT,JOHAR BARU,JOHAR BARU,3171081001,2020-10-23,1838,80,1758,9,6,3
DKI JAKARTA,JAKARTA PUSAT,JOHAR BARU,JOHAR BARU,3171081001,2020-10-24,1843,56,1787,5,-24,29
DKI JAKARTA,JAKARTA PUSAT,JOHAR BARU,JOHAR BARU,3171081001,2020-10-25,1847,58,1789,4,2,2
DKI JAKARTA,JAKARTA PUSAT,JOHAR BARU,JOHAR BARU,3171081001,2020-10-26,1858,51,1807,11,-7,18
DKI JAKARTA,JAKARTA PUSAT,JOHAR BARU,JOHAR BARU,3171081001,2020-10-27,1865,46,1819,7,-5,12
DKI JAKARTA,JAKARTA PUSAT,JOHAR BARU,JOHAR BARU,3171081001,2020-10-28,1875,51,1824,10,5,5
DKI JAKARTA,JAKARTA PUSAT,JOHAR BARU,JOHAR BARU,3171081001,2020-10-29,1892,52,1842,17,1,18
DKI JAKARTA,JAKARTA PUSAT,JOHAR BARU,JOHAR BARU,3171081001,2020-10-30,1924,76,1850,32,24,8
DKI JAKARTA,JAKARTA PUSAT,JOHAR BARU,JOHAR BARU,3171081001,2020-10-31,1940,79,1863,16,3,13
DKI JAKARTA,JAKARTA PUSAT,JOHAR BARU,KAMPUNG RAWA,3171081002,2020-10-01,599,31,568,0,0,0
DKI JAKARTA,JAKARTA PUSAT,JOHAR BARU,KAMPUNG RAWA,3171081002,2020-10-02,610,35,575,11,4,7
DKI JAKARTA,JAKARTA PUSAT,JOHAR BARU,KAMPUNG RAWA,3171081002,2020-10-03,617,41,576,7,6,1
DKI JAKARTA,JAKARTA PUSAT,JOHAR BARU,KAMPUNG RAWA,3171081002,2020-10-04,628,51,577,11,10,1
DKI JAKARTA,JAKARTA PUSAT,JOHAR BARU,KAMPUNG RAWA,3171081002,2020-10-05,639,57,582,11,6,5
DKI JAKARTA,JAKARTA PUSAT,JOHAR BARU,KAMPUNG RAWA,3171081002,2020-10-06,654,49,605,15,-8,23
DKI JAKARTA,JAKARTA PUSAT,JOHAR BARU,KAMPUNG RAWA,3171081002,2020-10-07,663,57,606,9,8,1
DKI JAKARTA,JAKARTA PUSAT,JOHAR BARU,KAMPUNG RAWA,3171081002,2020-10-08,685,68,617,22,11,11
DKI JAKARTA,JAKARTA PUSAT,JOHAR BARU,KAMPUNG RAWA,3171081002,2020-10-09,689,70,619,4,2,2
DKI JAKARTA,JAKARTA PUSAT,JOHAR BARU,KAMPUNG RAWA,3171081002,2020-10-10,690,67,623,1,-3,4
DKI JAKARTA,JAKARTA PUSAT,JOHAR BARU,KAMPUNG RAWA,3171081002,2020-10-11,717,93,624,27,26,1
DKI JAKARTA,JAKARTA PUSAT,JOHAR BARU,KAMPUNG RAWA,3171081002,2020-10-12,723,91,632,6,-2,8
DKI JAKARTA,JAKARTA PUSAT,JOHAR BARU,KAMPUNG RAWA,3171081002,2020-10-13,724,82,642,1,-9,10
DKI JAKARTA,JAKARTA PUSAT,JOHAR BARU,KAMPUNG RAWA,3171081002,2020-10-14,734,67,667,10,-15,25
DKI JAKARTA,JAKARTA PUSAT,JOHAR BARU,KAMPUNG RAWA,3171081002,2020-10-15,744,56,688,10,-11,21
DKI JAKARTA,JAKARTA PUSAT,JOHAR BARU,KAMPUNG RAWA,3171081002,2020-10-16,751,60,691,7,4,3
DKI JAKARTA,JAKARTA PUSAT,JOHAR BARU,KAMPUNG RAWA,3171081002,2020-10-17,754,62,692,3,2,1
DKI JAKARTA,JAKARTA PUSAT,JOHAR BARU,KAMPUNG RAWA,3171081002,2020-10-18,757,63,694,3,1,2
DKI JAKARTA,JAKARTA PUSAT,JOHAR BARU,KAMPUNG RAWA,3171081002,2020-10-19,759,48,711,2,-15,17
DKI JAKARTA,JAKARTA PUSAT,JOHAR BARU,KAMPUNG RAWA,3171081002,2020-10-20,763,31,732,4,-17,21
DKI JAKARTA,JAKARTA PUSAT,JOHAR BARU,KAMPUNG RAWA,3171081002,2020-10-21,764,28,736,1,-3,4
DKI JAKARTA,JAKARTA PUSAT,JOHAR BARU,KAMPUNG RAWA,3171081002,2020-10-22,765,23,742,1,-5,6
DKI JAKARTA,JAKARTA PUSAT,JOHAR BARU,KAMPUNG RAWA,3171081002,2020-10-23,771,29,742,6,6,0
DKI JAKARTA,JAKARTA PUSAT,JOHAR BARU,KAMPUNG RAWA,3171081002,2020-10-24,772,26,746,1,-3,4
DKI JAKARTA,JAKARTA PUSAT,JOHAR BARU,KAMPUNG RAWA,3171081002,2020-10-25,773,26,747,1,0,1
DKI JAKARTA,JAKARTA PUSAT,JOHAR BARU,KAMPUNG RAWA,3171081002,2020-10-26,777,25,752,4,-1,5
DKI JAKARTA,JAKARTA PUSAT,JOHAR BARU,KAMPUNG RAWA,3171081002,2020-10-27,780,23,757,3,-2,5
DKI JAKARTA,JAKARTA PUSAT,JOHAR BARU,KAMPUNG RAWA,3171081002,2020-10-28,784,20,764,4,-3,7
DKI JAKARTA,JAKARTA PUSAT,JOHAR BARU,KAMPUNG RAWA,3171081002,2020-10-29,794,25,769,10,5,5
DKI JAKARTA,JAKARTA PUSAT,JOHAR BARU,KAMPUNG RAWA,3171081002,2020-10-30,803,31,772,9,6,3
DKI JAKARTA,JAKARTA PUSAT,JOHAR BARU,KAMPUNG RAWA,3171081002,2020-10-31,807,32,775,4,1,3
DKI JAKARTA,JAKARTA PUSAT,JOHAR BARU,TANAH TINGGI,3171081004,2020-10-01,804,54,750,0,0,0
DKI JAKARTA,JAKARTA PUSAT,JOHAR BARU,TANAH TINGGI,3171081004,2020-10-02,825,69,756,21,15,6
DKI JAKARTA,JAKARTA PUSAT,JOHAR BARU,TANAH TINGGI,3171081004,2020-10-03,832,72,760,7,3,4
DKI JAKARTA,JAKARTA PUSAT,JOHAR BARU,TANAH TINGGI,3171081004,2020-10-04,849,88,761,17,16,1
DKI JAKARTA,JAKARTA PUSAT,JOHAR BARU,TANAH TINGGI,3171081004,2020-10-05,868,100,768,19,12,7
DKI JAKARTA,JAKARTA PUSAT,JOHAR BARU,TANAH TINGGI,3171081004,2020-10-06,890,92,798,22,-8,30
DKI JAKARTA,JAKARTA PUSAT,JOHAR BARU,TANAH TINGGI,3171081004,2020-10-07,913,106,807,23,14,9
DKI JAKARTA,JAKARTA PUSAT,JOHAR BARU,TANAH TINGGI,3171081004,2020-10-08,936,102,834,23,-4,27
DKI JAKARTA,JAKARTA PUSAT,JOHAR BARU,TANAH TINGGI,3171081004,2020-10-09,938,104,834,2,2,0
DKI JAKARTA,JAKARTA PUSAT,JOHAR BARU,TANAH TINGGI,3171081004,2020-10-10,944,96,848,6,-8,14
DKI JAKARTA,JAKARTA PUSAT,JOHAR BARU,TANAH TINGGI,3171081004,2020-10-11,955,104,851,11,8,3
DKI JAKARTA,JAKARTA PUSAT,JOHAR BARU,TANAH TINGGI,3171081004,2020-10-12,957,93,864,2,-11,13
DKI JAKARTA,JAKARTA PUSAT,JOHAR BARU,TANAH TINGGI,3171081004,2020-10-13,963,86,877,6,-7,13
DKI JAKARTA,JAKARTA PUSAT,JOHAR BARU,TANAH TINGGI,3171081004,2020-10-14,977,74,903,14,-12,26
DKI JAKARTA,JAKARTA PUSAT,JOHAR BARU,TANAH TINGGI,3171081004,2020-10-15,1007,70,937,30,-4,34
DKI JAKARTA,JAKARTA PUSAT,JOHAR BARU,TANAH TINGGI,3171081004,2020-10-16,1010,52,958,3,-18,21
DKI JAKARTA,JAKARTA PUSAT,JOHAR BARU,TANAH TINGGI,3171081004,2020-10-17,1027,63,964,17,11,6
DKI JAKARTA,JAKARTA PUSAT,JOHAR BARU,TANAH TINGGI,3171081004,2020-10-18,1045,80,965,18,17,1
DKI JAKARTA,JAKARTA PUSAT,JOHAR BARU,TANAH TINGGI,3171081004,2020-10-19,1048,65,983,3,-15,18
DKI JAKARTA,JAKARTA PUSAT,JOHAR BARU,TANAH TINGGI,3171081004,2020-10-20,1065,62,1003,17,-3,20
DKI JAKARTA,JAKARTA PUSAT,JOHAR BARU,TANAH TINGGI,3171081004,2020-10-21,1068,60,1008,3,-2,5
DKI JAKARTA,JAKARTA PUSAT,JOHAR BARU,TANAH TINGGI,3171081004,2020-10-22,1072,55,1017,4,-5,9
DKI JAKARTA,JAKARTA PUSAT,JOHAR BARU,TANAH TINGGI,3171081004,2020-10-23,1078,58,1020,6,3,3
DKI JAKARTA,JAKARTA PUSAT,JOHAR BARU,TANAH TINGGI,3171081004,2020-10-24,1079,56,1023,1,-2,3
DKI JAKARTA,JAKARTA PUSAT,JOHAR BARU,TANAH TINGGI,3171081004,2020-10-25,1088,62,1026,9,6,3
DKI JAKARTA,JAKARTA PUSAT,JOHAR BARU,TANAH TINGGI,3171081004,2020-10-26,1091,58,1033,3,-4,7
DKI JAKARTA,JAKARTA PUSAT,JOHAR BARU,TANAH TINGGI,3171081004,2020-10-27,1099,57,1042,8,-1,9
DKI JAKARTA,JAKARTA PUSAT,JOHAR BARU,TANAH TINGGI,3171081004,2020-10-28,1104,59,1045,5,2,3
DKI JAKARTA,JAKARTA PUSAT,JOHAR BARU,TANAH TINGGI,3171081004,2020-10-29,1119,51,1068,15,-8,23
DKI JAKARTA,JAKARTA PUSAT,JOHAR BARU,TANAH TINGGI,3171081004,2020-10-30,1132,54,1078,13,3,10
DKI JAKARTA,JAKARTA PUSAT,JOHAR BARU,TANAH TINGGI,3171081004,2020-10-31,1135,52,1083,3,-2,5
DKI JAKARTA,JAKARTA PUSAT,KEMAYORAN,CEMPAKA BARU,3171031006,2020-10-01,668,86,582,0,0,0
DKI JAKARTA,JAKARTA PUSAT,KEMAYORAN,CEMPAKA BARU,3171031006,2020-10-02,681,94,587,13,8,5
DKI JAKARTA,JAKARTA PUSAT,KEMAYORAN,CEMPAKA BARU,3171031006,2020-10-03,707,119,588,26,25,1
DKI JAKARTA,JAKARTA PUSAT,KEMAYORAN,CEMPAKA BARU,3171031006,2020-10-04,716,126,590,9,7,2
DKI JAKARTA,JAKARTA PUSAT,KEMAYORAN,CEMPAKA BARU,3171031006,2020-10-05,724,117,607,8,-9,17
DKI JAKARTA,JAKARTA PUSAT,KEMAYORAN,CEMPAKA BARU,3171031006,2020-10-06,763,105,658,39,-12,51
DKI JAKARTA,JAKARTA PUSAT,KEMAYORAN,CEMPAKA BARU,3171031006,2020-10-07,780,111,669,17,6,11
DKI JAKARTA,JAKARTA PUSAT,KEMAYORAN,CEMPAKA BARU,3171031006,2020-10-08,843,156,687,63,45,18
DKI JAKARTA,JAKARTA PUSAT,KEMAYORAN,CEMPAKA BARU,3171031006,2020-10-09,846,159,687,3,3,0
DKI JAKARTA,JAKARTA PUSAT,KEMAYORAN,CEMPAKA BARU,3171031006,2020-10-10,852,133,719,6,-26,32
DKI JAKARTA,JAKARTA PUSAT,KEMAYORAN,CEMPAKA BARU,3171031006,2020-10-11,884,159,725,32,26,6
DKI JAKARTA,JAKARTA PUSAT,KEMAYORAN,CEMPAKA BARU,3171031006,2020-10-12,899,153,746,15,-6,21
DKI JAKARTA,JAKARTA PUSAT,KEMAYORAN,CEMPAKA BARU,3171031006,2020-10-13,904,147,757,5,-6,11
DKI JAKARTA,JAKARTA PUSAT,KEMAYORAN,CEMPAKA BARU,3171031006,2020-10-14,919,151,768,15,4,11
DKI JAKARTA,JAKARTA PUSAT,KEMAYORAN,CEMPAKA BARU,3171031006,2020-10-15,941,161,780,22,10,12
DKI JAKARTA,JAKARTA PUSAT,KEMAYORAN,CEMPAKA BARU,3171031006,2020-10-16,947,146,801,6,-15,21
DKI JAKARTA,JAKARTA PUSAT,KEMAYORAN,CEMPAKA BARU,3171031006,2020-10-17,956,152,804,9,6,3
DKI JAKARTA,JAKARTA PUSAT,KEMAYORAN,CEMPAKA BARU,3171031006,2020-10-18,963,156,807,7,4,3
DKI JAKARTA,JAKARTA PUSAT,KEMAYORAN,CEMPAKA BARU,3171031006,2020-10-19,966,116,850,3,-40,43
DKI JAKARTA,JAKARTA PUSAT,KEMAYORAN,CEMPAKA BARU,3171031006,2020-10-20,981,117,864,15,1,14
DKI JAKARTA,JAKARTA PUSAT,KEMAYORAN,CEMPAKA BARU,3171031006,2020-10-21,993,116,877,12,-1,13
DKI JAKARTA,JAKARTA PUSAT,KEMAYORAN,CEMPAKA BARU,3171031006,2020-10-22,1002,91,911,9,-25,34
DKI JAKARTA,JAKARTA PUSAT,KEMAYORAN,CEMPAKA BARU,3171031006,2020-10-23,1011,99,912,9,8,1
DKI JAKARTA,JAKARTA PUSAT,KEMAYORAN,CEMPAKA BARU,3171031006,2020-10-24,1016,88,928,5,-11,16
DKI JAKARTA,JAKARTA PUSAT,KEMAYORAN,CEMPAKA BARU,3171031006,2020-10-25,1019,89,930,3,1,2
DKI JAKARTA,JAKARTA PUSAT,KEMAYORAN,CEMPAKA BARU,3171031006,2020-10-26,1028,83,945,9,-6,15
DKI JAKARTA,JAKARTA PUSAT,KEMAYORAN,CEMPAKA BARU,3171031006,2020-10-27,1031,81,950,3,-2,5
DKI JAKARTA,JAKARTA PUSAT,KEMAYORAN,CEMPAKA BARU,3171031006,2020-10-28,1036,70,966,5,-11,16
DKI JAKARTA,JAKARTA PUSAT,KEMAYORAN,CEMPAKA BARU,3171031006,2020-10-29,1041,59,982,5,-11,16
DKI JAKARTA,JAKARTA PUSAT,KEMAYORAN,CEMPAKA BARU,3171031006,2020-10-30,1044,54,990,3,-5,8
DKI JAKARTA,JAKARTA PUSAT,KEMAYORAN,CEMPAKA BARU,3171031006,2020-10-31,1046,56,990,2,2,0
DKI JAKARTA,JAKARTA PUSAT,KEMAYORAN,GUNUNG SAHARI SELATAN,3171031005,2020-10-01,379,67,312,0,0,0
DKI JAKARTA,JAKARTA PUSAT,KEMAYORAN,GUNUNG SAHARI SELATAN,3171031005,2020-10-02,385,51,334,6,-16,22
DKI JAKARTA,JAKARTA PUSAT,KEMAYORAN,GUNUNG SAHARI SELATAN,3171031005,2020-10-03,398,63,335,13,12,1
DKI JAKARTA,JAKARTA PUSAT,KEMAYORAN,GUNUNG SAHARI SELATAN,3171031005,2020-10-04,399,63,336,1,0,1
DKI JAKARTA,JAKARTA PUSAT,KEMAYORAN,GUNUNG SAHARI SELATAN,3171031005,2020-10-05,399,63,336,0,0,0
DKI JAKARTA,JAKARTA PUSAT,KEMAYORAN,GUNUNG SAHARI SELATAN,3171031005,2020-10-06,409,43,366,10,-20,30
DKI JAKARTA,JAKARTA PUSAT,KEMAYORAN,GUNUNG SAHARI SELATAN,3171031005,2020-10-07,410,29,381,1,-14,15
DKI JAKARTA,JAKARTA PUSAT,KEMAYORAN,GUNUNG SAHARI SELATAN,3171031005,2020-10-08,417,36,381,7,7,0
DKI JAKARTA,JAKARTA PUSAT,KEMAYORAN,GUNUNG SAHARI SELATAN,3171031005,2020-10-09,419,37,382,2,1,1
DKI JAKARTA,JAKARTA PUSAT,KEMAYORAN,GUNUNG SAHARI SELATAN,3171031005,2020-10-10,428,43,385,9,6,3
DKI JAKARTA,JAKARTA PUSAT,KEMAYORAN,GUNUNG SAHARI SELATAN,3171031005,2020-10-11,440,55,385,12,12,0
DKI JAKARTA,JAKARTA PUSAT,KEMAYORAN,GUNUNG SAHARI SELATAN,3171031005,2020-10-12,460,64,396,20,9,11
DKI JAKARTA,JAKARTA PUSAT,KEMAYORAN,GUNUNG SAHARI SELATAN,3171031005,2020-10-13,462,58,404,2,-6,8
DKI JAKARTA,JAKARTA PUSAT,KEMAYORAN,GUNUNG SAHARI SELATAN,3171031005,2020-10-14,487,77,410,25,19,6
DKI JAKARTA,JAKARTA PUSAT,KEMAYORAN,GUNUNG SAHARI SELATAN,3171031005,2020-10-15,498,87,411,11,10,1
DKI JAKARTA,JAKARTA PUSAT,KEMAYORAN,GUNUNG SAHARI SELATAN,3171031005,2020-10-16,502,89,413,4,2,2
DKI JAKARTA,JAKARTA PUSAT,KEMAYORAN,GUNUNG SAHARI SELATAN,3171031005,2020-10-17,513,100,413,11,11,0
DKI JAKARTA,JAKARTA PUSAT,KEMAYORAN,GUNUNG SAHARI SELATAN,3171031005,2020-10-18,516,103,413,3,3,0
DKI JAKARTA,JAKARTA PUSAT,KEMAYORAN,GUNUNG SAHARI SELATAN,3171031005,2020-10-19,518,102,416,2,-1,3
DKI JAKARTA,JAKARTA PUSAT,KEMAYORAN,GUNUNG SAHARI SELATAN,3171031005,2020-10-20,520,100,420,2,-2,4
DKI JAKARTA,JAKARTA PUSAT,KEMAYORAN,GUNUNG SAHARI SELATAN,3171031005,2020-10-21,522,84,438,2,-16,18
DKI JAKARTA,JAKARTA PUSAT,KEMAYORAN,GUNUNG SAHARI SELATAN,3171031005,2020-10-22,522,81,441,0,-3,3
DKI JAKARTA,JAKARTA PUSAT,KEMAYORAN,GUNUNG SAHARI SELATAN,3171031005,2020-10-23,528,87,441,6,6,0
DKI JAKARTA,JAKARTA PUSAT,KEMAYORAN,GUNUNG SAHARI SELATAN,3171031005,2020-10-24,533,47,486,5,-40,45
DKI JAKARTA,JAKARTA PUSAT,KEMAYORAN,GUNUNG SAHARI SELATAN,3171031005,2020-10-25,535,48,487,2,1,1
DKI JAKARTA,JAKARTA PUSAT,KEMAYORAN,GUNUNG SAHARI SELATAN,3171031005,2020-10-26,542,43,499,7,-5,12
DKI JAKARTA,JAKARTA PUSAT,KEMAYORAN,GUNUNG SAHARI SELATAN,3171031005,2020-10-27,543,36,507,1,-7,8
DKI JAKARTA,JAKARTA PUSAT,KEMAYORAN,GUNUNG SAHARI SELATAN,3171031005,2020-10-28,544,34,510,1,-2,3
DKI JAKARTA,JAKARTA PUSAT,KEMAYORAN,GUNUNG SAHARI SELATAN,3171031005,2020-10-29,546,22,524,2,-12,14
DKI JAKARTA,JAKARTA PUSAT,KEMAYORAN,GUNUNG SAHARI SELATAN,3171031005,2020-10-30,550,25,525,4,3,1
DKI JAKARTA,JAKARTA PUSAT,KEMAYORAN,GUNUNG SAHARI SELATAN,3171031005,2020-10-31,555,30,525,5,5,0
DKI JAKARTA,JAKARTA PUSAT,KEMAYORAN,HARAPAN MULIA,3171031003,2020-10-01,422,43,379,0,0,0
DKI JAKARTA,JAKARTA PUSAT,KEMAYORAN,HARAPAN MULIA,3171031003,2020-10-02,428,47,381,6,4,2
DKI JAKARTA,JAKARTA PUSAT,KEMAYORAN,HARAPAN MULIA,3171031003,2020-10-03,439,55,384,11,8,3
DKI JAKARTA,JAKARTA PUSAT,KEMAYORAN,HARAPAN MULIA,3171031003,2020-10-04,448,64,384,9,9,0
DKI JAKARTA,JAKARTA PUSAT,KEMAYORAN,HARAPAN MULIA,3171031003,2020-10-05,450,54,396,2,-10,12
DKI JAKARTA,JAKARTA PUSAT,KEMAYORAN,HARAPAN MULIA,3171031003,2020-10-06,473,63,410,23,9,14
DKI JAKARTA,JAKARTA PUSAT,KEMAYORAN,HARAPAN MULIA,3171031003,2020-10-07,478,54,424,5,-9,14
DKI JAKARTA,JAKARTA PUSAT,KEMAYORAN,HARAPAN MULIA,3171031003,2020-10-08,489,61,428,11,7,4
DKI JAKARTA,JAKARTA PUSAT,KEMAYORAN,HARAPAN MULIA,3171031003,2020-10-09,495,66,429,6,5,1
DKI JAKARTA,JAKARTA PUSAT,KEMAYORAN,HARAPAN MULIA,3171031003,2020-10-10,499,65,434,4,-1,5
DKI JAKARTA,JAKARTA PUSAT,KEMAYORAN,HARAPAN MULIA,3171031003,2020-10-11,509,72,437,10,7,3
DKI JAKARTA,JAKARTA PUSAT,KEMAYORAN,HARAPAN MULIA,3171031003,2020-10-12,519,73,446,10,1,9
DKI JAKARTA,JAKARTA PUSAT,KEMAYORAN,HARAPAN MULIA,3171031003,2020-10-13,521,69,452,2,-4,6
DKI JAKARTA,JAKARTA PUSAT,KEMAYORAN,HARAPAN MULIA,3171031003,2020-10-14,529,72,457,8,3,5
DKI JAKARTA,JAKARTA PUSAT,KEMAYORAN,HARAPAN MULIA,3171031003,2020-10-15,538,55,483,9,-17,26
DKI JAKARTA,JAKARTA PUSAT,KEMAYORAN,HARAPAN MULIA,3171031003,2020-10-16,541,52,489,3,-3,6
DKI JAKARTA,JAKARTA PUSAT,KEMAYORAN,HARAPAN MULIA,3171031003,2020-10-17,550,59,491,9,7,2
DKI JAKARTA,JAKARTA PUSAT,KEMAYORAN,HARAPAN MULIA,3171031003,2020-10-18,551,60,491,1,1,0
DKI JAKARTA,JAKARTA PUSAT,KEMAYORAN,HARAPAN MULIA,3171031003,2020-10-19,554,52,502,3,-8,11
DKI JAKARTA,JAKARTA PUSAT,KEMAYORAN,HARAPAN MULIA,3171031003,2020-10-20,558,51,507,4,-1,5
DKI JAKARTA,JAKARTA PUSAT,KEMAYORAN,HARAPAN MULIA,3171031003,2020-10-21,582,57,525,24,6,18
DKI JAKARTA,JAKARTA PUSAT,KEMAYORAN,HARAPAN MULIA,3171031003,2020-10-22,568,43,525,-14,-14,0
DKI JAKARTA,JAKARTA PUSAT,KEMAYORAN,HARAPAN MULIA,3171031003,2020-10-23,569,43,526,1,0,1
DKI JAKARTA,JAKARTA PUSAT,KEMAYORAN,HARAPAN MULIA,3171031003,2020-10-24,572,39,533,3,-4,7
DKI JAKARTA,JAKARTA PUSAT,KEMAYORAN,HARAPAN MULIA,3171031003,2020-10-25,572,39,533,0,0,0
DKI JAKARTA,JAKARTA PUSAT,KEMAYORAN,HARAPAN MULIA,3171031003,2020-10-26,578,36,542,6,-3,9
DKI JAKARTA,JAKARTA PUSAT,KEMAYORAN,HARAPAN MULIA,3171031003,2020-10-27,580,33,547,2,-3,5
DKI JAKARTA,JAKARTA PUSAT,KEMAYORAN,HARAPAN MULIA,3171031003,2020-10-28,583,34,549,3,1,2
DKI JAKARTA,JAKARTA PUSAT,KEMAYORAN,HARAPAN MULIA,3171031003,2020-10-29,585,27,559,2,-7,10
DKI JAKARTA,JAKARTA PUSAT,KEMAYORAN,HARAPAN MULIA,3171031003,2020-10-30,592,29,564,7,2,5
DKI JAKARTA,JAKARTA PUSAT,KEMAYORAN,HARAPAN MULIA,3171031003,2020-10-31,593,30,564,1,1,0
DKI JAKARTA,JAKARTA PUSAT,KEMAYORAN,KEBON KOSONG,3171031002,2020-10-01,377,33,344,0,0,0
DKI JAKARTA,JAKARTA PUSAT,KEMAYORAN,KEBON KOSONG,3171031002,2020-10-02,380,33,347,3,0,3
DKI JAKARTA,JAKARTA PUSAT,KEMAYORAN,KEBON KOSONG,3171031002,2020-10-03,389,41,348,9,8,1
DKI JAKARTA,JAKARTA PUSAT,KEMAYORAN,KEBON KOSONG,3171031002,2020-10-04,389,41,348,0,0,0
DKI JAKARTA,JAKARTA PUSAT,KEMAYORAN,KEBON KOSONG,3171031002,2020-10-05,391,39,352,2,-2,4
DKI JAKARTA,JAKARTA PUSAT,KEMAYORAN,KEBON KOSONG,3171031002,2020-10-06,392,36,356,1,-3,4
DKI JAKARTA,JAKARTA PUSAT,KEMAYORAN,KEBON KOSONG,3171031002,2020-10-07,395,29,366,3,-7,10
DKI JAKARTA,JAKARTA PUSAT,KEMAYORAN,KEBON KOSONG,3171031002,2020-10-08,406,35,371,11,6,5
DKI JAKARTA,JAKARTA PUSAT,KEMAYORAN,KEBON KOSONG,3171031002,2020-10-09,409,38,371,3,3,0
DKI JAKARTA,JAKARTA PUSAT,KEMAYORAN,KEBON KOSONG,3171031002,2020-10-10,415,37,378,6,-1,7
DKI JAKARTA,JAKARTA PUSAT,KEMAYORAN,KEBON KOSONG,3171031002,2020-10-11,429,50,379,14,13,1
DKI JAKARTA,JAKARTA PUSAT,KEMAYORAN,KEBON KOSONG,3171031002,2020-10-12,439,47,392,10,-3,13
DKI JAKARTA,JAKARTA PUSAT,KEMAYORAN,KEBON KOSONG,3171031002,2020-10-13,443,47,396,4,0,4
DKI JAKARTA,JAKARTA PUSAT,KEMAYORAN,KEBON KOSONG,3171031002,2020-10-14,455,57,398,12,10,2
DKI JAKARTA,JAKARTA PUSAT,KEMAYORAN,KEBON KOSONG,3171031002,2020-10-15,468,66,402,13,9,4
DKI JAKARTA,JAKARTA PUSAT,KEMAYORAN,KEBON KOSONG,3171031002,2020-10-16,472,67,405,4,1,3
DKI JAKARTA,JAKARTA PUSAT,KEMAYORAN,KEBON KOSONG,3171031002,2020-10-17,487,80,407,15,13,2
DKI JAKARTA,JAKARTA PUSAT,KEMAYORAN,KEBON KOSONG,3171031002,2020-10-18,494,86,408,7,6,1
DKI JAKARTA,JAKARTA PUSAT,KEMAYORAN,KEBON KOSONG,3171031002,2020-10-19,499,83,416,5,-3,8
DKI JAKARTA,JAKARTA PUSAT,KEMAYORAN,KEBON KOSONG,3171031002,2020-10-20,505,84,421,6,1,5
DKI JAKARTA,JAKARTA PUSAT,KEMAYORAN,KEBON KOSONG,3171031002,2020-10-21,505,78,427,0,-6,6
DKI JAKARTA,JAKARTA PUSAT,KEMAYORAN,KEBON KOSONG,3171031002,2020-10-22,512,66,446,7,-12,19
DKI JAKARTA,JAKARTA PUSAT,KEMAYORAN,KEBON KOSONG,3171031002,2020-10-23,514,68,446,2,2,0
DKI JAKARTA,JAKARTA PUSAT,KEMAYORAN,KEBON KOSONG,3171031002,2020-10-24,515,59,456,1,-9,10
DKI JAKARTA,JAKARTA PUSAT,KEMAYORAN,KEBON KOSONG,3171031002,2020-10-25,518,58,460,3,-1,4
DKI JAKARTA,JAKARTA PUSAT,KEMAYORAN,KEBON KOSONG,3171031002,2020-10-26,521,39,482,3,-19,22
DKI JAKARTA,JAKARTA PUSAT,KEMAYORAN,KEBON KOSONG,3171031002,2020-10-27,522,37,485,1,-2,3
DKI JAKARTA,JAKARTA PUSAT,KEMAYORAN,KEBON KOSONG,3171031002,2020-10-28,526,36,490,4,-1,5
DKI JAKARTA,JAKARTA PUSAT,KEMAYORAN,KEBON KOSONG,3171031002,2020-10-29,530,23,507,4,-13,17
DKI JAKARTA,JAKARTA PUSAT,KEMAYORAN,KEBON KOSONG,3171031002,2020-10-30,537,22,515,7,-1,8
DKI JAKARTA,JAKARTA PUSAT,KEMAYORAN,KEBON KOSONG,3171031002,2020-10-31,541,22,519,4,0,4
DKI JAKARTA,JAKARTA PUSAT,KEMAYORAN,KEMAYORAN,3171031001,2020-10-01,479,37,442,0,0,0
DKI JAKARTA,JAKARTA PUSAT,KEMAYORAN,KEMAYORAN,3171031001,2020-10-02,485,41,444,6,4,2
DKI JAKARTA,JAKARTA PUSAT,KEMAYORAN,KEMAYORAN,3171031001,2020-10-03,489,41,448,4,0,4
DKI JAKARTA,JAKARTA PUSAT,KEMAYORAN,KEMAYORAN,3171031001,2020-10-04,491,42,449,2,1,1
DKI JAKARTA,JAKARTA PUSAT,KEMAYORAN,KEMAYORAN,3171031001,2020-10-05,496,44,452,5,2,3
DKI JAKARTA,JAKARTA PUSAT,KEMAYORAN,KEMAYORAN,3171031001,2020-10-06,500,34,466,4,-10,14
DKI JAKARTA,JAKARTA PUSAT,KEMAYORAN,KEMAYORAN,3171031001,2020-10-07,507,32,475,7,-2,9
DKI JAKARTA,JAKARTA PUSAT,KEMAYORAN,KEMAYORAN,3171031001,2020-10-08,519,37,482,12,5,7
DKI JAKARTA,JAKARTA PUSAT,KEMAYORAN,KEMAYORAN,3171031001,2020-10-09,520,37,483,1,0,1
DKI JAKARTA,JAKARTA PUSAT,KEMAYORAN,KEMAYORAN,3171031001,2020-10-10,525,34,491,5,-3,8
DKI JAKARTA,JAKARTA PUSAT,KEMAYORAN,KEMAYORAN,3171031001,2020-10-11,528,36,492,3,2,1
DKI JAKARTA,JAKARTA PUSAT,KEMAYORAN,KEMAYORAN,3171031001,2020-10-12,535,40,495,7,4,3
DKI JAKARTA,JAKARTA PUSAT,KEMAYORAN,KEMAYORAN,3171031001,2020-10-13,540,38,502,5,-2,7
DKI JAKARTA,JAKARTA PUSAT,KEMAYORAN,KEMAYORAN,3171031001,2020-10-14,542,38,504,2,0,2
DKI JAKARTA,JAKARTA PUSAT,KEMAYORAN,KEMAYORAN,3171031001,2020-10-15,550,42,508,8,4,4
DKI JAKARTA,JAKARTA PUSAT,KEMAYORAN,KEMAYORAN,3171031001,2020-10-16,551,33,518,1,-9,10
DKI JAKARTA,JAKARTA PUSAT,KEMAYORAN,KEMAYORAN,3171031001,2020-10-17,563,43,520,12,10,2
DKI JAKARTA,JAKARTA PUSAT,KEMAYORAN,KEMAYORAN,3171031001,2020-10-18,568,47,521,5,4,1
DKI JAKARTA,JAKARTA PUSAT,KEMAYORAN,KEMAYORAN,3171031001,2020-10-19,569,43,526,1,-4,5
DKI JAKARTA,JAKARTA PUSAT,KEMAYORAN,KEMAYORAN,3171031001,2020-10-20,573,45,528,4,2,2
DKI JAKARTA,JAKARTA PUSAT,KEMAYORAN,KEMAYORAN,3171031001,2020-10-21,573,42,531,0,-3,3
DKI JAKARTA,JAKARTA PUSAT,KEMAYORAN,KEMAYORAN,3171031001,2020-10-22,576,41,535,3,-1,4
DKI JAKARTA,JAKARTA PUSAT,KEMAYORAN,KEMAYORAN,3171031001,2020-10-23,580,43,537,4,2,2
DKI JAKARTA,JAKARTA PUSAT,KEMAYORAN,KEMAYORAN,3171031001,2020-10-24,582,32,550,2,-11,13
DKI JAKARTA,JAKARTA PUSAT,KEMAYORAN,KEMAYORAN,3171031001,2020-10-25,584,32,552,2,0,2
DKI JAKARTA,JAKARTA PUSAT,KEMAYORAN,KEMAYORAN,3171031001,2020-10-26,589,31,558,5,-1,6
DKI JAKARTA,JAKARTA PUSAT,KEMAYORAN,KEMAYORAN,3171031001,2020-10-27,589,27,562,0,-4,4
DKI JAKARTA,JAKARTA PUSAT,KEMAYORAN,KEMAYORAN,3171031001,2020-10-28,593,23,570,4,-4,8
DKI JAKARTA,JAKARTA PUSAT,KEMAYORAN,KEMAYORAN,3171031001,2020-10-29,598,17,581,5,-6,11
DKI JAKARTA,JAKARTA PUSAT,KEMAYORAN,KEMAYORAN,3171031001,2020-10-30,609,24,585,11,7,4
DKI JAKARTA,JAKARTA PUSAT,KEMAYORAN,KEMAYORAN,3171031001,2020-10-31,611,23,588,2,-1,3
DKI JAKARTA,JAKARTA PUSAT,KEMAYORAN,SERDANG,3171031004,2020-10-01,546,68,478,0,0,0
DKI JAKARTA,JAKARTA PUSAT,KEMAYORAN,SERDANG,3171031004,2020-10-02,557,75,482,11,7,4
DKI JAKARTA,JAKARTA PUSAT,KEMAYORAN,SERDANG,3171031004,2020-10-03,574,88,486,17,13,4
DKI JAKARTA,JAKARTA PUSAT,KEMAYORAN,SERDANG,3171031004,2020-10-04,581,95,486,7,7,0
DKI JAKARTA,JAKARTA PUSAT,KEMAYORAN,SERDANG,3171031004,2020-10-05,590,97,493,9,2,7
DKI JAKARTA,JAKARTA PUSAT,KEMAYORAN,SERDANG,3171031004,2020-10-06,613,80,533,23,-17,40
DKI JAKARTA,JAKARTA PUSAT,KEMAYORAN,SERDANG,3171031004,2020-10-07,620,78,542,7,-2,9
DKI JAKARTA,JAKARTA PUSAT,KEMAYORAN,SERDANG,3171031004,2020-10-08,644,85,559,24,7,17
DKI JAKARTA,JAKARTA PUSAT,KEMAYORAN,SERDANG,3171031004,2020-10-09,648,89,559,4,4,0
DKI JAKARTA,JAKARTA PUSAT,KEMAYORAN,SERDANG,3171031004,2020-10-10,652,89,563,4,0,4
DKI JAKARTA,JAKARTA PUSAT,KEMAYORAN,SERDANG,3171031004,2020-10-11,667,99,568,15,10,5
DKI JAKARTA,JAKARTA PUSAT,KEMAYORAN,SERDANG,3171031004,2020-10-12,678,90,588,11,-9,20
DKI JAKARTA,JAKARTA PUSAT,KEMAYORAN,SERDANG,3171031004,2020-10-13,682,94,588,4,4,0
DKI JAKARTA,JAKARTA PUSAT,KEMAYORAN,SERDANG,3171031004,2020-10-14,691,80,611,9,-14,23
DKI JAKARTA,JAKARTA PUSAT,KEMAYORAN,SERDANG,3171031004,2020-10-15,706,88,618,15,8,7
DKI JAKARTA,JAKARTA PUSAT,KEMAYORAN,SERDANG,3171031004,2020-10-16,710,74,636,4,-14,18
DKI JAKARTA,JAKARTA PUSAT,KEMAYORAN,SERDANG,3171031004,2020-10-17,718,79,639,8,5,3
DKI JAKARTA,JAKARTA PUSAT,KEMAYORAN,SERDANG,3171031004,2020-10-18,725,85,640,7,6,1
DKI JAKARTA,JAKARTA PUSAT,KEMAYORAN,SERDANG,3171031004,2020-10-19,732,80,652,7,-5,12
DKI JAKARTA,JAKARTA PUSAT,KEMAYORAN,SERDANG,3171031004,2020-10-20,738,84,654,6,4,2
DKI JAKARTA,JAKARTA PUSAT,KEMAYORAN,SERDANG,3171031004,2020-10-21,750,93,657,12,9,3
DKI JAKARTA,JAKARTA PUSAT,KEMAYORAN,SERDANG,3171031004,2020-10-22,755,79,676,5,-14,19
DKI JAKARTA,JAKARTA PUSAT,KEMAYORAN,SERDANG,3171031004,2020-10-23,759,82,677,4,3,1
DKI JAKARTA,JAKARTA PUSAT,KEMAYORAN,SERDANG,3171031004,2020-10-24,767,78,689,8,-4,12
DKI JAKARTA,JAKARTA PUSAT,KEMAYORAN,SERDANG,3171031004,2020-10-25,770,81,689,3,3,0
DKI JAKARTA,JAKARTA PUSAT,KEMAYORAN,SERDANG,3171031004,2020-10-26,771,65,706,1,-16,17
DKI JAKARTA,JAKARTA PUSAT,KEMAYORAN,SERDANG,3171031004,2020-10-27,776,64,712,5,-1,6
DKI JAKARTA,JAKARTA PUSAT,KEMAYORAN,SERDANG,3171031004,2020-10-28,780,54,726,4,-10,14
DKI JAKARTA,JAKARTA PUSAT,KEMAYORAN,SERDANG,3171031004,2020-10-29,786,50,736,6,-4,10
DKI JAKARTA,JAKARTA PUSAT,KEMAYORAN,SERDANG,3171031004,2020-10-30,799,50,749,13,0,13
DKI JAKARTA,JAKARTA PUSAT,KEMAYORAN,SERDANG,3171031004,2020-10-31,801,51,750,2,1,1
DKI JAKARTA,JAKARTA PUSAT,KEMAYORAN,SUMUR BATU,3171031007,2020-10-01,441,45,396,0,0,0
DKI JAKARTA,JAKARTA PUSAT,KEMAYORAN,SUMUR BATU,3171031007,2020-10-02,449,47,402,8,2,6
DKI JAKARTA,JAKARTA PUSAT,KEMAYORAN,SUMUR BATU,3171031007,2020-10-03,459,56,403,10,9,1
DKI JAKARTA,JAKARTA PUSAT,KEMAYORAN,SUMUR BATU,3171031007,2020-10-04,465,60,405,6,4,2
DKI JAKARTA,JAKARTA PUSAT,KEMAYORAN,SUMUR BATU,3171031007,2020-10-05,467,50,417,2,-10,12
DKI JAKARTA,JAKARTA PUSAT,KEMAYORAN,SUMUR BATU,3171031007,2020-10-06,480,51,429,13,1,12
DKI JAKARTA,JAKARTA PUSAT,KEMAYORAN,SUMUR BATU,3171031007,2020-10-07,485,49,436,5,-2,7
DKI JAKARTA,JAKARTA PUSAT,KEMAYORAN,SUMUR BATU,3171031007,2020-10-08,500,57,443,15,8,7
DKI JAKARTA,JAKARTA PUSAT,KEMAYORAN,SUMUR BATU,3171031007,2020-10-09,502,57,445,2,0,2
DKI JAKARTA,JAKARTA PUSAT,KEMAYORAN,SUMUR BATU,3171031007,2020-10-10,505,50,455,3,-7,10
DKI JAKARTA,JAKARTA PUSAT,KEMAYORAN,SUMUR BATU,3171031007,2020-10-11,516,61,455,11,11,0
DKI JAKARTA,JAKARTA PUSAT,KEMAYORAN,SUMUR BATU,3171031007,2020-10-12,522,56,466,6,-5,11
DKI JAKARTA,JAKARTA PUSAT,KEMAYORAN,SUMUR BATU,3171031007,2020-10-13,523,55,468,1,-1,2
DKI JAKARTA,JAKARTA PUSAT,KEMAYORAN,SUMUR BATU,3171031007,2020-10-14,529,50,479,6,-5,11
DKI JAKARTA,JAKARTA PUSAT,KEMAYORAN,SUMUR BATU,3171031007,2020-10-15,537,52,485,8,2,6
DKI JAKARTA,JAKARTA PUSAT,KEMAYORAN,SUMUR BATU,3171031007,2020-10-16,541,44,497,4,-8,12
DKI JAKARTA,JAKARTA PUSAT,KEMAYORAN,SUMUR BATU,3171031007,2020-10-17,552,51,501,11,7,4
DKI JAKARTA,JAKARTA PUSAT,KEMAYORAN,SUMUR BATU,3171031007,2020-10-18,558,57,501,6,6,0
DKI JAKARTA,JAKARTA PUSAT,KEMAYORAN,SUMUR BATU,3171031007,2020-10-19,561,53,508,3,-4,7
DKI JAKARTA,JAKARTA PUSAT,KEMAYORAN,SUMUR BATU,3171031007,2020-10-20,564,52,512,3,-1,4
DKI JAKARTA,JAKARTA PUSAT,KEMAYORAN,SUMUR BATU,3171031007,2020-10-21,564,48,516,0,-4,4
DKI JAKARTA,JAKARTA PUSAT,KEMAYORAN,SUMUR BATU,3171031007,2020-10-22,566,41,525,2,-7,9
DKI JAKARTA,JAKARTA PUSAT,KEMAYORAN,SUMUR BATU,3171031007,2020-10-23,567,42,525,1,1,0
DKI JAKARTA,JAKARTA PUSAT,KEMAYORAN,SUMUR BATU,3171031007,2020-10-24,570,38,532,3,-4,7
DKI JAKARTA,JAKARTA PUSAT,KEMAYORAN,SUMUR BATU,3171031007,2020-10-25,571,39,532,1,1,0
DKI JAKARTA,JAKARTA PUSAT,KEMAYORAN,SUMUR BATU,3171031007,2020-10-26,577,35,542,6,-4,10
DKI JAKARTA,JAKARTA PUSAT,KEMAYORAN,SUMUR BATU,3171031007,2020-10-27,580,32,548,3,-3,6
DKI JAKARTA,JAKARTA PUSAT,KEMAYORAN,SUMUR BATU,3171031007,2020-10-28,584,27,557,4,-5,9
DKI JAKARTA,JAKARTA PUSAT,KEMAYORAN,SUMUR BATU,3171031007,2020-10-29,587,20,567,3,-7,10
DKI JAKARTA,JAKARTA PUSAT,KEMAYORAN,SUMUR BATU,3171031007,2020-10-30,602,33,569,15,13,2
DKI JAKARTA,JAKARTA PUSAT,KEMAYORAN,SUMUR BATU,3171031007,2020-10-31,604,33,571,2,0,2
DKI JAKARTA,JAKARTA PUSAT,KEMAYORAN,UTAN PANJANG,3171031008,2020-10-01,379,43,336,0,0,0
DKI JAKARTA,JAKARTA PUSAT,KEMAYORAN,UTAN PANJANG,3171031008,2020-10-02,391,55,336,12,12,0
DKI JAKARTA,JAKARTA PUSAT,KEMAYORAN,UTAN PANJANG,3171031008,2020-10-03,405,69,336,14,14,0
DKI JAKARTA,JAKARTA PUSAT,KEMAYORAN,UTAN PANJANG,3171031008,2020-10-04,407,71,336,2,2,0
DKI JAKARTA,JAKARTA PUSAT,KEMAYORAN,UTAN PANJANG,3171031008,2020-10-05,414,73,341,7,2,5
DKI JAKARTA,JAKARTA PUSAT,KEMAYORAN,UTAN PANJANG,3171031008,2020-10-06,436,76,360,22,3,19
DKI JAKARTA,JAKARTA PUSAT,KEMAYORAN,UTAN PANJANG,3171031008,2020-10-07,452,90,362,16,14,2
DKI JAKARTA,JAKARTA PUSAT,KEMAYORAN,UTAN PANJANG,3171031008,2020-10-08,473,109,364,21,19,2
DKI JAKARTA,JAKARTA PUSAT,KEMAYORAN,UTAN PANJANG,3171031008,2020-10-09,477,113,364,4,4,0
DKI JAKARTA,JAKARTA PUSAT,KEMAYORAN,UTAN PANJANG,3171031008,2020-10-10,495,125,370,18,12,6
DKI JAKARTA,JAKARTA PUSAT,KEMAYORAN,UTAN PANJANG,3171031008,2020-10-11,515,140,375,20,15,5
DKI JAKARTA,JAKARTA PUSAT,KEMAYORAN,UTAN PANJANG,3171031008,2020-10-12,520,106,414,5,-34,39
DKI JAKARTA,JAKARTA PUSAT,KEMAYORAN,UTAN PANJANG,3171031008,2020-10-13,521,100,421,1,-6,7
DKI JAKARTA,JAKARTA PUSAT,KEMAYORAN,UTAN PANJANG,3171031008,2020-10-14,524,96,428,3,-4,7
DKI JAKARTA,JAKARTA PUSAT,KEMAYORAN,UTAN PANJANG,3171031008,2020-10-15,542,107,435,18,11,7
DKI JAKARTA,JAKARTA PUSAT,KEMAYORAN,UTAN PANJANG,3171031008,2020-10-16,554,98,456,12,-9,21
DKI JAKARTA,JAKARTA PUSAT,KEMAYORAN,UTAN PANJANG,3171031008,2020-10-17,559,99,460,5,1,4
DKI JAKARTA,JAKARTA PUSAT,KEMAYORAN,UTAN PANJANG,3171031008,2020-10-18,563,100,463,4,1,3
DKI JAKARTA,JAKARTA PUSAT,KEMAYORAN,UTAN PANJANG,3171031008,2020-10-19,567,96,471,4,-4,8
DKI JAKARTA,JAKARTA PUSAT,KEMAYORAN,UTAN PANJANG,3171031008,2020-10-20,572,86,486,5,-10,15
DKI JAKARTA,JAKARTA PUSAT,KEMAYORAN,UTAN PANJANG,3171031008,2020-10-21,596,76,520,24,-10,34
DKI JAKARTA,JAKARTA PUSAT,KEMAYORAN,UTAN PANJANG,3171031008,2020-10-22,608,83,525,12,7,5
DKI JAKARTA,JAKARTA PUSAT,KEMAYORAN,UTAN PANJANG,3171031008,2020-10-23,609,84,525,1,1,0
DKI JAKARTA,JAKARTA PUSAT,KEMAYORAN,UTAN PANJANG,3171031008,2020-10-24,613,80,533,4,-4,8
DKI JAKARTA,JAKARTA PUSAT,KEMAYORAN,UTAN PANJANG,3171031008,2020-10-25,614,80,534,1,0,1
DKI JAKARTA,JAKARTA PUSAT,KEMAYORAN,UTAN PANJANG,3171031008,2020-10-26,616,79,537,2,-1,3
DKI JAKARTA,JAKARTA PUSAT,KEMAYORAN,UTAN PANJANG,3171031008,2020-10-27,621,55,566,5,-24,29
DKI JAKARTA,JAKARTA PUSAT,KEMAYORAN,UTAN PANJANG,3171031008,2020-10-28,625,55,570,4,0,4
DKI JAKARTA,JAKARTA PUSAT,KEMAYORAN,UTAN PANJANG,3171031008,2020-10-29,626,55,571,1,0,1
DKI JAKARTA,JAKARTA PUSAT,KEMAYORAN,UTAN PANJANG,3171031008,2020-10-30,639,59,580,13,4,9
DKI JAKARTA,JAKARTA PUSAT,KEMAYORAN,UTAN PANJANG,3171031008,2020-10-31,643,61,582,4,2,2
DKI JAKARTA,JAKARTA PUSAT,MENTENG,CIKINI,3171061003,2020-10-01,171,8,163,0,0,0
DKI JAKARTA,JAKARTA PUSAT,MENTENG,CIKINI,3171061003,2020-10-02,173,8,165,2,0,2
DKI JAKARTA,JAKARTA PUSAT,MENTENG,CIKINI,3171061003,2020-10-03,177,10,167,4,2,2
DKI JAKARTA,JAKARTA PUSAT,MENTENG,CIKINI,3171061003,2020-10-04,177,10,167,0,0,0
DKI JAKARTA,JAKARTA PUSAT,MENTENG,CIKINI,3171061003,2020-10-05,177,8,169,0,-2,2
DKI JAKARTA,JAKARTA PUSAT,MENTENG,CIKINI,3171061003,2020-10-06,179,10,169,2,2,0
DKI JAKARTA,JAKARTA PUSAT,MENTENG,CIKINI,3171061003,2020-10-07,180,9,171,1,-1,2
DKI JAKARTA,JAKARTA PUSAT,MENTENG,CIKINI,3171061003,2020-10-08,184,8,176,4,-1,5
DKI JAKARTA,JAKARTA PUSAT,MENTENG,CIKINI,3171061003,2020-10-09,185,9,176,1,1,0
DKI JAKARTA,JAKARTA PUSAT,MENTENG,CIKINI,3171061003,2020-10-10,187,10,177,2,1,1
DKI JAKARTA,JAKARTA PUSAT,MENTENG,CIKINI,3171061003,2020-10-11,189,12,177,2,2,0
DKI JAKARTA,JAKARTA PUSAT,MENTENG,CIKINI,3171061003,2020-10-12,189,10,179,0,-2,2
DKI JAKARTA,JAKARTA PUSAT,MENTENG,CIKINI,3171061003,2020-10-13,190,11,179,1,1,0
DKI JAKARTA,JAKARTA PUSAT,MENTENG,CIKINI,3171061003,2020-10-14,191,10,181,1,-1,2
DKI JAKARTA,JAKARTA PUSAT,MENTENG,CIKINI,3171061003,2020-10-15,195,14,181,4,4,0
DKI JAKARTA,JAKARTA PUSAT,MENTENG,CIKINI,3171061003,2020-10-16,198,14,184,3,0,3
DKI JAKARTA,JAKARTA PUSAT,MENTENG,CIKINI,3171061003,2020-10-17,201,16,185,3,2,1
DKI JAKARTA,JAKARTA PUSAT,MENTENG,CIKINI,3171061003,2020-10-18,203,16,187,2,0,2
DKI JAKARTA,JAKARTA PUSAT,MENTENG,CIKINI,3171061003,2020-10-19,203,16,187,0,0,0
DKI JAKARTA,JAKARTA PUSAT,MENTENG,CIKINI,3171061003,2020-10-20,203,15,188,0,-1,1
DKI JAKARTA,JAKARTA PUSAT,MENTENG,CIKINI,3171061003,2020-10-21,203,15,188,0,0,0
DKI JAKARTA,JAKARTA PUSAT,MENTENG,CIKINI,3171061003,2020-10-22,203,12,191,0,-3,3
DKI JAKARTA,JAKARTA PUSAT,MENTENG,CIKINI,3171061003,2020-10-23,206,14,192,3,2,1
DKI JAKARTA,JAKARTA PUSAT,MENTENG,CIKINI,3171061003,2020-10-24,207,12,195,1,-2,3
DKI JAKARTA,JAKARTA PUSAT,MENTENG,CIKINI,3171061003,2020-10-25,207,12,195,0,0,0
DKI JAKARTA,JAKARTA PUSAT,MENTENG,CIKINI,3171061003,2020-10-26,210,9,201,3,-3,6
DKI JAKARTA,JAKARTA PUSAT,MENTENG,CIKINI,3171061003,2020-10-27,212,10,202,2,1,1
DKI JAKARTA,JAKARTA PUSAT,MENTENG,CIKINI,3171061003,2020-10-28,212,6,206,0,-4,4
DKI JAKARTA,JAKARTA PUSAT,MENTENG,CIKINI,3171061003,2020-10-29,213,5,208,1,-1,2
DKI JAKARTA,JAKARTA PUSAT,MENTENG,CIKINI,3171061003,2020-10-30,218,9,209,5,4,1
DKI JAKARTA,JAKARTA PUSAT,MENTENG,CIKINI,3171061003,2020-10-31,221,10,211,3,1,2
DKI JAKARTA,JAKARTA PUSAT,MENTENG,GONDANGDIA,3171061004,2020-10-01,107,3,104,0,0,0
DKI JAKARTA,JAKARTA PUSAT,MENTENG,GONDANGDIA,3171061004,2020-10-02,111,5,106,4,2,2
DKI JAKARTA,JAKARTA PUSAT,MENTENG,GONDANGDIA,3171061004,2020-10-03,114,7,107,3,2,1
DKI JAKARTA,JAKARTA PUSAT,MENTENG,GONDANGDIA,3171061004,2020-10-04,116,7,109,2,0,2
DKI JAKARTA,JAKARTA PUSAT,MENTENG,GONDANGDIA,3171061004,2020-10-05,117,7,110,1,0,1
DKI JAKARTA,JAKARTA PUSAT,MENTENG,GONDANGDIA,3171061004,2020-10-06,117,7,110,0,0,0
DKI JAKARTA,JAKARTA PUSAT,MENTENG,GONDANGDIA,3171061004,2020-10-07,119,8,111,2,1,1
DKI JAKARTA,JAKARTA PUSAT,MENTENG,GONDANGDIA,3171061004,2020-10-08,121,10,111,2,2,0
DKI JAKARTA,JAKARTA PUSAT,MENTENG,GONDANGDIA,3171061004,2020-10-09,125,14,111,4,4,0
DKI JAKARTA,JAKARTA PUSAT,MENTENG,GONDANGDIA,3171061004,2020-10-10,126,10,116,1,-4,5
DKI JAKARTA,JAKARTA PUSAT,MENTENG,GONDANGDIA,3171061004,2020-10-11,126,10,116,0,0,0
DKI JAKARTA,JAKARTA PUSAT,MENTENG,GONDANGDIA,3171061004,2020-10-12,127,10,117,1,0,1
DKI JAKARTA,JAKARTA PUSAT,MENTENG,GONDANGDIA,3171061004,2020-10-13,129,11,118,2,1,1
DKI JAKARTA,JAKARTA PUSAT,MENTENG,GONDANGDIA,3171061004,2020-10-14,129,10,119,0,-1,1
DKI JAKARTA,JAKARTA PUSAT,MENTENG,GONDANGDIA,3171061004,2020-10-15,129,6,123,0,-4,4
DKI JAKARTA,JAKARTA PUSAT,MENTENG,GONDANGDIA,3171061004,2020-10-16,129,4,125,0,-2,2
DKI JAKARTA,JAKARTA PUSAT,MENTENG,GONDANGDIA,3171061004,2020-10-17,132,7,125,3,3,0
DKI JAKARTA,JAKARTA PUSAT,MENTENG,GONDANGDIA,3171061004,2020-10-18,132,6,126,0,-1,1
DKI JAKARTA,JAKARTA PUSAT,MENTENG,GONDANGDIA,3171061004,2020-10-19,132,4,128,0,-2,2
DKI JAKARTA,JAKARTA PUSAT,MENTENG,GONDANGDIA,3171061004,2020-10-20,135,5,130,3,1,2
DKI JAKARTA,JAKARTA PUSAT,MENTENG,GONDANGDIA,3171061004,2020-10-21,135,5,130,0,0,0
DKI JAKARTA,JAKARTA PUSAT,MENTENG,GONDANGDIA,3171061004,2020-10-22,135,5,130,0,0,0
DKI JAKARTA,JAKARTA PUSAT,MENTENG,GONDANGDIA,3171061004,2020-10-23,136,5,131,1,0,1
DKI JAKARTA,JAKARTA PUSAT,MENTENG,GONDANGDIA,3171061004,2020-10-24,137,6,131,1,1,0
DKI JAKARTA,JAKARTA PUSAT,MENTENG,GONDANGDIA,3171061004,2020-10-25,139,5,134,2,-1,3
DKI JAKARTA,JAKARTA PUSAT,MENTENG,GONDANGDIA,3171061004,2020-10-26,142,8,134,3,3,0
DKI JAKARTA,JAKARTA PUSAT,MENTENG,GONDANGDIA,3171061004,2020-10-27,145,10,135,3,2,1
DKI JAKARTA,JAKARTA PUSAT,MENTENG,GONDANGDIA,3171061004,2020-10-28,145,10,135,0,0,0
DKI JAKARTA,JAKARTA PUSAT,MENTENG,GONDANGDIA,3171061004,2020-10-29,146,7,139,1,-3,4
DKI JAKARTA,JAKARTA PUSAT,MENTENG,GONDANGDIA,3171061004,2020-10-30,149,9,140,3,2,1
DKI JAKARTA,JAKARTA PUSAT,MENTENG,GONDANGDIA,3171061004,2020-10-31,149,8,141,0,-1,1
DKI JAKARTA,JAKARTA PUSAT,MENTENG,KEBON SIRIH,3171061005,2020-10-01,269,9,260,0,0,0
DKI JAKARTA,JAKARTA PUSAT,MENTENG,KEBON SIRIH,3171061005,2020-10-02,271,11,260,2,2,0
DKI JAKARTA,JAKARTA PUSAT,MENTENG,KEBON SIRIH,3171061005,2020-10-03,272,12,260,1,1,0
DKI JAKARTA,JAKARTA PUSAT,MENTENG,KEBON SIRIH,3171061005,2020-10-04,272,12,260,0,0,0
DKI JAKARTA,JAKARTA PUSAT,MENTENG,KEBON SIRIH,3171061005,2020-10-05,274,12,262,2,0,2
DKI JAKARTA,JAKARTA PUSAT,MENTENG,KEBON SIRIH,3171061005,2020-10-06,276,13,263,2,1,1
DKI JAKARTA,JAKARTA PUSAT,MENTENG,KEBON SIRIH,3171061005,2020-10-07,276,13,263,0,0,0
DKI JAKARTA,JAKARTA PUSAT,MENTENG,KEBON SIRIH,3171061005,2020-10-08,280,17,263,4,4,0
DKI JAKARTA,JAKARTA PUSAT,MENTENG,KEBON SIRIH,3171061005,2020-10-09,282,19,263,2,2,0
DKI JAKARTA,JAKARTA PUSAT,MENTENG,KEBON SIRIH,3171061005,2020-10-10,287,21,266,5,2,3
DKI JAKARTA,JAKARTA PUSAT,MENTENG,KEBON SIRIH,3171061005,2020-10-11,289,21,268,2,0,2
DKI JAKARTA,JAKARTA PUSAT,MENTENG,KEBON SIRIH,3171061005,2020-10-12,290,21,269,1,0,1
DKI JAKARTA,JAKARTA PUSAT,MENTENG,KEBON SIRIH,3171061005,2020-10-13,291,20,271,1,-1,2
DKI JAKARTA,JAKARTA PUSAT,MENTENG,KEBON SIRIH,3171061005,2020-10-14,292,19,273,1,-1,2
DKI JAKARTA,JAKARTA PUSAT,MENTENG,KEBON SIRIH,3171061005,2020-10-15,297,23,274,5,4,1
DKI JAKARTA,JAKARTA PUSAT,MENTENG,KEBON SIRIH,3171061005,2020-10-16,298,22,276,1,-1,2
DKI JAKARTA,JAKARTA PUSAT,MENTENG,KEBON SIRIH,3171061005,2020-10-17,301,25,276,3,3,0
DKI JAKARTA,JAKARTA PUSAT,MENTENG,KEBON SIRIH,3171061005,2020-10-18,301,23,278,0,-2,2
DKI JAKARTA,JAKARTA PUSAT,MENTENG,KEBON SIRIH,3171061005,2020-10-19,303,22,281,2,-1,3
DKI JAKARTA,JAKARTA PUSAT,MENTENG,KEBON SIRIH,3171061005,2020-10-20,305,21,284,2,-1,3
DKI JAKARTA,JAKARTA PUSAT,MENTENG,KEBON SIRIH,3171061005,2020-10-21,308,16,292,3,-5,8
DKI JAKARTA,JAKARTA PUSAT,MENTENG,KEBON SIRIH,3171061005,2020-10-22,308,15,293,0,-1,1
DKI JAKARTA,JAKARTA PUSAT,MENTENG,KEBON SIRIH,3171061005,2020-10-23,308,15,293,0,0,0
DKI JAKARTA,JAKARTA PUSAT,MENTENG,KEBON SIRIH,3171061005,2020-10-24,310,17,293,2,2,0
DKI JAKARTA,JAKARTA PUSAT,MENTENG,KEBON SIRIH,3171061005,2020-10-25,314,21,293,4,4,0
DKI JAKARTA,JAKARTA PUSAT,MENTENG,KEBON SIRIH,3171061005,2020-10-26,316,19,297,2,-2,4
DKI JAKARTA,JAKARTA PUSAT,MENTENG,KEBON SIRIH,3171061005,2020-10-27,317,18,299,1,-1,2
DKI JAKARTA,JAKARTA PUSAT,MENTENG,KEBON SIRIH,3171061005,2020-10-28,318,16,302,1,-2,3
DKI JAKARTA,JAKARTA PUSAT,MENTENG,KEBON SIRIH,3171061005,2020-10-29,322,15,307,4,-1,5
DKI JAKARTA,JAKARTA PUSAT,MENTENG,KEBON SIRIH,3171061005,2020-10-30,322,13,309,0,-2,2
DKI JAKARTA,JAKARTA PUSAT,MENTENG,KEBON SIRIH,3171061005,2020-10-31,323,14,309,1,1,0
DKI JAKARTA,JAKARTA PUSAT,MENTENG,MENTENG,3171061001,2020-10-01,633,34,599,0,0,0
DKI JAKARTA,JAKARTA PUSAT,MENTENG,MENTENG,3171061001,2020-10-02,643,41,602,10,7,3
DKI JAKARTA,JAKARTA PUSAT,MENTENG,MENTENG,3171061001,2020-10-03,653,48,605,10,7,3
DKI JAKARTA,JAKARTA PUSAT,MENTENG,MENTENG,3171061001,2020-10-04,659,54,605,6,6,0
DKI JAKARTA,JAKARTA PUSAT,MENTENG,MENTENG,3171061001,2020-10-05,660,50,610,1,-4,5
DKI JAKARTA,JAKARTA PUSAT,MENTENG,MENTENG,3171061001,2020-10-06,668,52,616,8,2,6
DKI JAKARTA,JAKARTA PUSAT,MENTENG,MENTENG,3171061001,2020-10-07,675,55,620,7,3,4
DKI JAKARTA,JAKARTA PUSAT,MENTENG,MENTENG,3171061001,2020-10-08,680,55,625,5,0,5
DKI JAKARTA,JAKARTA PUSAT,MENTENG,MENTENG,3171061001,2020-10-09,685,59,626,5,4,1
DKI JAKARTA,JAKARTA PUSAT,MENTENG,MENTENG,3171061001,2020-10-10,693,60,633,8,1,7
DKI JAKARTA,JAKARTA PUSAT,MENTENG,MENTENG,3171061001,2020-10-11,698,64,634,5,4,1
DKI JAKARTA,JAKARTA PUSAT,MENTENG,MENTENG,3171061001,2020-10-12,701,59,642,3,-5,8
DKI JAKARTA,JAKARTA PUSAT,MENTENG,MENTENG,3171061001,2020-10-13,705,56,649,4,-3,7
DKI JAKARTA,JAKARTA PUSAT,MENTENG,MENTENG,3171061001,2020-10-14,708,41,667,3,-15,18
DKI JAKARTA,JAKARTA PUSAT,MENTENG,MENTENG,3171061001,2020-10-15,716,41,675,8,0,8
DKI JAKARTA,JAKARTA PUSAT,MENTENG,MENTENG,3171061001,2020-10-16,722,38,684,6,-3,9
DKI JAKARTA,JAKARTA PUSAT,MENTENG,MENTENG,3171061001,2020-10-17,731,46,685,9,8,1
DKI JAKARTA,JAKARTA PUSAT,MENTENG,MENTENG,3171061001,2020-10-18,740,51,689,9,5,4
DKI JAKARTA,JAKARTA PUSAT,MENTENG,MENTENG,3171061001,2020-10-19,741,42,699,1,-9,10
DKI JAKARTA,JAKARTA PUSAT,MENTENG,MENTENG,3171061001,2020-10-20,752,46,706,11,4,7
DKI JAKARTA,JAKARTA PUSAT,MENTENG,MENTENG,3171061001,2020-10-21,753,41,712,1,-5,6
DKI JAKARTA,JAKARTA PUSAT,MENTENG,MENTENG,3171061001,2020-10-22,760,42,718,7,1,6
DKI JAKARTA,JAKARTA PUSAT,MENTENG,MENTENG,3171061001,2020-10-23,770,44,726,10,2,8
DKI JAKARTA,JAKARTA PUSAT,MENTENG,MENTENG,3171061001,2020-10-24,779,41,738,9,-3,12
DKI JAKARTA,JAKARTA PUSAT,MENTENG,MENTENG,3171061001,2020-10-25,787,41,746,8,0,8
DKI JAKARTA,JAKARTA PUSAT,MENTENG,MENTENG,3171061001,2020-10-26,790,33,757,3,-8,11
DKI JAKARTA,JAKARTA PUSAT,MENTENG,MENTENG,3171061001,2020-10-27,795,35,760,5,2,3
DKI JAKARTA,JAKARTA PUSAT,MENTENG,MENTENG,3171061001,2020-10-28,801,30,771,6,-5,11
DKI JAKARTA,JAKARTA PUSAT,MENTENG,MENTENG,3171061001,2020-10-29,805,26,779,4,-4,8
DKI JAKARTA,JAKARTA PUSAT,MENTENG,MENTENG,3171061001,2020-10-30,818,31,787,13,5,8
DKI JAKARTA,JAKARTA PUSAT,MENTENG,MENTENG,3171061001,2020-10-31,826,33,793,8,2,6
DKI JAKARTA,JAKARTA PUSAT,MENTENG,PEGANGSAAN,3171061002,2020-10-01,800,57,743,0,0,0
DKI JAKARTA,JAKARTA PUSAT,MENTENG,PEGANGSAAN,3171061002,2020-10-02,806,56,750,6,-1,7
DKI JAKARTA,JAKARTA PUSAT,MENTENG,PEGANGSAAN,3171061002,2020-10-03,813,51,762,7,-5,12
DKI JAKARTA,JAKARTA PUSAT,MENTENG,PEGANGSAAN,3171061002,2020-10-04,819,54,765,6,3,3
DKI JAKARTA,JAKARTA PUSAT,MENTENG,PEGANGSAAN,3171061002,2020-10-05,820,43,777,1,-11,12
DKI JAKARTA,JAKARTA PUSAT,MENTENG,PEGANGSAAN,3171061002,2020-10-06,823,41,782,3,-2,5
DKI JAKARTA,JAKARTA PUSAT,MENTENG,PEGANGSAAN,3171061002,2020-10-07,826,35,791,3,-6,9
DKI JAKARTA,JAKARTA PUSAT,MENTENG,PEGANGSAAN,3171061002,2020-10-08,831,37,794,5,2,3
DKI JAKARTA,JAKARTA PUSAT,MENTENG,PEGANGSAAN,3171061002,2020-10-09,832,38,794,1,1,0
DKI JAKARTA,JAKARTA PUSAT,MENTENG,PEGANGSAAN,3171061002,2020-10-10,838,39,799,6,1,5
DKI JAKARTA,JAKARTA PUSAT,MENTENG,PEGANGSAAN,3171061002,2020-10-11,839,39,800,1,0,1
DKI JAKARTA,JAKARTA PUSAT,MENTENG,PEGANGSAAN,3171061002,2020-10-12,841,29,812,2,-10,12
DKI JAKARTA,JAKARTA PUSAT,MENTENG,PEGANGSAAN,3171061002,2020-10-13,847,28,819,6,-1,7
DKI JAKARTA,JAKARTA PUSAT,MENTENG,PEGANGSAAN,3171061002,2020-10-14,848,20,828,1,-8,9
DKI JAKARTA,JAKARTA PUSAT,MENTENG,PEGANGSAAN,3171061002,2020-10-15,855,21,834,7,1,6
DKI JAKARTA,JAKARTA PUSAT,MENTENG,PEGANGSAAN,3171061002,2020-10-16,859,24,835,4,3,1
DKI JAKARTA,JAKARTA PUSAT,MENTENG,PEGANGSAAN,3171061002,2020-10-17,861,26,835,2,2,0
DKI JAKARTA,JAKARTA PUSAT,MENTENG,PEGANGSAAN,3171061002,2020-10-18,864,28,836,3,2,1
DKI JAKARTA,JAKARTA PUSAT,MENTENG,PEGANGSAAN,3171061002,2020-10-19,867,26,841,3,-2,5
DKI JAKARTA,JAKARTA PUSAT,MENTENG,PEGANGSAAN,3171061002,2020-10-20,873,24,849,6,-2,8
DKI JAKARTA,JAKARTA PUSAT,MENTENG,PEGANGSAAN,3171061002,2020-10-21,879,28,851,6,4,2
DKI JAKARTA,JAKARTA PUSAT,MENTENG,PEGANGSAAN,3171061002,2020-10-22,883,28,855,4,0,4
DKI JAKARTA,JAKARTA PUSAT,MENTENG,PEGANGSAAN,3171061002,2020-10-23,885,29,856,2,1,1
DKI JAKARTA,JAKARTA PUSAT,MENTENG,PEGANGSAAN,3171061002,2020-10-24,888,25,863,3,-4,7
DKI JAKARTA,JAKARTA PUSAT,MENTENG,PEGANGSAAN,3171061002,2020-10-25,895,30,865,7,5,2
DKI JAKARTA,JAKARTA PUSAT,MENTENG,PEGANGSAAN,3171061002,2020-10-26,896,26,870,1,-4,5
DKI JAKARTA,JAKARTA PUSAT,MENTENG,PEGANGSAAN,3171061002,2020-10-27,897,27,870,1,1,0
DKI JAKARTA,JAKARTA PUSAT,MENTENG,PEGANGSAAN,3171061002,2020-10-28,902,27,875,5,0,5
DKI JAKARTA,JAKARTA PUSAT,MENTENG,PEGANGSAAN,3171061002,2020-10-29,905,25,880,3,-2,5
DKI JAKARTA,JAKARTA PUSAT,MENTENG,PEGANGSAAN,3171061002,2020-10-30,908,25,883,3,0,3
DKI JAKARTA,JAKARTA PUSAT,MENTENG,PEGANGSAAN,3171061002,2020-10-31,916,31,885,8,6,2
DKI JAKARTA,JAKARTA PUSAT,SAWAH BESAR,GUNUNG SAHARI UTARA,3171021004,2020-10-01,450,34,416,0,0,0
DKI JAKARTA,JAKARTA PUSAT,SAWAH BESAR,GUNUNG SAHARI UTARA,3171021004,2020-10-02,460,31,429,10,-3,13
DKI JAKARTA,JAKARTA PUSAT,SAWAH BESAR,GUNUNG SAHARI UTARA,3171021004,2020-10-03,459,31,428,-1,0,-1
DKI JAKARTA,JAKARTA PUSAT,SAWAH BESAR,GUNUNG SAHARI UTARA,3171021004,2020-10-04,462,33,429,3,2,1
DKI JAKARTA,JAKARTA PUSAT,SAWAH BESAR,GUNUNG SAHARI UTARA,3171021004,2020-10-05,462,30,432,0,-3,3
DKI JAKARTA,JAKARTA PUSAT,SAWAH BESAR,GUNUNG SAHARI UTARA,3171021004,2020-10-06,467,29,438,5,-1,6
DKI JAKARTA,JAKARTA PUSAT,SAWAH BESAR,GUNUNG SAHARI UTARA,3171021004,2020-10-07,467,21,446,0,-8,8
DKI JAKARTA,JAKARTA PUSAT,SAWAH BESAR,GUNUNG SAHARI UTARA,3171021004,2020-10-08,481,35,446,14,14,0
DKI JAKARTA,JAKARTA PUSAT,SAWAH BESAR,GUNUNG SAHARI UTARA,3171021004,2020-10-09,487,40,447,6,5,1
DKI JAKARTA,JAKARTA PUSAT,SAWAH BESAR,GUNUNG SAHARI UTARA,3171021004,2020-10-10,490,41,449,3,1,2
DKI JAKARTA,JAKARTA PUSAT,SAWAH BESAR,GUNUNG SAHARI UTARA,3171021004,2020-10-11,496,46,450,6,5,1
DKI JAKARTA,JAKARTA PUSAT,SAWAH BESAR,GUNUNG SAHARI UTARA,3171021004,2020-10-12,500,39,461,4,-7,11
DKI JAKARTA,JAKARTA PUSAT,SAWAH BESAR,GUNUNG SAHARI UTARA,3171021004,2020-10-13,501,32,469,1,-7,8
DKI JAKARTA,JAKARTA PUSAT,SAWAH BESAR,GUNUNG SAHARI UTARA,3171021004,2020-10-14,501,31,470,0,-1,1
DKI JAKARTA,JAKARTA PUSAT,SAWAH BESAR,GUNUNG SAHARI UTARA,3171021004,2020-10-15,519,46,473,18,15,3
DKI JAKARTA,JAKARTA PUSAT,SAWAH BESAR,GUNUNG SAHARI UTARA,3171021004,2020-10-16,536,57,479,17,11,6
DKI JAKARTA,JAKARTA PUSAT,SAWAH BESAR,GUNUNG SAHARI UTARA,3171021004,2020-10-17,543,63,480,7,6,1
DKI JAKARTA,JAKARTA PUSAT,SAWAH BESAR,GUNUNG SAHARI UTARA,3171021004,2020-10-18,546,66,480,3,3,0
DKI JAKARTA,JAKARTA PUSAT,SAWAH BESAR,GUNUNG SAHARI UTARA,3171021004,2020-10-19,546,65,481,0,-1,1
DKI JAKARTA,JAKARTA PUSAT,SAWAH BESAR,GUNUNG SAHARI UTARA,3171021004,2020-10-20,552,59,493,6,-6,12
DKI JAKARTA,JAKARTA PUSAT,SAWAH BESAR,GUNUNG SAHARI UTARA,3171021004,2020-10-21,556,63,493,4,4,0
DKI JAKARTA,JAKARTA PUSAT,SAWAH BESAR,GUNUNG SAHARI UTARA,3171021004,2020-10-22,556,54,502,0,-9,9
DKI JAKARTA,JAKARTA PUSAT,SAWAH BESAR,GUNUNG SAHARI UTARA,3171021004,2020-10-23,559,56,503,3,2,1
DKI JAKARTA,JAKARTA PUSAT,SAWAH BESAR,GUNUNG SAHARI UTARA,3171021004,2020-10-24,559,54,505,0,-2,2
DKI JAKARTA,JAKARTA PUSAT,SAWAH BESAR,GUNUNG SAHARI UTARA,3171021004,2020-10-25,565,60,505,6,6,0
DKI JAKARTA,JAKARTA PUSAT,SAWAH BESAR,GUNUNG SAHARI UTARA,3171021004,2020-10-26,568,42,526,3,-18,21
DKI JAKARTA,JAKARTA PUSAT,SAWAH BESAR,GUNUNG SAHARI UTARA,3171021004,2020-10-27,570,24,546,2,-18,20
DKI JAKARTA,JAKARTA PUSAT,SAWAH BESAR,GUNUNG SAHARI UTARA,3171021004,2020-10-28,571,20,551,1,-4,5
DKI JAKARTA,JAKARTA PUSAT,SAWAH BESAR,GUNUNG SAHARI UTARA,3171021004,2020-10-29,572,14,558,1,-6,7
DKI JAKARTA,JAKARTA PUSAT,SAWAH BESAR,GUNUNG SAHARI UTARA,3171021004,2020-10-30,577,18,559,5,4,1
DKI JAKARTA,JAKARTA PUSAT,SAWAH BESAR,GUNUNG SAHARI UTARA,3171021004,2020-10-31,582,23,559,5,5,0
DKI JAKARTA,JAKARTA PUSAT,SAWAH BESAR,KARANG ANYAR,3171021002,2020-10-01,761,53,708,0,0,0
DKI JAKARTA,JAKARTA PUSAT,SAWAH BESAR,KARANG ANYAR,3171021002,2020-10-02,768,43,725,7,-10,17
DKI JAKARTA,JAKARTA PUSAT,SAWAH BESAR,KARANG ANYAR,3171021002,2020-10-03,778,47,731,10,4,6
DKI JAKARTA,JAKARTA PUSAT,SAWAH BESAR,KARANG ANYAR,3171021002,2020-10-04,780,43,737,2,-4,6
DKI JAKARTA,JAKARTA PUSAT,SAWAH BESAR,KARANG ANYAR,3171021002,2020-10-05,785,43,742,5,0,5
DKI JAKARTA,JAKARTA PUSAT,SAWAH BESAR,KARANG ANYAR,3171021002,2020-10-06,793,39,754,8,-4,12
DKI JAKARTA,JAKARTA PUSAT,SAWAH BESAR,KARANG ANYAR,3171021002,2020-10-07,799,42,757,6,3,3
DKI JAKARTA,JAKARTA PUSAT,SAWAH BESAR,KARANG ANYAR,3171021002,2020-10-08,810,52,758,11,10,1
DKI JAKARTA,JAKARTA PUSAT,SAWAH BESAR,KARANG ANYAR,3171021002,2020-10-09,812,53,759,2,1,1
DKI JAKARTA,JAKARTA PUSAT,SAWAH BESAR,KARANG ANYAR,3171021002,2020-10-10,818,51,767,6,-2,8
DKI JAKARTA,JAKARTA PUSAT,SAWAH BESAR,KARANG ANYAR,3171021002,2020-10-11,825,55,770,7,4,3
DKI JAKARTA,JAKARTA PUSAT,SAWAH BESAR,KARANG ANYAR,3171021002,2020-10-12,828,48,780,3,-7,10
DKI JAKARTA,JAKARTA PUSAT,SAWAH BESAR,KARANG ANYAR,3171021002,2020-10-13,829,46,783,1,-2,3
DKI JAKARTA,JAKARTA PUSAT,SAWAH BESAR,KARANG ANYAR,3171021002,2020-10-14,831,40,791,2,-6,8
DKI JAKARTA,JAKARTA PUSAT,SAWAH BESAR,KARANG ANYAR,3171021002,2020-10-15,843,42,801,12,2,10
DKI JAKARTA,JAKARTA PUSAT,SAWAH BESAR,KARANG ANYAR,3171021002,2020-10-16,846,42,804,3,0,3
DKI JAKARTA,JAKARTA PUSAT,SAWAH BESAR,KARANG ANYAR,3171021002,2020-10-17,852,47,805,6,5,1
DKI JAKARTA,JAKARTA PUSAT,SAWAH BESAR,KARANG ANYAR,3171021002,2020-10-18,858,53,805,6,6,0
DKI JAKARTA,JAKARTA PUSAT,SAWAH BESAR,KARANG ANYAR,3171021002,2020-10-19,862,54,808,4,1,3
DKI JAKARTA,JAKARTA PUSAT,SAWAH BESAR,KARANG ANYAR,3171021002,2020-10-20,867,49,818,5,-5,10
DKI JAKARTA,JAKARTA PUSAT,SAWAH BESAR,KARANG ANYAR,3171021002,2020-10-21,869,50,819,2,1,1
DKI JAKARTA,JAKARTA PUSAT,SAWAH BESAR,KARANG ANYAR,3171021002,2020-10-22,870,39,831,1,-11,12
DKI JAKARTA,JAKARTA PUSAT,SAWAH BESAR,KARANG ANYAR,3171021002,2020-10-23,873,42,831,3,3,0
DKI JAKARTA,JAKARTA PUSAT,SAWAH BESAR,KARANG ANYAR,3171021002,2020-10-24,904,69,835,31,27,4
DKI JAKARTA,JAKARTA PUSAT,SAWAH BESAR,KARANG ANYAR,3171021002,2020-10-25,907,66,841,3,-3,6
DKI JAKARTA,JAKARTA PUSAT,SAWAH BESAR,KARANG ANYAR,3171021002,2020-10-26,912,58,854,5,-8,13
DKI JAKARTA,JAKARTA PUSAT,SAWAH BESAR,KARANG ANYAR,3171021002,2020-10-27,918,56,862,6,-2,8
DKI JAKARTA,JAKARTA PUSAT,SAWAH BESAR,KARANG ANYAR,3171021002,2020-10-28,920,55,865,2,-1,3
DKI JAKARTA,JAKARTA PUSAT,SAWAH BESAR,KARANG ANYAR,3171021002,2020-10-29,921,53,869,1,-2,4
DKI JAKARTA,JAKARTA PUSAT,SAWAH BESAR,KARANG ANYAR,3171021002,2020-10-30,928,50,879,7,-3,10
DKI JAKARTA,JAKARTA PUSAT,SAWAH BESAR,KARANG ANYAR,3171021002,2020-10-31,929,50,880,1,0,1
DKI JAKARTA,JAKARTA PUSAT,SAWAH BESAR,KARTINI,3171021003,2020-10-01,574,61,513,0,0,0
DKI JAKARTA,JAKARTA PUSAT,SAWAH BESAR,KARTINI,3171021003,2020-10-02,591,73,518,17,12,5
DKI JAKARTA,JAKARTA PUSAT,SAWAH BESAR,KARTINI,3171021003,2020-10-03,611,91,520,20,18,2
DKI JAKARTA,JAKARTA PUSAT,SAWAH BESAR,KARTINI,3171021003,2020-10-04,616,96,520,5,5,0
DKI JAKARTA,JAKARTA PUSAT,SAWAH BESAR,KARTINI,3171021003,2020-10-05,622,94,528,6,-2,8
DKI JAKARTA,JAKARTA PUSAT,SAWAH BESAR,KARTINI,3171021003,2020-10-06,632,99,533,10,5,5
DKI JAKARTA,JAKARTA PUSAT,SAWAH BESAR,KARTINI,3171021003,2020-10-07,641,98,543,9,-1,10
DKI JAKARTA,JAKARTA PUSAT,SAWAH BESAR,KARTINI,3171021003,2020-10-08,651,89,562,10,-9,19
DKI JAKARTA,JAKARTA PUSAT,SAWAH BESAR,KARTINI,3171021003,2020-10-09,651,89,562,0,0,0
DKI JAKARTA,JAKARTA PUSAT,SAWAH BESAR,KARTINI,3171021003,2020-10-10,652,76,576,1,-13,14
DKI JAKARTA,JAKARTA PUSAT,SAWAH BESAR,KARTINI,3171021003,2020-10-11,654,77,577,2,1,1
DKI JAKARTA,JAKARTA PUSAT,SAWAH BESAR,KARTINI,3171021003,2020-10-12,660,57,603,6,-20,26
DKI JAKARTA,JAKARTA PUSAT,SAWAH BESAR,KARTINI,3171021003,2020-10-13,660,47,613,0,-10,10
DKI JAKARTA,JAKARTA PUSAT,SAWAH BESAR,KARTINI,3171021003,2020-10-14,660,42,618,0,-5,5
DKI JAKARTA,JAKARTA PUSAT,SAWAH BESAR,KARTINI,3171021003,2020-10-15,679,51,628,19,9,10
DKI JAKARTA,JAKARTA PUSAT,SAWAH BESAR,KARTINI,3171021003,2020-10-16,683,37,646,4,-14,18
DKI JAKARTA,JAKARTA PUSAT,SAWAH BESAR,KARTINI,3171021003,2020-10-17,685,36,649,2,-1,3
DKI JAKARTA,JAKARTA PUSAT,SAWAH BESAR,KARTINI,3171021003,2020-10-18,687,38,649,2,2,0
DKI JAKARTA,JAKARTA PUSAT,SAWAH BESAR,KARTINI,3171021003,2020-10-19,688,30,658,1,-8,9
DKI JAKARTA,JAKARTA PUSAT,SAWAH BESAR,KARTINI,3171021003,2020-10-20,692,31,661,4,1,3
DKI JAKARTA,JAKARTA PUSAT,SAWAH BESAR,KARTINI,3171021003,2020-10-21,692,29,663,0,-2,2
DKI JAKARTA,JAKARTA PUSAT,SAWAH BESAR,KARTINI,3171021003,2020-10-22,693,28,665,1,-1,2
DKI JAKARTA,JAKARTA PUSAT,SAWAH BESAR,KARTINI,3171021003,2020-10-23,693,28,665,0,0,0
DKI JAKARTA,JAKARTA PUSAT,SAWAH BESAR,KARTINI,3171021003,2020-10-24,693,26,667,0,-2,2
DKI JAKARTA,JAKARTA PUSAT,SAWAH BESAR,KARTINI,3171021003,2020-10-25,694,25,669,1,-1,2
DKI JAKARTA,JAKARTA PUSAT,SAWAH BESAR,KARTINI,3171021003,2020-10-26,695,7,688,1,-18,19
DKI JAKARTA,JAKARTA PUSAT,SAWAH BESAR,KARTINI,3171021003,2020-10-27,699,9,690,4,2,2
DKI JAKARTA,JAKARTA PUSAT,SAWAH BESAR,KARTINI,3171021003,2020-10-28,704,11,693,5,2,3
DKI JAKARTA,JAKARTA PUSAT,SAWAH BESAR,KARTINI,3171021003,2020-10-29,706,9,697,2,-2,4
DKI JAKARTA,JAKARTA PUSAT,SAWAH BESAR,KARTINI,3171021003,2020-10-30,714,16,698,8,7,1
DKI JAKARTA,JAKARTA PUSAT,SAWAH BESAR,KARTINI,3171021003,2020-10-31,715,16,699,1,0,1
DKI JAKARTA,JAKARTA PUSAT,SAWAH BESAR,MANGGA DUA SELATAN,3171021005,2020-10-01,692,39,653,0,0,0
DKI JAKARTA,JAKARTA PUSAT,SAWAH BESAR,MANGGA DUA SELATAN,3171021005,2020-10-02,701,39,662,9,0,9
DKI JAKARTA,JAKARTA PUSAT,SAWAH BESAR,MANGGA DUA SELATAN,3171021005,2020-10-03,708,45,663,7,6,1
DKI JAKARTA,JAKARTA PUSAT,SAWAH BESAR,MANGGA DUA SELATAN,3171021005,2020-10-04,714,51,663,6,6,0
DKI JAKARTA,JAKARTA PUSAT,SAWAH BESAR,MANGGA DUA SELATAN,3171021005,2020-10-05,720,50,670,6,-1,7
DKI JAKARTA,JAKARTA PUSAT,SAWAH BESAR,MANGGA DUA SELATAN,3171021005,2020-10-06,732,53,679,12,3,9
DKI JAKARTA,JAKARTA PUSAT,SAWAH BESAR,MANGGA DUA SELATAN,3171021005,2020-10-07,736,49,687,4,-4,8
DKI JAKARTA,JAKARTA PUSAT,SAWAH BESAR,MANGGA DUA SELATAN,3171021005,2020-10-08,752,62,690,16,13,3
DKI JAKARTA,JAKARTA PUSAT,SAWAH BESAR,MANGGA DUA SELATAN,3171021005,2020-10-09,753,63,690,1,1,0
DKI JAKARTA,JAKARTA PUSAT,SAWAH BESAR,MANGGA DUA SELATAN,3171021005,2020-10-10,759,62,697,6,-1,7
DKI JAKARTA,JAKARTA PUSAT,SAWAH BESAR,MANGGA DUA SELATAN,3171021005,2020-10-11,766,67,699,7,5,2
DKI JAKARTA,JAKARTA PUSAT,SAWAH BESAR,MANGGA DUA SELATAN,3171021005,2020-10-12,769,60,709,3,-7,10
DKI JAKARTA,JAKARTA PUSAT,SAWAH BESAR,MANGGA DUA SELATAN,3171021005,2020-10-13,770,57,713,1,-3,4
DKI JAKARTA,JAKARTA PUSAT,SAWAH BESAR,MANGGA DUA SELATAN,3171021005,2020-10-14,770,48,722,0,-9,9
DKI JAKARTA,JAKARTA PUSAT,SAWAH BESAR,MANGGA DUA SELATAN,3171021005,2020-10-15,784,52,732,14,4,10
DKI JAKARTA,JAKARTA PUSAT,SAWAH BESAR,MANGGA DUA SELATAN,3171021005,2020-10-16,800,63,737,16,11,5
DKI JAKARTA,JAKARTA PUSAT,SAWAH BESAR,MANGGA DUA SELATAN,3171021005,2020-10-17,814,75,739,14,12,2
DKI JAKARTA,JAKARTA PUSAT,SAWAH BESAR,MANGGA DUA SELATAN,3171021005,2020-10-18,818,79,739,4,4,0
DKI JAKARTA,JAKARTA PUSAT,SAWAH BESAR,MANGGA DUA SELATAN,3171021005,2020-10-19,822,66,756,4,-13,17
DKI JAKARTA,JAKARTA PUSAT,SAWAH BESAR,MANGGA DUA SELATAN,3171021005,2020-10-20,830,72,758,8,6,2
DKI JAKARTA,JAKARTA PUSAT,SAWAH BESAR,MANGGA DUA SELATAN,3171021005,2020-10-21,832,67,765,2,-5,7
DKI JAKARTA,JAKARTA PUSAT,SAWAH BESAR,MANGGA DUA SELATAN,3171021005,2020-10-22,835,61,774,3,-6,9
DKI JAKARTA,JAKARTA PUSAT,SAWAH BESAR,MANGGA DUA SELATAN,3171021005,2020-10-23,837,62,775,2,1,1
DKI JAKARTA,JAKARTA PUSAT,SAWAH BESAR,MANGGA DUA SELATAN,3171021005,2020-10-24,839,61,778,2,-1,3
DKI JAKARTA,JAKARTA PUSAT,SAWAH BESAR,MANGGA DUA SELATAN,3171021005,2020-10-25,840,62,778,1,1,0
DKI JAKARTA,JAKARTA PUSAT,SAWAH BESAR,MANGGA DUA SELATAN,3171021005,2020-10-26,846,52,794,6,-10,16
DKI JAKARTA,JAKARTA PUSAT,SAWAH BESAR,MANGGA DUA SELATAN,3171021005,2020-10-27,852,37,815,6,-15,21
DKI JAKARTA,JAKARTA PUSAT,SAWAH BESAR,MANGGA DUA SELATAN,3171021005,2020-10-28,866,48,818,14,11,3
DKI JAKARTA,JAKARTA PUSAT,SAWAH BESAR,MANGGA DUA SELATAN,3171021005,2020-10-29,867,33,834,1,-15,16
DKI JAKARTA,JAKARTA PUSAT,SAWAH BESAR,MANGGA DUA SELATAN,3171021005,2020-10-30,875,34,841,8,1,7
DKI JAKARTA,JAKARTA PUSAT,SAWAH BESAR,MANGGA DUA SELATAN,3171021005,2020-10-31,876,33,843,1,-1,2
DKI JAKARTA,JAKARTA PUSAT,SAWAH BESAR,PASAR BARU,3171021001,2020-10-01,412,21,391,0,0,0
DKI JAKARTA,JAKARTA PUSAT,SAWAH BESAR,PASAR BARU,3171021001,2020-10-02,419,22,397,7,1,6
DKI JAKARTA,JAKARTA PUSAT,SAWAH BESAR,PASAR BARU,3171021001,2020-10-03,423,26,397,4,4,0
DKI JAKARTA,JAKARTA PUSAT,SAWAH BESAR,PASAR BARU,3171021001,2020-10-04,425,27,398,2,1,1
DKI JAKARTA,JAKARTA PUSAT,SAWAH BESAR,PASAR BARU,3171021001,2020-10-05,426,27,399,1,0,1
DKI JAKARTA,JAKARTA PUSAT,SAWAH BESAR,PASAR BARU,3171021001,2020-10-06,430,28,402,4,1,3
DKI JAKARTA,JAKARTA PUSAT,SAWAH BESAR,PASAR BARU,3171021001,2020-10-07,432,27,405,2,-1,3
DKI JAKARTA,JAKARTA PUSAT,SAWAH BESAR,PASAR BARU,3171021001,2020-10-08,436,23,413,4,-4,8
DKI JAKARTA,JAKARTA PUSAT,SAWAH BESAR,PASAR BARU,3171021001,2020-10-09,440,26,414,4,3,1
DKI JAKARTA,JAKARTA PUSAT,SAWAH BESAR,PASAR BARU,3171021001,2020-10-10,443,24,419,3,-2,5
DKI JAKARTA,JAKARTA PUSAT,SAWAH BESAR,PASAR BARU,3171021001,2020-10-11,446,27,419,3,3,0
DKI JAKARTA,JAKARTA PUSAT,SAWAH BESAR,PASAR BARU,3171021001,2020-10-12,453,24,429,7,-3,10
DKI JAKARTA,JAKARTA PUSAT,SAWAH BESAR,PASAR BARU,3171021001,2020-10-13,455,25,430,2,1,1
DKI JAKARTA,JAKARTA PUSAT,SAWAH BESAR,PASAR BARU,3171021001,2020-10-14,455,22,433,0,-3,3
DKI JAKARTA,JAKARTA PUSAT,SAWAH BESAR,PASAR BARU,3171021001,2020-10-15,458,22,436,3,0,3
DKI JAKARTA,JAKARTA PUSAT,SAWAH BESAR,PASAR BARU,3171021001,2020-10-16,460,22,438,2,0,2
DKI JAKARTA,JAKARTA PUSAT,SAWAH BESAR,PASAR BARU,3171021001,2020-10-17,463,25,438,3,3,0
DKI JAKARTA,JAKARTA PUSAT,SAWAH BESAR,PASAR BARU,3171021001,2020-10-18,465,27,438,2,2,0
DKI JAKARTA,JAKARTA PUSAT,SAWAH BESAR,PASAR BARU,3171021001,2020-10-19,466,24,442,1,-3,4
DKI JAKARTA,JAKARTA PUSAT,SAWAH BESAR,PASAR BARU,3171021001,2020-10-20,468,24,444,2,0,2
DKI JAKARTA,JAKARTA PUSAT,SAWAH BESAR,PASAR BARU,3171021001,2020-10-21,468,19,449,0,-5,5
DKI JAKARTA,JAKARTA PUSAT,SAWAH BESAR,PASAR BARU,3171021001,2020-10-22,468,14,454,0,-5,5
DKI JAKARTA,JAKARTA PUSAT,SAWAH BESAR,PASAR BARU,3171021001,2020-10-23,471,16,455,3,2,1
DKI JAKARTA,JAKARTA PUSAT,SAWAH BESAR,PASAR BARU,3171021001,2020-10-24,472,10,462,1,-6,7
DKI JAKARTA,JAKARTA PUSAT,SAWAH BESAR,PASAR BARU,3171021001,2020-10-25,473,11,462,1,1,0
DKI JAKARTA,JAKARTA PUSAT,SAWAH BESAR,PASAR BARU,3171021001,2020-10-26,485,20,465,12,9,3
DKI JAKARTA,JAKARTA PUSAT,SAWAH BESAR,PASAR BARU,3171021001,2020-10-27,490,23,467,5,3,2
DKI JAKARTA,JAKARTA PUSAT,SAWAH BESAR,PASAR BARU,3171021001,2020-10-28,496,27,469,6,4,2
DKI JAKARTA,JAKARTA PUSAT,SAWAH BESAR,PASAR BARU,3171021001,2020-10-29,499,28,471,3,1,2
DKI JAKARTA,JAKARTA PUSAT,SAWAH BESAR,PASAR BARU,3171021001,2020-10-30,511,37,474,12,9,3
DKI JAKARTA,JAKARTA PUSAT,SAWAH BESAR,PASAR BARU,3171021001,2020-10-31,513,38,475,2,1,1
DKI JAKARTA,JAKARTA PUSAT,SENEN,BUNGUR,3171041006,2020-10-01,448,18,430,0,0,0
DKI JAKARTA,JAKARTA PUSAT,SENEN,BUNGUR,3171041006,2020-10-02,451,13,438,3,-5,8
DKI JAKARTA,JAKARTA PUSAT,SENEN,BUNGUR,3171041006,2020-10-03,456,17,439,5,4,1
DKI JAKARTA,JAKARTA PUSAT,SENEN,BUNGUR,3171041006,2020-10-04,457,18,439,1,1,0
DKI JAKARTA,JAKARTA PUSAT,SENEN,BUNGUR,3171041006,2020-10-05,458,16,442,1,-2,3
DKI JAKARTA,JAKARTA PUSAT,SENEN,BUNGUR,3171041006,2020-10-06,460,17,443,2,1,1
DKI JAKARTA,JAKARTA PUSAT,SENEN,BUNGUR,3171041006,2020-10-07,462,18,444,2,1,1
DKI JAKARTA,JAKARTA PUSAT,SENEN,BUNGUR,3171041006,2020-10-08,475,26,449,13,8,5
DKI JAKARTA,JAKARTA PUSAT,SENEN,BUNGUR,3171041006,2020-10-09,476,26,450,1,0,1
DKI JAKARTA,JAKARTA PUSAT,SENEN,BUNGUR,3171041006,2020-10-10,481,31,450,5,5,0
DKI JAKARTA,JAKARTA PUSAT,SENEN,BUNGUR,3171041006,2020-10-11,486,35,451,5,4,1
DKI JAKARTA,JAKARTA PUSAT,SENEN,BUNGUR,3171041006,2020-10-12,488,35,453,2,0,2
DKI JAKARTA,JAKARTA PUSAT,SENEN,BUNGUR,3171041006,2020-10-13,489,32,457,1,-3,4
DKI JAKARTA,JAKARTA PUSAT,SENEN,BUNGUR,3171041006,2020-10-14,500,39,461,11,7,4
DKI JAKARTA,JAKARTA PUSAT,SENEN,BUNGUR,3171041006,2020-10-15,512,49,463,12,10,2
DKI JAKARTA,JAKARTA PUSAT,SENEN,BUNGUR,3171041006,2020-10-16,514,47,467,2,-2,4
DKI JAKARTA,JAKARTA PUSAT,SENEN,BUNGUR,3171041006,2020-10-17,514,44,470,0,-3,3
DKI JAKARTA,JAKARTA PUSAT,SENEN,BUNGUR,3171041006,2020-10-18,515,45,470,1,1,0
DKI JAKARTA,JAKARTA PUSAT,SENEN,BUNGUR,3171041006,2020-10-19,518,46,472,3,1,2
DKI JAKARTA,JAKARTA PUSAT,SENEN,BUNGUR,3171041006,2020-10-20,518,46,472,0,0,0
DKI JAKARTA,JAKARTA PUSAT,SENEN,BUNGUR,3171041006,2020-10-21,522,42,480,4,-4,8
DKI JAKARTA,JAKARTA PUSAT,SENEN,BUNGUR,3171041006,2020-10-22,533,51,482,11,9,2
DKI JAKARTA,JAKARTA PUSAT,SENEN,BUNGUR,3171041006,2020-10-23,543,61,482,10,10,0
DKI JAKARTA,JAKARTA PUSAT,SENEN,BUNGUR,3171041006,2020-10-24,551,62,489,8,1,7
DKI JAKARTA,JAKARTA PUSAT,SENEN,BUNGUR,3171041006,2020-10-25,571,81,490,20,19,1
DKI JAKARTA,JAKARTA PUSAT,SENEN,BUNGUR,3171041006,2020-10-26,575,64,511,4,-17,21
DKI JAKARTA,JAKARTA PUSAT,SENEN,BUNGUR,3171041006,2020-10-27,589,72,517,14,8,6
DKI JAKARTA,JAKARTA PUSAT,SENEN,BUNGUR,3171041006,2020-10-28,592,72,520,3,0,3
DKI JAKARTA,JAKARTA PUSAT,SENEN,BUNGUR,3171041006,2020-10-29,596,73,523,4,1,3
DKI JAKARTA,JAKARTA PUSAT,SENEN,BUNGUR,3171041006,2020-10-30,604,75,529,8,2,6
DKI JAKARTA,JAKARTA PUSAT,SENEN,BUNGUR,3171041006,2020-10-31,605,76,529,1,1,0
DKI JAKARTA,JAKARTA PUSAT,SENEN,KENARI,3171041002,2020-10-01,413,30,383,0,0,0
DKI JAKARTA,JAKARTA PUSAT,SENEN,KENARI,3171041002,2020-10-02,424,35,389,11,5,6
DKI JAKARTA,JAKARTA PUSAT,SENEN,KENARI,3171041002,2020-10-03,438,40,398,14,5,9
DKI JAKARTA,JAKARTA PUSAT,SENEN,KENARI,3171041002,2020-10-04,442,43,399,4,3,1
DKI JAKARTA,JAKARTA PUSAT,SENEN,KENARI,3171041002,2020-10-05,444,42,402,2,-1,3
DKI JAKARTA,JAKARTA PUSAT,SENEN,KENARI,3171041002,2020-10-06,449,46,403,5,4,1
DKI JAKARTA,JAKARTA PUSAT,SENEN,KENARI,3171041002,2020-10-07,453,39,414,4,-7,11
DKI JAKARTA,JAKARTA PUSAT,SENEN,KENARI,3171041002,2020-10-08,461,41,420,8,2,6
DKI JAKARTA,JAKARTA PUSAT,SENEN,KENARI,3171041002,2020-10-09,467,46,421,6,5,1
DKI JAKARTA,JAKARTA PUSAT,SENEN,KENARI,3171041002,2020-10-10,474,45,429,7,-1,8
DKI JAKARTA,JAKARTA PUSAT,SENEN,KENARI,3171041002,2020-10-11,477,46,431,3,1,2
DKI JAKARTA,JAKARTA PUSAT,SENEN,KENARI,3171041002,2020-10-12,480,46,434,3,0,3
DKI JAKARTA,JAKARTA PUSAT,SENEN,KENARI,3171041002,2020-10-13,481,42,439,1,-4,5
DKI JAKARTA,JAKARTA PUSAT,SENEN,KENARI,3171041002,2020-10-14,484,33,451,3,-9,12
DKI JAKARTA,JAKARTA PUSAT,SENEN,KENARI,3171041002,2020-10-15,489,28,461,5,-5,10
DKI JAKARTA,JAKARTA PUSAT,SENEN,KENARI,3171041002,2020-10-16,492,27,465,3,-1,4
DKI JAKARTA,JAKARTA PUSAT,SENEN,KENARI,3171041002,2020-10-17,499,33,466,7,6,1
DKI JAKARTA,JAKARTA PUSAT,SENEN,KENARI,3171041002,2020-10-18,502,36,466,3,3,0
DKI JAKARTA,JAKARTA PUSAT,SENEN,KENARI,3171041002,2020-10-19,503,32,471,1,-4,5
DKI JAKARTA,JAKARTA PUSAT,SENEN,KENARI,3171041002,2020-10-20,505,28,477,2,-4,6
DKI JAKARTA,JAKARTA PUSAT,SENEN,KENARI,3171041002,2020-10-21,512,26,486,7,-2,9
DKI JAKARTA,JAKARTA PUSAT,SENEN,KENARI,3171041002,2020-10-22,518,20,498,6,-6,12
DKI JAKARTA,JAKARTA PUSAT,SENEN,KENARI,3171041002,2020-10-23,529,27,502,11,7,4
DKI JAKARTA,JAKARTA PUSAT,SENEN,KENARI,3171041002,2020-10-24,532,29,503,3,2,1
DKI JAKARTA,JAKARTA PUSAT,SENEN,KENARI,3171041002,2020-10-25,541,38,503,9,9,0
DKI JAKARTA,JAKARTA PUSAT,SENEN,KENARI,3171041002,2020-10-26,541,30,511,0,-8,8
DKI JAKARTA,JAKARTA PUSAT,SENEN,KENARI,3171041002,2020-10-27,553,41,512,12,11,1
DKI JAKARTA,JAKARTA PUSAT,SENEN,KENARI,3171041002,2020-10-28,554,38,516,1,-3,4
DKI JAKARTA,JAKARTA PUSAT,SENEN,KENARI,3171041002,2020-10-29,557,37,520,3,-1,4
DKI JAKARTA,JAKARTA PUSAT,SENEN,KENARI,3171041002,2020-10-30,565,43,522,8,6,2
DKI JAKARTA,JAKARTA PUSAT,SENEN,KENARI,3171041002,2020-10-31,568,42,526,3,-1,4
DKI JAKARTA,JAKARTA PUSAT,SENEN,KRAMAT,3171041004,2020-10-01,796,31,765,0,0,0
DKI JAKARTA,JAKARTA PUSAT,SENEN,KRAMAT,3171041004,2020-10-02,806,36,770,10,5,5
DKI JAKARTA,JAKARTA PUSAT,SENEN,KRAMAT,3171041004,2020-10-03,826,40,786,20,4,16
DKI JAKARTA,JAKARTA PUSAT,SENEN,KRAMAT,3171041004,2020-10-04,827,40,787,1,0,1
DKI JAKARTA,JAKARTA PUSAT,SENEN,KRAMAT,3171041004,2020-10-05,831,42,789,4,2,2
DKI JAKARTA,JAKARTA PUSAT,SENEN,KRAMAT,3171041004,2020-10-06,838,42,796,7,0,7
DKI JAKARTA,JAKARTA PUSAT,SENEN,KRAMAT,3171041004,2020-10-07,846,49,797,8,7,1
DKI JAKARTA,JAKARTA PUSAT,SENEN,KRAMAT,3171041004,2020-10-08,858,52,806,12,3,9
DKI JAKARTA,JAKARTA PUSAT,SENEN,KRAMAT,3171041004,2020-10-09,860,54,806,2,2,0
DKI JAKARTA,JAKARTA PUSAT,SENEN,KRAMAT,3171041004,2020-10-10,866,54,812,6,0,6
DKI JAKARTA,JAKARTA PUSAT,SENEN,KRAMAT,3171041004,2020-10-11,873,60,813,7,6,1
DKI JAKARTA,JAKARTA PUSAT,SENEN,KRAMAT,3171041004,2020-10-12,875,59,816,2,-1,3
DKI JAKARTA,JAKARTA PUSAT,SENEN,KRAMAT,3171041004,2020-10-13,876,50,826,1,-9,10
DKI JAKARTA,JAKARTA PUSAT,SENEN,KRAMAT,3171041004,2020-10-14,887,52,835,11,2,9
DKI JAKARTA,JAKARTA PUSAT,SENEN,KRAMAT,3171041004,2020-10-15,895,53,842,8,1,7
DKI JAKARTA,JAKARTA PUSAT,SENEN,KRAMAT,3171041004,2020-10-16,902,57,845,7,4,3
DKI JAKARTA,JAKARTA PUSAT,SENEN,KRAMAT,3171041004,2020-10-17,903,57,846,1,0,1
DKI JAKARTA,JAKARTA PUSAT,SENEN,KRAMAT,3171041004,2020-10-18,906,59,847,3,2,1
DKI JAKARTA,JAKARTA PUSAT,SENEN,KRAMAT,3171041004,2020-10-19,908,54,854,2,-5,7
DKI JAKARTA,JAKARTA PUSAT,SENEN,KRAMAT,3171041004,2020-10-20,911,45,866,3,-9,12
DKI JAKARTA,JAKARTA PUSAT,SENEN,KRAMAT,3171041004,2020-10-21,923,51,872,12,6,6
DKI JAKARTA,JAKARTA PUSAT,SENEN,KRAMAT,3171041004,2020-10-22,940,60,880,17,9,8
DKI JAKARTA,JAKARTA PUSAT,SENEN,KRAMAT,3171041004,2020-10-23,947,67,880,7,7,0
DKI JAKARTA,JAKARTA PUSAT,SENEN,KRAMAT,3171041004,2020-10-24,952,65,887,5,-2,7
DKI JAKARTA,JAKARTA PUSAT,SENEN,KRAMAT,3171041004,2020-10-25,954,67,887,2,2,0
DKI JAKARTA,JAKARTA PUSAT,SENEN,KRAMAT,3171041004,2020-10-26,958,64,894,4,-3,7
DKI JAKARTA,JAKARTA PUSAT,SENEN,KRAMAT,3171041004,2020-10-27,971,68,903,13,4,9
DKI JAKARTA,JAKARTA PUSAT,SENEN,KRAMAT,3171041004,2020-10-28,981,73,908,10,5,5
DKI JAKARTA,JAKARTA PUSAT,SENEN,KRAMAT,3171041004,2020-10-29,988,74,914,7,1,6
DKI JAKARTA,JAKARTA PUSAT,SENEN,KRAMAT,3171041004,2020-10-30,998,80,918,10,6,4
DKI JAKARTA,JAKARTA PUSAT,SENEN,KRAMAT,3171041004,2020-10-31,998,78,920,0,-2,2
DKI JAKARTA,JAKARTA PUSAT,SENEN,KWITANG,3171041005,2020-10-01,393,16,377,0,0,0
DKI JAKARTA,JAKARTA PUSAT,SENEN,KWITANG,3171041005,2020-10-02,396,18,378,3,2,1
DKI JAKARTA,JAKARTA PUSAT,SENEN,KWITANG,3171041005,2020-10-03,403,21,382,7,3,4
DKI JAKARTA,JAKARTA PUSAT,SENEN,KWITANG,3171041005,2020-10-04,405,22,383,2,1,1
DKI JAKARTA,JAKARTA PUSAT,SENEN,KWITANG,3171041005,2020-10-05,407,22,385,2,0,2
DKI JAKARTA,JAKARTA PUSAT,SENEN,KWITANG,3171041005,2020-10-06,408,21,387,1,-1,2
DKI JAKARTA,JAKARTA PUSAT,SENEN,KWITANG,3171041005,2020-10-07,416,28,388,8,7,1
DKI JAKARTA,JAKARTA PUSAT,SENEN,KWITANG,3171041005,2020-10-08,421,29,392,5,1,4
DKI JAKARTA,JAKARTA PUSAT,SENEN,KWITANG,3171041005,2020-10-09,421,29,392,0,0,0
DKI JAKARTA,JAKARTA PUSAT,SENEN,KWITANG,3171041005,2020-10-10,422,28,394,1,-1,2
DKI JAKARTA,JAKARTA PUSAT,SENEN,KWITANG,3171041005,2020-10-11,424,27,397,2,-1,3
DKI JAKARTA,JAKARTA PUSAT,SENEN,KWITANG,3171041005,2020-10-12,428,29,399,4,2,2
DKI JAKARTA,JAKARTA PUSAT,SENEN,KWITANG,3171041005,2020-10-13,429,28,401,1,-1,2
DKI JAKARTA,JAKARTA PUSAT,SENEN,KWITANG,3171041005,2020-10-14,440,33,407,11,5,6
DKI JAKARTA,JAKARTA PUSAT,SENEN,KWITANG,3171041005,2020-10-15,451,41,410,11,8,3
DKI JAKARTA,JAKARTA PUSAT,SENEN,KWITANG,3171041005,2020-10-16,455,43,412,4,2,2
DKI JAKARTA,JAKARTA PUSAT,SENEN,KWITANG,3171041005,2020-10-17,457,43,414,2,0,2
DKI JAKARTA,JAKARTA PUSAT,SENEN,KWITANG,3171041005,2020-10-18,457,43,414,0,0,0
DKI JAKARTA,JAKARTA PUSAT,SENEN,KWITANG,3171041005,2020-10-19,458,33,425,1,-10,11
DKI JAKARTA,JAKARTA PUSAT,SENEN,KWITANG,3171041005,2020-10-20,459,32,427,1,-1,2
DKI JAKARTA,JAKARTA PUSAT,SENEN,KWITANG,3171041005,2020-10-21,465,38,427,6,6,0
DKI JAKARTA,JAKARTA PUSAT,SENEN,KWITANG,3171041005,2020-10-22,468,36,432,3,-2,5
DKI JAKARTA,JAKARTA PUSAT,SENEN,KWITANG,3171041005,2020-10-23,480,48,432,12,12,0
DKI JAKARTA,JAKARTA PUSAT,SENEN,KWITANG,3171041005,2020-10-24,482,47,435,2,-1,3
DKI JAKARTA,JAKARTA PUSAT,SENEN,KWITANG,3171041005,2020-10-25,486,51,435,4,4,0
DKI JAKARTA,JAKARTA PUSAT,SENEN,KWITANG,3171041005,2020-10-26,488,33,455,2,-18,20
DKI JAKARTA,JAKARTA PUSAT,SENEN,KWITANG,3171041005,2020-10-27,500,44,456,12,11,1
DKI JAKARTA,JAKARTA PUSAT,SENEN,KWITANG,3171041005,2020-10-28,508,49,459,8,5,3
DKI JAKARTA,JAKARTA PUSAT,SENEN,KWITANG,3171041005,2020-10-29,510,48,462,2,-1,3
DKI JAKARTA,JAKARTA PUSAT,SENEN,KWITANG,3171041005,2020-10-30,518,55,463,8,7,1
DKI JAKARTA,JAKARTA PUSAT,SENEN,KWITANG,3171041005,2020-10-31,519,56,463,1,1,0
DKI JAKARTA,JAKARTA PUSAT,SENEN,PASEBAN,3171041003,2020-10-01,750,77,673,0,0,0
DKI JAKARTA,JAKARTA PUSAT,SENEN,PASEBAN,3171041003,2020-10-02,782,83,699,32,6,26
DKI JAKARTA,JAKARTA PUSAT,SENEN,PASEBAN,3171041003,2020-10-03,802,95,707,20,12,8
DKI JAKARTA,JAKARTA PUSAT,SENEN,PASEBAN,3171041003,2020-10-04,810,99,711,8,4,4
DKI JAKARTA,JAKARTA PUSAT,SENEN,PASEBAN,3171041003,2020-10-05,813,97,716,3,-2,5
DKI JAKARTA,JAKARTA PUSAT,SENEN,PASEBAN,3171041003,2020-10-06,823,102,721,10,5,5
DKI JAKARTA,JAKARTA PUSAT,SENEN,PASEBAN,3171041003,2020-10-07,843,106,737,20,4,16
DKI JAKARTA,JAKARTA PUSAT,SENEN,PASEBAN,3171041003,2020-10-08,857,102,755,14,-4,18
DKI JAKARTA,JAKARTA PUSAT,SENEN,PASEBAN,3171041003,2020-10-09,871,112,759,14,10,4
DKI JAKARTA,JAKARTA PUSAT,SENEN,PASEBAN,3171041003,2020-10-10,891,110,781,20,-2,22
DKI JAKARTA,JAKARTA PUSAT,SENEN,PASEBAN,3171041003,2020-10-11,904,118,786,13,8,5
DKI JAKARTA,JAKARTA PUSAT,SENEN,PASEBAN,3171041003,2020-10-12,915,113,802,11,-5,16
DKI JAKARTA,JAKARTA PUSAT,SENEN,PASEBAN,3171041003,2020-10-13,921,102,819,6,-11,17
DKI JAKARTA,JAKARTA PUSAT,SENEN,PASEBAN,3171041003,2020-10-14,928,89,839,7,-13,20
DKI JAKARTA,JAKARTA PUSAT,SENEN,PASEBAN,3171041003,2020-10-15,935,83,852,7,-6,13
DKI JAKARTA,JAKARTA PUSAT,SENEN,PASEBAN,3171041003,2020-10-16,953,88,865,18,5,13
DKI JAKARTA,JAKARTA PUSAT,SENEN,PASEBAN,3171041003,2020-10-17,965,94,871,12,6,6
DKI JAKARTA,JAKARTA PUSAT,SENEN,PASEBAN,3171041003,2020-10-18,976,104,872,11,10,1
DKI JAKARTA,JAKARTA PUSAT,SENEN,PASEBAN,3171041003,2020-10-19,978,85,893,2,-19,21
DKI JAKARTA,JAKARTA PUSAT,SENEN,PASEBAN,3171041003,2020-10-20,981,80,901,3,-5,8
DKI JAKARTA,JAKARTA PUSAT,SENEN,PASEBAN,3171041003,2020-10-21,995,88,907,14,8,6
DKI JAKARTA,JAKARTA PUSAT,SENEN,PASEBAN,3171041003,2020-10-22,1012,82,930,17,-6,23
DKI JAKARTA,JAKARTA PUSAT,SENEN,PASEBAN,3171041003,2020-10-23,1027,94,933,15,12,3
DKI JAKARTA,JAKARTA PUSAT,SENEN,PASEBAN,3171041003,2020-10-24,1043,98,945,16,4,12
DKI JAKARTA,JAKARTA PUSAT,SENEN,PASEBAN,3171041003,2020-10-25,1051,102,949,8,4,4
DKI JAKARTA,JAKARTA PUSAT,SENEN,PASEBAN,3171041003,2020-10-26,1058,95,963,7,-7,14
DKI JAKARTA,JAKARTA PUSAT,SENEN,PASEBAN,3171041003,2020-10-27,1065,93,972,7,-2,9
DKI JAKARTA,JAKARTA PUSAT,SENEN,PASEBAN,3171041003,2020-10-28,1070,88,982,5,-5,10
DKI JAKARTA,JAKARTA PUSAT,SENEN,PASEBAN,3171041003,2020-10-29,1075,86,989,5,-2,7
DKI JAKARTA,JAKARTA PUSAT,SENEN,PASEBAN,3171041003,2020-10-30,1085,91,994,10,5,5
DKI JAKARTA,JAKARTA PUSAT,SENEN,PASEBAN,3171041003,2020-10-31,1090,93,997,5,2,3
DKI JAKARTA,JAKARTA PUSAT,SENEN,SENEN,3171041001,2020-10-01,633,38,595,0,0,0
DKI JAKARTA,JAKARTA PUSAT,SENEN,SENEN,3171041001,2020-10-02,637,41,596,4,3,1
DKI JAKARTA,JAKARTA PUSAT,SENEN,SENEN,3171041001,2020-10-03,632,40,592,-5,-1,-4
DKI JAKARTA,JAKARTA PUSAT,SENEN,SENEN,3171041001,2020-10-04,643,45,598,11,5,6
DKI JAKARTA,JAKARTA PUSAT,SENEN,SENEN,3171041001,2020-10-05,644,41,603,1,-4,5
DKI JAKARTA,JAKARTA PUSAT,SENEN,SENEN,3171041001,2020-10-06,646,43,603,2,2,0
DKI JAKARTA,JAKARTA PUSAT,SENEN,SENEN,3171041001,2020-10-07,649,44,605,3,1,2
DKI JAKARTA,JAKARTA PUSAT,SENEN,SENEN,3171041001,2020-10-08,653,45,608,4,1,3
DKI JAKARTA,JAKARTA PUSAT,SENEN,SENEN,3171041001,2020-10-09,656,47,609,3,2,1
DKI JAKARTA,JAKARTA PUSAT,SENEN,SENEN,3171041001,2020-10-10,657,24,633,1,-23,24
DKI JAKARTA,JAKARTA PUSAT,SENEN,SENEN,3171041001,2020-10-11,660,25,635,3,1,2
DKI JAKARTA,JAKARTA PUSAT,SENEN,SENEN,3171041001,2020-10-12,661,19,642,1,-6,7
DKI JAKARTA,JAKARTA PUSAT,SENEN,SENEN,3171041001,2020-10-13,663,20,643,2,1,1
DKI JAKARTA,JAKARTA PUSAT,SENEN,SENEN,3171041001,2020-10-14,663,17,646,0,-3,3
DKI JAKARTA,JAKARTA PUSAT,SENEN,SENEN,3171041001,2020-10-15,666,17,649,3,0,3
DKI JAKARTA,JAKARTA PUSAT,SENEN,SENEN,3171041001,2020-10-16,670,14,656,4,-3,7
DKI JAKARTA,JAKARTA PUSAT,SENEN,SENEN,3171041001,2020-10-17,672,16,656,2,2,0
DKI JAKARTA,JAKARTA PUSAT,SENEN,SENEN,3171041001,2020-10-18,678,22,656,6,6,0
DKI JAKARTA,JAKARTA PUSAT,SENEN,SENEN,3171041001,2020-10-19,680,18,662,2,-4,6
DKI JAKARTA,JAKARTA PUSAT,SENEN,SENEN,3171041001,2020-10-20,680,17,663,0,-1,1
DKI JAKARTA,JAKARTA PUSAT,SENEN,SENEN,3171041001,2020-10-21,684,21,663,4,4,0
DKI JAKARTA,JAKARTA PUSAT,SENEN,SENEN,3171041001,2020-10-22,686,19,667,2,-2,4
DKI JAKARTA,JAKARTA PUSAT,SENEN,SENEN,3171041001,2020-10-23,687,19,668,1,0,1
DKI JAKARTA,JAKARTA PUSAT,SENEN,SENEN,3171041001,2020-10-24,699,30,669,12,11,1
DKI JAKARTA,JAKARTA PUSAT,SENEN,SENEN,3171041001,2020-10-25,700,31,669,1,1,0
DKI JAKARTA,JAKARTA PUSAT,SENEN,SENEN,3171041001,2020-10-26,703,31,672,3,0,3
DKI JAKARTA,JAKARTA PUSAT,SENEN,SENEN,3171041001,2020-10-27,724,50,674,21,19,2
DKI JAKARTA,JAKARTA PUSAT,SENEN,SENEN,3171041001,2020-10-28,741,62,679,17,12,5
DKI JAKARTA,JAKARTA PUSAT,SENEN,SENEN,3171041001,2020-10-29,741,58,683,0,-4,4
DKI JAKARTA,JAKARTA PUSAT,SENEN,SENEN,3171041001,2020-10-30,758,72,686,17,14,3
DKI JAKARTA,JAKARTA PUSAT,SENEN,SENEN,3171041001,2020-10-31,760,72,688,2,0,2
DKI JAKARTA,JAKARTA PUSAT,TANAH ABANG,BENDUNGAN HILIR,3171071002,2020-10-01,438,46,392,0,0,0
DKI JAKARTA,JAKARTA PUSAT,TANAH ABANG,BENDUNGAN HILIR,3171071002,2020-10-02,451,51,400,13,5,8
DKI JAKARTA,JAKARTA PUSAT,TANAH ABANG,BENDUNGAN HILIR,3171071002,2020-10-03,456,50,406,5,-1,6
DKI JAKARTA,JAKARTA PUSAT,TANAH ABANG,BENDUNGAN HILIR,3171071002,2020-10-04,467,59,408,11,9,2
DKI JAKARTA,JAKARTA PUSAT,TANAH ABANG,BENDUNGAN HILIR,3171071002,2020-10-05,468,53,415,1,-6,7
DKI JAKARTA,JAKARTA PUSAT,TANAH ABANG,BENDUNGAN HILIR,3171071002,2020-10-06,481,53,428,13,0,13
DKI JAKARTA,JAKARTA PUSAT,TANAH ABANG,BENDUNGAN HILIR,3171071002,2020-10-07,516,61,455,35,8,27
DKI JAKARTA,JAKARTA PUSAT,TANAH ABANG,BENDUNGAN HILIR,3171071002,2020-10-08,587,59,528,71,-2,73
DKI JAKARTA,JAKARTA PUSAT,TANAH ABANG,BENDUNGAN HILIR,3171071002,2020-10-09,592,64,528,5,5,0
DKI JAKARTA,JAKARTA PUSAT,TANAH ABANG,BENDUNGAN HILIR,3171071002,2020-10-10,598,61,537,6,-3,9
DKI JAKARTA,JAKARTA PUSAT,TANAH ABANG,BENDUNGAN HILIR,3171071002,2020-10-11,650,82,568,52,21,31
DKI JAKARTA,JAKARTA PUSAT,TANAH ABANG,BENDUNGAN HILIR,3171071002,2020-10-12,652,72,580,2,-10,12
DKI JAKARTA,JAKARTA PUSAT,TANAH ABANG,BENDUNGAN HILIR,3171071002,2020-10-13,656,46,610,4,-26,30
DKI JAKARTA,JAKARTA PUSAT,TANAH ABANG,BENDUNGAN HILIR,3171071002,2020-10-14,680,46,634,24,0,24
DKI JAKARTA,JAKARTA PUSAT,TANAH ABANG,BENDUNGAN HILIR,3171071002,2020-10-15,698,52,646,18,6,12
DKI JAKARTA,JAKARTA PUSAT,TANAH ABANG,BENDUNGAN HILIR,3171071002,2020-10-16,701,42,659,3,-10,13
DKI JAKARTA,JAKARTA PUSAT,TANAH ABANG,BENDUNGAN HILIR,3171071002,2020-10-17,715,54,661,14,12,2
DKI JAKARTA,JAKARTA PUSAT,TANAH ABANG,BENDUNGAN HILIR,3171071002,2020-10-18,727,63,664,12,9,3
DKI JAKARTA,JAKARTA PUSAT,TANAH ABANG,BENDUNGAN HILIR,3171071002,2020-10-19,729,55,674,2,-8,10
DKI JAKARTA,JAKARTA PUSAT,TANAH ABANG,BENDUNGAN HILIR,3171071002,2020-10-20,732,49,683,3,-6,9
DKI JAKARTA,JAKARTA PUSAT,TANAH ABANG,BENDUNGAN HILIR,3171071002,2020-10-21,760,73,687,28,24,4
DKI JAKARTA,JAKARTA PUSAT,TANAH ABANG,BENDUNGAN HILIR,3171071002,2020-10-22,771,77,694,11,4,7
DKI JAKARTA,JAKARTA PUSAT,TANAH ABANG,BENDUNGAN HILIR,3171071002,2020-10-23,780,82,698,9,5,4
DKI JAKARTA,JAKARTA PUSAT,TANAH ABANG,BENDUNGAN HILIR,3171071002,2020-10-24,780,74,706,0,-8,8
DKI JAKARTA,JAKARTA PUSAT,TANAH ABANG,BENDUNGAN HILIR,3171071002,2020-10-25,792,81,711,12,7,5
DKI JAKARTA,JAKARTA PUSAT,TANAH ABANG,BENDUNGAN HILIR,3171071002,2020-10-26,795,80,715,3,-1,4
DKI JAKARTA,JAKARTA PUSAT,TANAH ABANG,BENDUNGAN HILIR,3171071002,2020-10-27,798,78,720,3,-2,5
DKI JAKARTA,JAKARTA PUSAT,TANAH ABANG,BENDUNGAN HILIR,3171071002,2020-10-28,806,80,726,8,2,6
DKI JAKARTA,JAKARTA PUSAT,TANAH ABANG,BENDUNGAN HILIR,3171071002,2020-10-29,810,72,738,4,-8,12
DKI JAKARTA,JAKARTA PUSAT,TANAH ABANG,BENDUNGAN HILIR,3171071002,2020-10-30,822,65,757,12,-7,19
DKI JAKARTA,JAKARTA PUSAT,TANAH ABANG,BENDUNGAN HILIR,3171071002,2020-10-31,827,64,763,5,-1,6
DKI JAKARTA,JAKARTA PUSAT,TANAH ABANG,GELORA,3171071001,2020-10-01,107,1,106,0,0,0
DKI JAKARTA,JAKARTA PUSAT,TANAH ABANG,GELORA,3171071001,2020-10-02,134,22,112,27,21,6
DKI JAKARTA,JAKARTA PUSAT,TANAH ABANG,GELORA,3171071001,2020-10-03,139,27,112,5,5,0
DKI JAKARTA,JAKARTA PUSAT,TANAH ABANG,GELORA,3171071001,2020-10-04,140,26,114,1,-1,2
DKI JAKARTA,JAKARTA PUSAT,TANAH ABANG,GELORA,3171071001,2020-10-05,140,26,114,0,0,0
DKI JAKARTA,JAKARTA PUSAT,TANAH ABANG,GELORA,3171071001,2020-10-06,149,26,123,9,0,9
DKI JAKARTA,JAKARTA PUSAT,TANAH ABANG,GELORA,3171071001,2020-10-07,150,27,123,1,1,0
DKI JAKARTA,JAKARTA PUSAT,TANAH ABANG,GELORA,3171071001,2020-10-08,171,28,143,21,1,20
DKI JAKARTA,JAKARTA PUSAT,TANAH ABANG,GELORA,3171071001,2020-10-09,171,28,143,0,0,0
DKI JAKARTA,JAKARTA PUSAT,TANAH ABANG,GELORA,3171071001,2020-10-10,171,28,143,0,0,0
DKI JAKARTA,JAKARTA PUSAT,TANAH ABANG,GELORA,3171071001,2020-10-11,202,28,174,31,0,31
DKI JAKARTA,JAKARTA PUSAT,TANAH ABANG,GELORA,3171071001,2020-10-12,204,5,199,2,-23,25
DKI JAKARTA,JAKARTA PUSAT,TANAH ABANG,GELORA,3171071001,2020-10-13,204,5,199,0,0,0
DKI JAKARTA,JAKARTA PUSAT,TANAH ABANG,GELORA,3171071001,2020-10-14,210,5,205,6,0,6
DKI JAKARTA,JAKARTA PUSAT,TANAH ABANG,GELORA,3171071001,2020-10-15,216,11,205,6,6,0
DKI JAKARTA,JAKARTA PUSAT,TANAH ABANG,GELORA,3171071001,2020-10-16,220,14,206,4,3,1
DKI JAKARTA,JAKARTA PUSAT,TANAH ABANG,GELORA,3171071001,2020-10-17,222,16,206,2,2,0
DKI JAKARTA,JAKARTA PUSAT,TANAH ABANG,GELORA,3171071001,2020-10-18,223,17,206,1,1,0
DKI JAKARTA,JAKARTA PUSAT,TANAH ABANG,GELORA,3171071001,2020-10-19,223,16,207,0,-1,1
DKI JAKARTA,JAKARTA PUSAT,TANAH ABANG,GELORA,3171071001,2020-10-20,225,16,209,2,0,2
DKI JAKARTA,JAKARTA PUSAT,TANAH ABANG,GELORA,3171071001,2020-10-21,225,14,211,0,-2,2
DKI JAKARTA,JAKARTA PUSAT,TANAH ABANG,GELORA,3171071001,2020-10-22,225,12,213,0,-2,2
DKI JAKARTA,JAKARTA PUSAT,TANAH ABANG,GELORA,3171071001,2020-10-23,225,12,213,0,0,0
DKI JAKARTA,JAKARTA PUSAT,TANAH ABANG,GELORA,3171071001,2020-10-24,225,9,216,0,-3,3
DKI JAKARTA,JAKARTA PUSAT,TANAH ABANG,GELORA,3171071001,2020-10-25,227,9,218,2,0,2
DKI JAKARTA,JAKARTA PUSAT,TANAH ABANG,GELORA,3171071001,2020-10-26,227,9,218,0,0,0
DKI JAKARTA,JAKARTA PUSAT,TANAH ABANG,GELORA,3171071001,2020-10-27,227,5,222,0,-4,4
DKI JAKARTA,JAKARTA PUSAT,TANAH ABANG,GELORA,3171071001,2020-10-28,227,3,224,0,-2,2
DKI JAKARTA,JAKARTA PUSAT,TANAH ABANG,GELORA,3171071001,2020-10-29,227,1,226,0,-2,2
DKI JAKARTA,JAKARTA PUSAT,TANAH ABANG,GELORA,3171071001,2020-10-30,228,2,226,1,1,0
DKI JAKARTA,JAKARTA PUSAT,TANAH ABANG,GELORA,3171071001,2020-10-31,229,2,227,1,0,1
DKI JAKARTA,JAKARTA PUSAT,TANAH ABANG,KAMPUNG BALI,3171071007,2020-10-01,181,20,161,0,0,0
DKI JAKARTA,JAKARTA PUSAT,TANAH ABANG,KAMPUNG BALI,3171071007,2020-10-02,187,20,167,6,0,6
DKI JAKARTA,JAKARTA PUSAT,TANAH ABANG,KAMPUNG BALI,3171071007,2020-10-03,187,19,168,0,-1,1
DKI JAKARTA,JAKARTA PUSAT,TANAH ABANG,KAMPUNG BALI,3171071007,2020-10-04,195,26,169,8,7,1
DKI JAKARTA,JAKARTA PUSAT,TANAH ABANG,KAMPUNG BALI,3171071007,2020-10-05,195,26,169,0,0,0
DKI JAKARTA,JAKARTA PUSAT,TANAH ABANG,KAMPUNG BALI,3171071007,2020-10-06,206,29,177,11,3,8
DKI JAKARTA,JAKARTA PUSAT,TANAH ABANG,KAMPUNG BALI,3171071007,2020-10-07,220,37,183,14,8,6
DKI JAKARTA,JAKARTA PUSAT,TANAH ABANG,KAMPUNG BALI,3171071007,2020-10-08,241,39,202,21,2,19
DKI JAKARTA,JAKARTA PUSAT,TANAH ABANG,KAMPUNG BALI,3171071007,2020-10-09,244,41,203,3,2,1
DKI JAKARTA,JAKARTA PUSAT,TANAH ABANG,KAMPUNG BALI,3171071007,2020-10-10,245,32,213,1,-9,10
DKI JAKARTA,JAKARTA PUSAT,TANAH ABANG,KAMPUNG BALI,3171071007,2020-10-11,271,48,223,26,16,10
DKI JAKARTA,JAKARTA PUSAT,TANAH ABANG,KAMPUNG BALI,3171071007,2020-10-12,271,45,226,0,-3,3
DKI JAKARTA,JAKARTA PUSAT,TANAH ABANG,KAMPUNG BALI,3171071007,2020-10-13,271,39,232,0,-6,6
DKI JAKARTA,JAKARTA PUSAT,TANAH ABANG,KAMPUNG BALI,3171071007,2020-10-14,299,39,260,28,0,28
DKI JAKARTA,JAKARTA PUSAT,TANAH ABANG,KAMPUNG BALI,3171071007,2020-10-15,306,34,272,7,-5,12
DKI JAKARTA,JAKARTA PUSAT,TANAH ABANG,KAMPUNG BALI,3171071007,2020-10-16,309,21,288,3,-13,16
DKI JAKARTA,JAKARTA PUSAT,TANAH ABANG,KAMPUNG BALI,3171071007,2020-10-17,313,23,290,4,2,2
DKI JAKARTA,JAKARTA PUSAT,TANAH ABANG,KAMPUNG BALI,3171071007,2020-10-18,315,24,291,2,1,1
DKI JAKARTA,JAKARTA PUSAT,TANAH ABANG,KAMPUNG BALI,3171071007,2020-10-19,315,16,299,0,-8,8
DKI JAKARTA,JAKARTA PUSAT,TANAH ABANG,KAMPUNG BALI,3171071007,2020-10-20,315,16,299,0,0,0
DKI JAKARTA,JAKARTA PUSAT,TANAH ABANG,KAMPUNG BALI,3171071007,2020-10-21,316,15,301,1,-1,2
DKI JAKARTA,JAKARTA PUSAT,TANAH ABANG,KAMPUNG BALI,3171071007,2020-10-22,318,16,302,2,1,1
DKI JAKARTA,JAKARTA PUSAT,TANAH ABANG,KAMPUNG BALI,3171071007,2020-10-23,322,20,302,4,4,0
DKI JAKARTA,JAKARTA PUSAT,TANAH ABANG,KAMPUNG BALI,3171071007,2020-10-24,323,19,304,1,-1,2
DKI JAKARTA,JAKARTA PUSAT,TANAH ABANG,KAMPUNG BALI,3171071007,2020-10-25,324,17,307,1,-2,3
DKI JAKARTA,JAKARTA PUSAT,TANAH ABANG,KAMPUNG BALI,3171071007,2020-10-26,325,16,309,1,-1,2
DKI JAKARTA,JAKARTA PUSAT,TANAH ABANG,KAMPUNG BALI,3171071007,2020-10-27,326,12,314,1,-4,5
DKI JAKARTA,JAKARTA PUSAT,TANAH ABANG,KAMPUNG BALI,3171071007,2020-10-28,327,9,318,1,-3,4
DKI JAKARTA,JAKARTA PUSAT,TANAH ABANG,KAMPUNG BALI,3171071007,2020-10-29,329,8,321,2,-1,3
DKI JAKARTA,JAKARTA PUSAT,TANAH ABANG,KAMPUNG BALI,3171071007,2020-10-30,330,9,321,1,1,0
DKI JAKARTA,JAKARTA PUSAT,TANAH ABANG,KAMPUNG BALI,3171071007,2020-10-31,332,10,322,2,1,1
DKI JAKARTA,JAKARTA PUSAT,TANAH ABANG,KARET TENGSIN,3171071003,2020-10-01,297,30,267,0,0,0
DKI JAKARTA,JAKARTA PUSAT,TANAH ABANG,KARET TENGSIN,3171071003,2020-10-02,303,31,272,6,1,5
DKI JAKARTA,JAKARTA PUSAT,TANAH ABANG,KARET TENGSIN,3171071003,2020-10-03,307,34,273,4,3,1
DKI JAKARTA,JAKARTA PUSAT,TANAH ABANG,KARET TENGSIN,3171071003,2020-10-04,321,46,275,14,12,2
DKI JAKARTA,JAKARTA PUSAT,TANAH ABANG,KARET TENGSIN,3171071003,2020-10-05,321,45,276,0,-1,1
DKI JAKARTA,JAKARTA PUSAT,TANAH ABANG,KARET TENGSIN,3171071003,2020-10-06,333,45,288,12,0,12
DKI JAKARTA,JAKARTA PUSAT,TANAH ABANG,KARET TENGSIN,3171071003,2020-10-07,355,45,310,22,0,22
DKI JAKARTA,JAKARTA PUSAT,TANAH ABANG,KARET TENGSIN,3171071003,2020-10-08,431,53,378,76,8,68
DKI JAKARTA,JAKARTA PUSAT,TANAH ABANG,KARET TENGSIN,3171071003,2020-10-09,433,55,378,2,2,0
DKI JAKARTA,JAKARTA PUSAT,TANAH ABANG,KARET TENGSIN,3171071003,2020-10-10,435,55,380,2,0,2
DKI JAKARTA,JAKARTA PUSAT,TANAH ABANG,KARET TENGSIN,3171071003,2020-10-11,505,71,434,70,16,54
DKI JAKARTA,JAKARTA PUSAT,TANAH ABANG,KARET TENGSIN,3171071003,2020-10-12,507,67,440,2,-4,6
DKI JAKARTA,JAKARTA PUSAT,TANAH ABANG,KARET TENGSIN,3171071003,2020-10-13,508,36,472,1,-31,32
DKI JAKARTA,JAKARTA PUSAT,TANAH ABANG,KARET TENGSIN,3171071003,2020-10-14,537,35,502,29,-1,30
DKI JAKARTA,JAKARTA PUSAT,TANAH ABANG,KARET TENGSIN,3171071003,2020-10-15,557,42,515,20,7,13
DKI JAKARTA,JAKARTA PUSAT,TANAH ABANG,KARET TENGSIN,3171071003,2020-10-16,584,57,527,27,15,12
DKI JAKARTA,JAKARTA PUSAT,TANAH ABANG,KARET TENGSIN,3171071003,2020-10-17,602,66,536,18,9,9
DKI JAKARTA,JAKARTA PUSAT,TANAH ABANG,KARET TENGSIN,3171071003,2020-10-18,655,105,550,53,39,14
DKI JAKARTA,JAKARTA PUSAT,TANAH ABANG,KARET TENGSIN,3171071003,2020-10-19,666,77,589,11,-28,39
DKI JAKARTA,JAKARTA PUSAT,TANAH ABANG,KARET TENGSIN,3171071003,2020-10-20,720,76,644,54,-1,55
DKI JAKARTA,JAKARTA PUSAT,TANAH ABANG,KARET TENGSIN,3171071003,2020-10-21,722,75,647,2,-1,3
DKI JAKARTA,JAKARTA PUSAT,TANAH ABANG,KARET TENGSIN,3171071003,2020-10-22,739,77,662,17,2,15
DKI JAKARTA,JAKARTA PUSAT,TANAH ABANG,KARET TENGSIN,3171071003,2020-10-23,745,79,666,6,2,4
DKI JAKARTA,JAKARTA PUSAT,TANAH ABANG,KARET TENGSIN,3171071003,2020-10-24,745,72,673,0,-7,7
DKI JAKARTA,JAKARTA PUSAT,TANAH ABANG,KARET TENGSIN,3171071003,2020-10-25,752,66,686,7,-6,13
DKI JAKARTA,JAKARTA PUSAT,TANAH ABANG,KARET TENGSIN,3171071003,2020-10-26,752,62,690,0,-4,4
DKI JAKARTA,JAKARTA PUSAT,TANAH ABANG,KARET TENGSIN,3171071003,2020-10-27,752,52,700,0,-10,10
DKI JAKARTA,JAKARTA PUSAT,TANAH ABANG,KARET TENGSIN,3171071003,2020-10-28,753,43,710,1,-9,10
DKI JAKARTA,JAKARTA PUSAT,TANAH ABANG,KARET TENGSIN,3171071003,2020-10-29,760,35,725,7,-8,15
DKI JAKARTA,JAKARTA PUSAT,TANAH ABANG,KARET TENGSIN,3171071003,2020-10-30,768,34,734,8,-1,9
DKI JAKARTA,JAKARTA PUSAT,TANAH ABANG,KARET TENGSIN,3171071003,2020-10-31,769,35,734,1,1,0
DKI JAKARTA,JAKARTA PUSAT,TANAH ABANG,KEBON KACANG,3171071006,2020-10-01,378,18,360,0,0,0
DKI JAKARTA,JAKARTA PUSAT,TANAH ABANG,KEBON KACANG,3171071006,2020-10-02,386,25,361,8,7,1
DKI JAKARTA,JAKARTA PUSAT,TANAH ABANG,KEBON KACANG,3171071006,2020-10-03,392,25,367,6,0,6
DKI JAKARTA,JAKARTA PUSAT,TANAH ABANG,KEBON KACANG,3171071006,2020-10-04,397,30,367,5,5,0
DKI JAKARTA,JAKARTA PUSAT,TANAH ABANG,KEBON KACANG,3171071006,2020-10-05,398,29,369,1,-1,2
DKI JAKARTA,JAKARTA PUSAT,TANAH ABANG,KEBON KACANG,3171071006,2020-10-06,405,26,379,7,-3,10
DKI JAKARTA,JAKARTA PUSAT,TANAH ABANG,KEBON KACANG,3171071006,2020-10-07,421,33,388,16,7,9
DKI JAKARTA,JAKARTA PUSAT,TANAH ABANG,KEBON KACANG,3171071006,2020-10-08,452,34,418,31,1,30
DKI JAKARTA,JAKARTA PUSAT,TANAH ABANG,KEBON KACANG,3171071006,2020-10-09,454,36,418,2,2,0
DKI JAKARTA,JAKARTA PUSAT,TANAH ABANG,KEBON KACANG,3171071006,2020-10-10,457,34,423,3,-2,5
DKI JAKARTA,JAKARTA PUSAT,TANAH ABANG,KEBON KACANG,3171071006,2020-10-11,492,40,452,35,6,29
DKI JAKARTA,JAKARTA PUSAT,TANAH ABANG,KEBON KACANG,3171071006,2020-10-12,495,34,461,3,-6,9
DKI JAKARTA,JAKARTA PUSAT,TANAH ABANG,KEBON KACANG,3171071006,2020-10-13,501,32,469,6,-2,8
DKI JAKARTA,JAKARTA PUSAT,TANAH ABANG,KEBON KACANG,3171071006,2020-10-14,520,36,484,19,4,15
DKI JAKARTA,JAKARTA PUSAT,TANAH ABANG,KEBON KACANG,3171071006,2020-10-15,533,38,495,13,2,11
DKI JAKARTA,JAKARTA PUSAT,TANAH ABANG,KEBON KACANG,3171071006,2020-10-16,536,35,501,3,-3,6
DKI JAKARTA,JAKARTA PUSAT,TANAH ABANG,KEBON KACANG,3171071006,2020-10-17,545,42,503,9,7,2
DKI JAKARTA,JAKARTA PUSAT,TANAH ABANG,KEBON KACANG,3171071006,2020-10-18,547,43,504,2,1,1
DKI JAKARTA,JAKARTA PUSAT,TANAH ABANG,KEBON KACANG,3171071006,2020-10-19,547,32,515,0,-11,11
DKI JAKARTA,JAKARTA PUSAT,TANAH ABANG,KEBON KACANG,3171071006,2020-10-20,549,27,522,2,-5,7
DKI JAKARTA,JAKARTA PUSAT,TANAH ABANG,KEBON KACANG,3171071006,2020-10-21,549,24,525,0,-3,3
DKI JAKARTA,JAKARTA PUSAT,TANAH ABANG,KEBON KACANG,3171071006,2020-10-22,551,24,527,2,0,2
DKI JAKARTA,JAKARTA PUSAT,TANAH ABANG,KEBON KACANG,3171071006,2020-10-23,557,25,532,6,1,5
DKI JAKARTA,JAKARTA PUSAT,TANAH ABANG,KEBON KACANG,3171071006,2020-10-24,566,31,535,9,6,3
DKI JAKARTA,JAKARTA PUSAT,TANAH ABANG,KEBON KACANG,3171071006,2020-10-25,569,32,537,3,1,2
DKI JAKARTA,JAKARTA PUSAT,TANAH ABANG,KEBON KACANG,3171071006,2020-10-26,569,25,544,0,-7,7
DKI JAKARTA,JAKARTA PUSAT,TANAH ABANG,KEBON KACANG,3171071006,2020-10-27,571,26,545,2,1,1
DKI JAKARTA,JAKARTA PUSAT,TANAH ABANG,KEBON KACANG,3171071006,2020-10-28,574,26,548,3,0,3
DKI JAKARTA,JAKARTA PUSAT,TANAH ABANG,KEBON KACANG,3171071006,2020-10-29,577,21,556,3,-5,8
DKI JAKARTA,JAKARTA PUSAT,TANAH ABANG,KEBON KACANG,3171071006,2020-10-30,589,31,558,12,10,2
DKI JAKARTA,JAKARTA PUSAT,TANAH ABANG,KEBON KACANG,3171071006,2020-10-31,590,31,559,1,0,1
DKI JAKARTA,JAKARTA PUSAT,TANAH ABANG,KEBON MELATI,3171071005,2020-10-01,554,49,505,0,0,0
DKI JAKARTA,JAKARTA PUSAT,TANAH ABANG,KEBON MELATI,3171071005,2020-10-02,568,53,515,14,4,10
DKI JAKARTA,JAKARTA PUSAT,TANAH ABANG,KEBON MELATI,3171071005,2020-10-03,572,57,515,4,4,0
DKI JAKARTA,JAKARTA PUSAT,TANAH ABANG,KEBON MELATI,3171071005,2020-10-04,600,85,515,28,28,0
DKI JAKARTA,JAKARTA PUSAT,TANAH ABANG,KEBON MELATI,3171071005,2020-10-05,600,78,522,0,-7,7
DKI JAKARTA,JAKARTA PUSAT,TANAH ABANG,KEBON MELATI,3171071005,2020-10-06,628,88,540,28,10,18
DKI JAKARTA,JAKARTA PUSAT,TANAH ABANG,KEBON MELATI,3171071005,2020-10-07,652,90,562,24,2,22
DKI JAKARTA,JAKARTA PUSAT,TANAH ABANG,KEBON MELATI,3171071005,2020-10-08,723,107,616,71,17,54
DKI JAKARTA,JAKARTA PUSAT,TANAH ABANG,KEBON MELATI,3171071005,2020-10-09,727,111,616,4,4,0
DKI JAKARTA,JAKARTA PUSAT,TANAH ABANG,KEBON MELATI,3171071005,2020-10-10,740,112,628,13,1,12
DKI JAKARTA,JAKARTA PUSAT,TANAH ABANG,KEBON MELATI,3171071005,2020-10-11,849,140,709,109,28,81
DKI JAKARTA,JAKARTA PUSAT,TANAH ABANG,KEBON MELATI,3171071005,2020-10-12,851,124,727,2,-16,18
DKI JAKARTA,JAKARTA PUSAT,TANAH ABANG,KEBON MELATI,3171071005,2020-10-13,852,65,787,1,-59,60
DKI JAKARTA,JAKARTA PUSAT,TANAH ABANG,KEBON MELATI,3171071005,2020-10-14,893,41,852,41,-24,65
DKI JAKARTA,JAKARTA PUSAT,TANAH ABANG,KEBON MELATI,3171071005,2020-10-15,937,54,883,44,13,31
DKI JAKARTA,JAKARTA PUSAT,TANAH ABANG,KEBON MELATI,3171071005,2020-10-16,942,47,895,5,-7,12
DKI JAKARTA,JAKARTA PUSAT,TANAH ABANG,KEBON MELATI,3171071005,2020-10-17,949,53,896,7,6,1
DKI JAKARTA,JAKARTA PUSAT,TANAH ABANG,KEBON MELATI,3171071005,2020-10-18,959,62,897,10,9,1
DKI JAKARTA,JAKARTA PUSAT,TANAH ABANG,KEBON MELATI,3171071005,2020-10-19,959,59,900,0,-3,3
DKI JAKARTA,JAKARTA PUSAT,TANAH ABANG,KEBON MELATI,3171071005,2020-10-20,966,59,907,7,0,7
DKI JAKARTA,JAKARTA PUSAT,TANAH ABANG,KEBON MELATI,3171071005,2020-10-21,972,62,910,6,3,3
DKI JAKARTA,JAKARTA PUSAT,TANAH ABANG,KEBON MELATI,3171071005,2020-10-22,977,53,924,5,-9,14
DKI JAKARTA,JAKARTA PUSAT,TANAH ABANG,KEBON MELATI,3171071005,2020-10-23,983,56,927,6,3,3
DKI JAKARTA,JAKARTA PUSAT,TANAH ABANG,KEBON MELATI,3171071005,2020-10-24,986,51,935,3,-5,8
DKI JAKARTA,JAKARTA PUSAT,TANAH ABANG,KEBON MELATI,3171071005,2020-10-25,990,52,938,4,1,3
DKI JAKARTA,JAKARTA PUSAT,TANAH ABANG,KEBON MELATI,3171071005,2020-10-26,991,50,941,1,-2,3
DKI JAKARTA,JAKARTA PUSAT,TANAH ABANG,KEBON MELATI,3171071005,2020-10-27,993,38,955,2,-12,14
DKI JAKARTA,JAKARTA PUSAT,TANAH ABANG,KEBON MELATI,3171071005,2020-10-28,995,34,961,2,-4,6
DKI JAKARTA,JAKARTA PUSAT,TANAH ABANG,KEBON MELATI,3171071005,2020-10-29,1002,32,970,7,-2,9
DKI JAKARTA,JAKARTA PUSAT,TANAH ABANG,KEBON MELATI,3171071005,2020-10-30,1012,29,983,10,-3,13
DKI JAKARTA,JAKARTA PUSAT,TANAH ABANG,KEBON MELATI,3171071005,2020-10-31,1015,29,986,3,0,3
DKI JAKARTA,JAKARTA PUSAT,TANAH ABANG,PETAMBURAN,3171071004,2020-10-01,506,47,459,0,0,0
DKI JAKARTA,JAKARTA PUSAT,TANAH ABANG,PETAMBURAN,3171071004,2020-10-02,524,59,465,18,12,6
DKI JAKARTA,JAKARTA PUSAT,TANAH ABANG,PETAMBURAN,3171071004,2020-10-03,539,65,474,15,6,9
DKI JAKARTA,JAKARTA PUSAT,TANAH ABANG,PETAMBURAN,3171071004,2020-10-04,560,80,480,21,15,6
DKI JAKARTA,JAKARTA PUSAT,TANAH ABANG,PETAMBURAN,3171071004,2020-10-05,566,80,486,6,0,6
DKI JAKARTA,JAKARTA PUSAT,TANAH ABANG,PETAMBURAN,3171071004,2020-10-06,590,91,499,24,11,13
DKI JAKARTA,JAKARTA PUSAT,TANAH ABANG,PETAMBURAN,3171071004,2020-10-07,637,104,533,47,13,34
DKI JAKARTA,JAKARTA PUSAT,TANAH ABANG,PETAMBURAN,3171071004,2020-10-08,695,116,579,58,12,46
DKI JAKARTA,JAKARTA PUSAT,TANAH ABANG,PETAMBURAN,3171071004,2020-10-09,715,135,580,20,19,1
DKI JAKARTA,JAKARTA PUSAT,TANAH ABANG,PETAMBURAN,3171071004,2020-10-10,727,141,586,12,6,6
DKI JAKARTA,JAKARTA PUSAT,TANAH ABANG,PETAMBURAN,3171071004,2020-10-11,805,159,646,78,18,60
DKI JAKARTA,JAKARTA PUSAT,TANAH ABANG,PETAMBURAN,3171071004,2020-10-12,806,137,669,1,-22,23
DKI JAKARTA,JAKARTA PUSAT,TANAH ABANG,PETAMBURAN,3171071004,2020-10-13,809,111,698,3,-26,29
DKI JAKARTA,JAKARTA PUSAT,TANAH ABANG,PETAMBURAN,3171071004,2020-10-14,849,89,760,40,-22,62
DKI JAKARTA,JAKARTA PUSAT,TANAH ABANG,PETAMBURAN,3171071004,2020-10-15,882,98,784,33,9,24
DKI JAKARTA,JAKARTA PUSAT,TANAH ABANG,PETAMBURAN,3171071004,2020-10-16,887,89,798,5,-9,14
DKI JAKARTA,JAKARTA PUSAT,TANAH ABANG,PETAMBURAN,3171071004,2020-10-17,894,91,803,7,2,5
DKI JAKARTA,JAKARTA PUSAT,TANAH ABANG,PETAMBURAN,3171071004,2020-10-18,900,93,807,6,2,4
DKI JAKARTA,JAKARTA PUSAT,TANAH ABANG,PETAMBURAN,3171071004,2020-10-19,901,74,827,1,-19,20
DKI JAKARTA,JAKARTA PUSAT,TANAH ABANG,PETAMBURAN,3171071004,2020-10-20,910,63,847,9,-11,20
DKI JAKARTA,JAKARTA PUSAT,TANAH ABANG,PETAMBURAN,3171071004,2020-10-21,913,53,860,3,-10,13
DKI JAKARTA,JAKARTA PUSAT,TANAH ABANG,PETAMBURAN,3171071004,2020-10-22,922,43,879,9,-10,19
DKI JAKARTA,JAKARTA PUSAT,TANAH ABANG,PETAMBURAN,3171071004,2020-10-23,931,51,880,9,8,1
DKI JAKARTA,JAKARTA PUSAT,TANAH ABANG,PETAMBURAN,3171071004,2020-10-24,934,49,885,3,-2,5
DKI JAKARTA,JAKARTA PUSAT,TANAH ABANG,PETAMBURAN,3171071004,2020-10-25,936,50,886,2,1,1
DKI JAKARTA,JAKARTA PUSAT,TANAH ABANG,PETAMBURAN,3171071004,2020-10-26,939,50,889,3,0,3
DKI JAKARTA,JAKARTA PUSAT,TANAH ABANG,PETAMBURAN,3171071004,2020-10-27,946,49,897,7,-1,8
DKI JAKARTA,JAKARTA PUSAT,TANAH ABANG,PETAMBURAN,3171071004,2020-10-28,956,48,908,10,-1,11
DKI JAKARTA,JAKARTA PUSAT,TANAH ABANG,PETAMBURAN,3171071004,2020-10-29,958,44,914,2,-4,6
DKI JAKARTA,JAKARTA PUSAT,TANAH ABANG,PETAMBURAN,3171071004,2020-10-30,974,52,922,16,8,8
DKI JAKARTA,JAKARTA PUSAT,TANAH ABANG,PETAMBURAN,3171071004,2020-10-31,977,53,924,3,1,2
DKI JAKARTA,JAKARTA SELATAN,CILANDAK,CILANDAK BARAT,3174061001,2020-10-01,1099,133,966,0,0,0
DKI JAKARTA,JAKARTA SELATAN,CILANDAK,CILANDAK BARAT,3174061001,2020-10-02,1127,149,978,28,16,12
DKI JAKARTA,JAKARTA SELATAN,CILANDAK,CILANDAK BARAT,3174061001,2020-10-03,1140,160,980,13,11,2
DKI JAKARTA,JAKARTA SELATAN,CILANDAK,CILANDAK BARAT,3174061001,2020-10-04,1163,169,994,23,9,14
DKI JAKARTA,JAKARTA SELATAN,CILANDAK,CILANDAK BARAT,3174061001,2020-10-05,1182,170,1012,19,1,18
DKI JAKARTA,JAKARTA SELATAN,CILANDAK,CILANDAK BARAT,3174061001,2020-10-06,1204,180,1024,22,10,12
DKI JAKARTA,JAKARTA SELATAN,CILANDAK,CILANDAK BARAT,3174061001,2020-10-07,1224,184,1040,20,4,16
DKI JAKARTA,JAKARTA SELATAN,CILANDAK,CILANDAK BARAT,3174061001,2020-10-08,1242,181,1061,18,-3,21
DKI JAKARTA,JAKARTA SELATAN,CILANDAK,CILANDAK BARAT,3174061001,2020-10-09,1251,190,1061,9,9,0
DKI JAKARTA,JAKARTA SELATAN,CILANDAK,CILANDAK BARAT,3174061001,2020-10-10,1270,172,1098,19,-18,37
DKI JAKARTA,JAKARTA SELATAN,CILANDAK,CILANDAK BARAT,3174061001,2020-10-11,1312,199,1113,42,27,15
DKI JAKARTA,JAKARTA SELATAN,CILANDAK,CILANDAK BARAT,3174061001,2020-10-12,1326,170,1156,14,-29,43
DKI JAKARTA,JAKARTA SELATAN,CILANDAK,CILANDAK BARAT,3174061001,2020-10-13,1349,158,1191,23,-12,35
DKI JAKARTA,JAKARTA SELATAN,CILANDAK,CILANDAK BARAT,3174061001,2020-10-14,1353,123,1230,4,-35,39
DKI JAKARTA,JAKARTA SELATAN,CILANDAK,CILANDAK BARAT,3174061001,2020-10-15,1361,113,1248,8,-10,18
DKI JAKARTA,JAKARTA SELATAN,CILANDAK,CILANDAK BARAT,3174061001,2020-10-16,1369,114,1255,8,1,7
DKI JAKARTA,JAKARTA SELATAN,CILANDAK,CILANDAK BARAT,3174061001,2020-10-17,1405,147,1258,36,33,3
DKI JAKARTA,JAKARTA SELATAN,CILANDAK,CILANDAK BARAT,3174061001,2020-10-18,1409,148,1261,4,1,3
DKI JAKARTA,JAKARTA SELATAN,CILANDAK,CILANDAK BARAT,3174061001,2020-10-19,1412,127,1285,3,-21,24
DKI JAKARTA,JAKARTA SELATAN,CILANDAK,CILANDAK BARAT,3174061001,2020-10-20,1425,124,1301,13,-3,16
DKI JAKARTA,JAKARTA SELATAN,CILANDAK,CILANDAK BARAT,3174061001,2020-10-21,1452,132,1320,27,8,19
DKI JAKARTA,JAKARTA SELATAN,CILANDAK,CILANDAK BARAT,3174061001,2020-10-22,1462,104,1358,10,-28,38
DKI JAKARTA,JAKARTA SELATAN,CILANDAK,CILANDAK BARAT,3174061001,2020-10-23,1505,143,1362,43,39,4
DKI JAKARTA,JAKARTA SELATAN,CILANDAK,CILANDAK BARAT,3174061001,2020-10-24,1524,146,1378,19,3,16
DKI JAKARTA,JAKARTA SELATAN,CILANDAK,CILANDAK BARAT,3174061001,2020-10-25,1533,152,1381,9,6,3
DKI JAKARTA,JAKARTA SELATAN,CILANDAK,CILANDAK BARAT,3174061001,2020-10-26,1546,146,1400,13,-6,19
DKI JAKARTA,JAKARTA SELATAN,CILANDAK,CILANDAK BARAT,3174061001,2020-10-27,1566,151,1415,20,5,15
DKI JAKARTA,JAKARTA SELATAN,CILANDAK,CILANDAK BARAT,3174061001,2020-10-28,1576,143,1433,10,-8,18
DKI JAKARTA,JAKARTA SELATAN,CILANDAK,CILANDAK BARAT,3174061001,2020-10-29,1581,106,1476,5,-37,43
DKI JAKARTA,JAKARTA SELATAN,CILANDAK,CILANDAK BARAT,3174061001,2020-10-30,1591,107,1485,10,1,9
DKI JAKARTA,JAKARTA SELATAN,CILANDAK,CILANDAK BARAT,3174061001,2020-10-31,1609,121,1489,18,14,4
DKI JAKARTA,JAKARTA SELATAN,CILANDAK,CIPETE SELATAN,3174061005,2020-10-01,369,75,294,0,0,0
DKI JAKARTA,JAKARTA SELATAN,CILANDAK,CIPETE SELATAN,3174061005,2020-10-02,381,85,296,12,10,2
DKI JAKARTA,JAKARTA SELATAN,CILANDAK,CIPETE SELATAN,3174061005,2020-10-03,385,89,296,4,4,0
DKI JAKARTA,JAKARTA SELATAN,CILANDAK,CIPETE SELATAN,3174061005,2020-10-04,389,91,298,4,2,2
DKI JAKARTA,JAKARTA SELATAN,CILANDAK,CIPETE SELATAN,3174061005,2020-10-05,403,84,319,14,-7,21
DKI JAKARTA,JAKARTA SELATAN,CILANDAK,CIPETE SELATAN,3174061005,2020-10-06,415,84,331,12,0,12
DKI JAKARTA,JAKARTA SELATAN,CILANDAK,CIPETE SELATAN,3174061005,2020-10-07,420,84,336,5,0,5
DKI JAKARTA,JAKARTA SELATAN,CILANDAK,CIPETE SELATAN,3174061005,2020-10-08,425,77,348,5,-7,12
DKI JAKARTA,JAKARTA SELATAN,CILANDAK,CIPETE SELATAN,3174061005,2020-10-09,428,80,348,3,3,0
DKI JAKARTA,JAKARTA SELATAN,CILANDAK,CIPETE SELATAN,3174061005,2020-10-10,433,74,359,5,-6,11
DKI JAKARTA,JAKARTA SELATAN,CILANDAK,CIPETE SELATAN,3174061005,2020-10-11,439,79,360,6,5,1
DKI JAKARTA,JAKARTA SELATAN,CILANDAK,CIPETE SELATAN,3174061005,2020-10-12,445,54,391,6,-25,31
DKI JAKARTA,JAKARTA SELATAN,CILANDAK,CIPETE SELATAN,3174061005,2020-10-13,446,49,397,1,-5,6
DKI JAKARTA,JAKARTA SELATAN,CILANDAK,CIPETE SELATAN,3174061005,2020-10-14,449,40,409,3,-9,12
DKI JAKARTA,JAKARTA SELATAN,CILANDAK,CIPETE SELATAN,3174061005,2020-10-15,450,37,413,1,-3,4
DKI JAKARTA,JAKARTA SELATAN,CILANDAK,CIPETE SELATAN,3174061005,2020-10-16,453,25,428,3,-12,15
DKI JAKARTA,JAKARTA SELATAN,CILANDAK,CIPETE SELATAN,3174061005,2020-10-17,466,34,432,13,9,4
DKI JAKARTA,JAKARTA SELATAN,CILANDAK,CIPETE SELATAN,3174061005,2020-10-18,469,35,434,3,1,2
DKI JAKARTA,JAKARTA SELATAN,CILANDAK,CIPETE SELATAN,3174061005,2020-10-19,473,34,439,4,-1,5
DKI JAKARTA,JAKARTA SELATAN,CILANDAK,CIPETE SELATAN,3174061005,2020-10-20,478,35,443,5,1,4
DKI JAKARTA,JAKARTA SELATAN,CILANDAK,CIPETE SELATAN,3174061005,2020-10-21,481,33,448,3,-2,5
DKI JAKARTA,JAKARTA SELATAN,CILANDAK,CIPETE SELATAN,3174061005,2020-10-22,482,29,453,1,-4,5
DKI JAKARTA,JAKARTA SELATAN,CILANDAK,CIPETE SELATAN,3174061005,2020-10-23,502,48,454,20,19,1
DKI JAKARTA,JAKARTA SELATAN,CILANDAK,CIPETE SELATAN,3174061005,2020-10-24,511,53,458,9,5,4
DKI JAKARTA,JAKARTA SELATAN,CILANDAK,CIPETE SELATAN,3174061005,2020-10-25,511,51,460,0,-2,2
DKI JAKARTA,JAKARTA SELATAN,CILANDAK,CIPETE SELATAN,3174061005,2020-10-26,522,59,463,11,8,3
DKI JAKARTA,JAKARTA SELATAN,CILANDAK,CIPETE SELATAN,3174061005,2020-10-27,525,61,464,3,2,1
DKI JAKARTA,JAKARTA SELATAN,CILANDAK,CIPETE SELATAN,3174061005,2020-10-28,526,55,471,1,-6,7
DKI JAKARTA,JAKARTA SELATAN,CILANDAK,CIPETE SELATAN,3174061005,2020-10-29,530,47,483,4,-8,12
DKI JAKARTA,JAKARTA SELATAN,CILANDAK,CIPETE SELATAN,3174061005,2020-10-30,557,68,489,27,21,6
DKI JAKARTA,JAKARTA SELATAN,CILANDAK,CIPETE SELATAN,3174061005,2020-10-31,558,69,489,1,1,0
DKI JAKARTA,JAKARTA SELATAN,CILANDAK,GANDARIA SELATAN,3174061004,2020-10-01,556,44,512,0,0,0
DKI JAKARTA,JAKARTA SELATAN,CILANDAK,GANDARIA SELATAN,3174061004,2020-10-02,563,50,513,7,6,1
DKI JAKARTA,JAKARTA SELATAN,CILANDAK,GANDARIA SELATAN,3174061004,2020-10-03,565,46,519,2,-4,6
DKI JAKARTA,JAKARTA SELATAN,CILANDAK,GANDARIA SELATAN,3174061004,2020-10-04,571,51,520,6,5,1
DKI JAKARTA,JAKARTA SELATAN,CILANDAK,GANDARIA SELATAN,3174061004,2020-10-05,580,53,527,9,2,7
DKI JAKARTA,JAKARTA SELATAN,CILANDAK,GANDARIA SELATAN,3174061004,2020-10-06,584,50,534,4,-3,7
DKI JAKARTA,JAKARTA SELATAN,CILANDAK,GANDARIA SELATAN,3174061004,2020-10-07,588,52,536,4,2,2
DKI JAKARTA,JAKARTA SELATAN,CILANDAK,GANDARIA SELATAN,3174061004,2020-10-08,591,52,539,3,0,3
DKI JAKARTA,JAKARTA SELATAN,CILANDAK,GANDARIA SELATAN,3174061004,2020-10-09,594,55,539,3,3,0
DKI JAKARTA,JAKARTA SELATAN,CILANDAK,GANDARIA SELATAN,3174061004,2020-10-10,597,50,547,3,-5,8
DKI JAKARTA,JAKARTA SELATAN,CILANDAK,GANDARIA SELATAN,3174061004,2020-10-11,605,56,549,8,6,2
DKI JAKARTA,JAKARTA SELATAN,CILANDAK,GANDARIA SELATAN,3174061004,2020-10-12,606,37,569,1,-19,20
DKI JAKARTA,JAKARTA SELATAN,CILANDAK,GANDARIA SELATAN,3174061004,2020-10-13,610,36,574,4,-1,5
DKI JAKARTA,JAKARTA SELATAN,CILANDAK,GANDARIA SELATAN,3174061004,2020-10-14,613,32,581,3,-4,7
DKI JAKARTA,JAKARTA SELATAN,CILANDAK,GANDARIA SELATAN,3174061004,2020-10-15,626,39,587,13,7,6
DKI JAKARTA,JAKARTA SELATAN,CILANDAK,GANDARIA SELATAN,3174061004,2020-10-16,630,37,593,4,-2,6
DKI JAKARTA,JAKARTA SELATAN,CILANDAK,GANDARIA SELATAN,3174061004,2020-10-17,642,48,594,12,11,1
DKI JAKARTA,JAKARTA SELATAN,CILANDAK,GANDARIA SELATAN,3174061004,2020-10-18,648,54,594,6,6,0
DKI JAKARTA,JAKARTA SELATAN,CILANDAK,GANDARIA SELATAN,3174061004,2020-10-19,651,53,598,3,-1,4
DKI JAKARTA,JAKARTA SELATAN,CILANDAK,GANDARIA SELATAN,3174061004,2020-10-20,658,49,609,7,-4,11
DKI JAKARTA,JAKARTA SELATAN,CILANDAK,GANDARIA SELATAN,3174061004,2020-10-21,661,51,610,3,2,1
DKI JAKARTA,JAKARTA SELATAN,CILANDAK,GANDARIA SELATAN,3174061004,2020-10-22,665,53,612,4,2,2
DKI JAKARTA,JAKARTA SELATAN,CILANDAK,GANDARIA SELATAN,3174061004,2020-10-23,670,58,612,5,5,0
DKI JAKARTA,JAKARTA SELATAN,CILANDAK,GANDARIA SELATAN,3174061004,2020-10-24,676,61,615,6,3,3
DKI JAKARTA,JAKARTA SELATAN,CILANDAK,GANDARIA SELATAN,3174061004,2020-10-25,678,61,617,2,0,2
DKI JAKARTA,JAKARTA SELATAN,CILANDAK,GANDARIA SELATAN,3174061004,2020-10-26,680,53,627,2,-8,10
DKI JAKARTA,JAKARTA SELATAN,CILANDAK,GANDARIA SELATAN,3174061004,2020-10-27,694,55,639,14,2,12
DKI JAKARTA,JAKARTA SELATAN,CILANDAK,GANDARIA SELATAN,3174061004,2020-10-28,696,49,647,2,-6,8
DKI JAKARTA,JAKARTA SELATAN,CILANDAK,GANDARIA SELATAN,3174061004,2020-10-29,700,42,658,4,-7,11
DKI JAKARTA,JAKARTA SELATAN,CILANDAK,GANDARIA SELATAN,3174061004,2020-10-30,705,39,666,5,-3,8
DKI JAKARTA,JAKARTA SELATAN,CILANDAK,GANDARIA SELATAN,3174061004,2020-10-31,707,40,667,2,1,1
DKI JAKARTA,JAKARTA SELATAN,CILANDAK,LEBAK BULUS,3174061002,2020-10-01,600,83,517,0,0,0
DKI JAKARTA,JAKARTA SELATAN,CILANDAK,LEBAK BULUS,3174061002,2020-10-02,733,210,523,133,127,6
DKI JAKARTA,JAKARTA SELATAN,CILANDAK,LEBAK BULUS,3174061002,2020-10-03,744,219,525,11,9,2
DKI JAKARTA,JAKARTA SELATAN,CILANDAK,LEBAK BULUS,3174061002,2020-10-04,758,223,535,14,4,10
DKI JAKARTA,JAKARTA SELATAN,CILANDAK,LEBAK BULUS,3174061002,2020-10-05,766,221,545,8,-2,10
DKI JAKARTA,JAKARTA SELATAN,CILANDAK,LEBAK BULUS,3174061002,2020-10-06,821,253,568,55,32,23
DKI JAKARTA,JAKARTA SELATAN,CILANDAK,LEBAK BULUS,3174061002,2020-10-07,829,253,576,8,0,8
DKI JAKARTA,JAKARTA SELATAN,CILANDAK,LEBAK BULUS,3174061002,2020-10-08,837,256,581,8,3,5
DKI JAKARTA,JAKARTA SELATAN,CILANDAK,LEBAK BULUS,3174061002,2020-10-09,845,264,581,8,8,0
DKI JAKARTA,JAKARTA SELATAN,CILANDAK,LEBAK BULUS,3174061002,2020-10-10,852,248,604,7,-16,23
DKI JAKARTA,JAKARTA SELATAN,CILANDAK,LEBAK BULUS,3174061002,2020-10-11,928,321,607,76,73,3
DKI JAKARTA,JAKARTA SELATAN,CILANDAK,LEBAK BULUS,3174061002,2020-10-12,938,225,713,10,-96,106
DKI JAKARTA,JAKARTA SELATAN,CILANDAK,LEBAK BULUS,3174061002,2020-10-13,943,77,866,5,-148,153
DKI JAKARTA,JAKARTA SELATAN,CILANDAK,LEBAK BULUS,3174061002,2020-10-14,961,65,896,18,-12,30
DKI JAKARTA,JAKARTA SELATAN,CILANDAK,LEBAK BULUS,3174061002,2020-10-15,967,56,911,6,-9,15
DKI JAKARTA,JAKARTA SELATAN,CILANDAK,LEBAK BULUS,3174061002,2020-10-16,975,57,918,8,1,7
DKI JAKARTA,JAKARTA SELATAN,CILANDAK,LEBAK BULUS,3174061002,2020-10-17,984,58,926,9,1,8
DKI JAKARTA,JAKARTA SELATAN,CILANDAK,LEBAK BULUS,3174061002,2020-10-18,994,64,930,10,6,4
DKI JAKARTA,JAKARTA SELATAN,CILANDAK,LEBAK BULUS,3174061002,2020-10-19,1002,63,939,8,-1,9
DKI JAKARTA,JAKARTA SELATAN,CILANDAK,LEBAK BULUS,3174061002,2020-10-20,1009,55,954,7,-8,15
DKI JAKARTA,JAKARTA SELATAN,CILANDAK,LEBAK BULUS,3174061002,2020-10-21,1022,64,958,13,9,4
DKI JAKARTA,JAKARTA SELATAN,CILANDAK,LEBAK BULUS,3174061002,2020-10-22,1027,56,971,5,-8,13
DKI JAKARTA,JAKARTA SELATAN,CILANDAK,LEBAK BULUS,3174061002,2020-10-23,1036,65,971,9,9,0
DKI JAKARTA,JAKARTA SELATAN,CILANDAK,LEBAK BULUS,3174061002,2020-10-24,1038,57,981,2,-8,10
DKI JAKARTA,JAKARTA SELATAN,CILANDAK,LEBAK BULUS,3174061002,2020-10-25,1058,73,985,20,16,4
DKI JAKARTA,JAKARTA SELATAN,CILANDAK,LEBAK BULUS,3174061002,2020-10-26,1066,62,1004,8,-11,19
DKI JAKARTA,JAKARTA SELATAN,CILANDAK,LEBAK BULUS,3174061002,2020-10-27,1074,64,1010,8,2,6
DKI JAKARTA,JAKARTA SELATAN,CILANDAK,LEBAK BULUS,3174061002,2020-10-28,1077,62,1015,3,-2,5
DKI JAKARTA,JAKARTA SELATAN,CILANDAK,LEBAK BULUS,3174061002,2020-10-29,1082,59,1023,5,-3,8
DKI JAKARTA,JAKARTA SELATAN,CILANDAK,LEBAK BULUS,3174061002,2020-10-30,1092,59,1033,10,0,10
DKI JAKARTA,JAKARTA SELATAN,CILANDAK,LEBAK BULUS,3174061002,2020-10-31,1107,74,1033,15,15,0
DKI JAKARTA,JAKARTA SELATAN,CILANDAK,PONDOK LABU,3174061003,2020-10-01,883,111,772,0,0,0
DKI JAKARTA,JAKARTA SELATAN,CILANDAK,PONDOK LABU,3174061003,2020-10-02,899,111,788,16,0,16
DKI JAKARTA,JAKARTA SELATAN,CILANDAK,PONDOK LABU,3174061003,2020-10-03,911,121,790,12,10,2
DKI JAKARTA,JAKARTA SELATAN,CILANDAK,PONDOK LABU,3174061003,2020-10-04,926,128,798,15,7,8
DKI JAKARTA,JAKARTA SELATAN,CILANDAK,PONDOK LABU,3174061003,2020-10-05,933,125,808,7,-3,10
DKI JAKARTA,JAKARTA SELATAN,CILANDAK,PONDOK LABU,3174061003,2020-10-06,942,114,828,9,-11,20
DKI JAKARTA,JAKARTA SELATAN,CILANDAK,PONDOK LABU,3174061003,2020-10-07,951,108,843,9,-6,15
DKI JAKARTA,JAKARTA SELATAN,CILANDAK,PONDOK LABU,3174061003,2020-10-08,974,119,855,23,11,12
DKI JAKARTA,JAKARTA SELATAN,CILANDAK,PONDOK LABU,3174061003,2020-10-09,988,132,856,14,13,1
DKI JAKARTA,JAKARTA SELATAN,CILANDAK,PONDOK LABU,3174061003,2020-10-10,999,115,884,11,-17,28
DKI JAKARTA,JAKARTA SELATAN,CILANDAK,PONDOK LABU,3174061003,2020-10-11,1022,133,889,23,18,5
DKI JAKARTA,JAKARTA SELATAN,CILANDAK,PONDOK LABU,3174061003,2020-10-12,1029,118,911,7,-15,22
DKI JAKARTA,JAKARTA SELATAN,CILANDAK,PONDOK LABU,3174061003,2020-10-13,1033,103,930,4,-15,19
DKI JAKARTA,JAKARTA SELATAN,CILANDAK,PONDOK LABU,3174061003,2020-10-14,1039,93,946,6,-10,16
DKI JAKARTA,JAKARTA SELATAN,CILANDAK,PONDOK LABU,3174061003,2020-10-15,1054,103,951,15,10,5
DKI JAKARTA,JAKARTA SELATAN,CILANDAK,PONDOK LABU,3174061003,2020-10-16,1060,96,964,6,-7,13
DKI JAKARTA,JAKARTA SELATAN,CILANDAK,PONDOK LABU,3174061003,2020-10-17,1087,118,969,27,22,5
DKI JAKARTA,JAKARTA SELATAN,CILANDAK,PONDOK LABU,3174061003,2020-10-18,1093,122,971,6,4,2
DKI JAKARTA,JAKARTA SELATAN,CILANDAK,PONDOK LABU,3174061003,2020-10-19,1099,109,990,6,-13,19
DKI JAKARTA,JAKARTA SELATAN,CILANDAK,PONDOK LABU,3174061003,2020-10-20,1106,97,1009,7,-12,19
DKI JAKARTA,JAKARTA SELATAN,CILANDAK,PONDOK LABU,3174061003,2020-10-21,1119,99,1020,13,2,11
DKI JAKARTA,JAKARTA SELATAN,CILANDAK,PONDOK LABU,3174061003,2020-10-22,1146,110,1036,27,11,16
DKI JAKARTA,JAKARTA SELATAN,CILANDAK,PONDOK LABU,3174061003,2020-10-23,1166,129,1037,20,19,1
DKI JAKARTA,JAKARTA SELATAN,CILANDAK,PONDOK LABU,3174061003,2020-10-24,1177,123,1054,11,-6,17
DKI JAKARTA,JAKARTA SELATAN,CILANDAK,PONDOK LABU,3174061003,2020-10-25,1181,123,1058,4,0,4
DKI JAKARTA,JAKARTA SELATAN,CILANDAK,PONDOK LABU,3174061003,2020-10-26,1187,114,1073,6,-9,15
DKI JAKARTA,JAKARTA SELATAN,CILANDAK,PONDOK LABU,3174061003,2020-10-27,1202,124,1078,15,10,5
DKI JAKARTA,JAKARTA SELATAN,CILANDAK,PONDOK LABU,3174061003,2020-10-28,1205,109,1096,3,-15,18
DKI JAKARTA,JAKARTA SELATAN,CILANDAK,PONDOK LABU,3174061003,2020-10-29,1207,91,1116,2,-18,20
DKI JAKARTA,JAKARTA SELATAN,CILANDAK,PONDOK LABU,3174061003,2020-10-30,1217,92,1125,10,1,9
DKI JAKARTA,JAKARTA SELATAN,CILANDAK,PONDOK LABU,3174061003,2020-10-31,1228,102,1126,11,10,1
DKI JAKARTA,JAKARTA SELATAN,JAGAKARSA,CIGANJUR,3174091003,2020-10-01,463,51,412,0,0,0
DKI JAKARTA,JAKARTA SELATAN,JAGAKARSA,CIGANJUR,3174091003,2020-10-02,484,67,417,21,16,5
DKI JAKARTA,JAKARTA SELATAN,JAGAKARSA,CIGANJUR,3174091003,2020-10-03,485,71,414,1,4,-3
DKI JAKARTA,JAKARTA SELATAN,JAGAKARSA,CIGANJUR,3174091003,2020-10-04,502,78,424,17,7,10
DKI JAKARTA,JAKARTA SELATAN,JAGAKARSA,CIGANJUR,3174091003,2020-10-05,505,77,428,3,-1,4
DKI JAKARTA,JAKARTA SELATAN,JAGAKARSA,CIGANJUR,3174091003,2020-10-06,512,74,438,7,-3,10
DKI JAKARTA,JAKARTA SELATAN,JAGAKARSA,CIGANJUR,3174091003,2020-10-07,522,77,445,10,3,7
DKI JAKARTA,JAKARTA SELATAN,JAGAKARSA,CIGANJUR,3174091003,2020-10-08,536,84,452,14,7,7
DKI JAKARTA,JAKARTA SELATAN,JAGAKARSA,CIGANJUR,3174091003,2020-10-09,542,90,452,6,6,0
DKI JAKARTA,JAKARTA SELATAN,JAGAKARSA,CIGANJUR,3174091003,2020-10-10,560,95,465,18,5,13
DKI JAKARTA,JAKARTA SELATAN,JAGAKARSA,CIGANJUR,3174091003,2020-10-11,578,108,470,18,13,5
DKI JAKARTA,JAKARTA SELATAN,JAGAKARSA,CIGANJUR,3174091003,2020-10-12,585,87,498,7,-21,28
DKI JAKARTA,JAKARTA SELATAN,JAGAKARSA,CIGANJUR,3174091003,2020-10-13,597,89,508,12,2,10
DKI JAKARTA,JAKARTA SELATAN,JAGAKARSA,CIGANJUR,3174091003,2020-10-14,599,85,514,2,-4,6
DKI JAKARTA,JAKARTA SELATAN,JAGAKARSA,CIGANJUR,3174091003,2020-10-15,633,107,526,34,22,12
DKI JAKARTA,JAKARTA SELATAN,JAGAKARSA,CIGANJUR,3174091003,2020-10-16,636,101,535,3,-6,9
DKI JAKARTA,JAKARTA SELATAN,JAGAKARSA,CIGANJUR,3174091003,2020-10-17,644,106,538,8,5,3
DKI JAKARTA,JAKARTA SELATAN,JAGAKARSA,CIGANJUR,3174091003,2020-10-18,649,109,540,5,3,2
DKI JAKARTA,JAKARTA SELATAN,JAGAKARSA,CIGANJUR,3174091003,2020-10-19,652,100,552,3,-9,12
DKI JAKARTA,JAKARTA SELATAN,JAGAKARSA,CIGANJUR,3174091003,2020-10-20,654,88,566,2,-12,14
DKI JAKARTA,JAKARTA SELATAN,JAGAKARSA,CIGANJUR,3174091003,2020-10-21,668,88,580,14,0,14
DKI JAKARTA,JAKARTA SELATAN,JAGAKARSA,CIGANJUR,3174091003,2020-10-22,679,76,603,11,-12,23
DKI JAKARTA,JAKARTA SELATAN,JAGAKARSA,CIGANJUR,3174091003,2020-10-23,682,79,603,3,3,0
DKI JAKARTA,JAKARTA SELATAN,JAGAKARSA,CIGANJUR,3174091003,2020-10-24,691,79,612,9,0,9
DKI JAKARTA,JAKARTA SELATAN,JAGAKARSA,CIGANJUR,3174091003,2020-10-25,697,85,612,6,6,0
DKI JAKARTA,JAKARTA SELATAN,JAGAKARSA,CIGANJUR,3174091003,2020-10-26,707,81,626,10,-4,14
DKI JAKARTA,JAKARTA SELATAN,JAGAKARSA,CIGANJUR,3174091003,2020-10-27,720,81,639,13,0,13
DKI JAKARTA,JAKARTA SELATAN,JAGAKARSA,CIGANJUR,3174091003,2020-10-28,743,88,655,23,7,16
DKI JAKARTA,JAKARTA SELATAN,JAGAKARSA,CIGANJUR,3174091003,2020-10-29,761,90,671,18,2,16
DKI JAKARTA,JAKARTA SELATAN,JAGAKARSA,CIGANJUR,3174091003,2020-10-30,774,101,673,13,11,2
DKI JAKARTA,JAKARTA SELATAN,JAGAKARSA,CIGANJUR,3174091003,2020-10-31,779,103,676,5,2,3
DKI JAKARTA,JAKARTA SELATAN,JAGAKARSA,CIPEDAK,3174091006,2020-10-01,539,212,327,0,0,0
DKI JAKARTA,JAKARTA SELATAN,JAGAKARSA,CIPEDAK,3174091006,2020-10-02,548,203,345,9,-9,18
DKI JAKARTA,JAKARTA SELATAN,JAGAKARSA,CIPEDAK,3174091006,2020-10-03,562,215,347,14,12,2
DKI JAKARTA,JAKARTA SELATAN,JAGAKARSA,CIPEDAK,3174091006,2020-10-04,582,223,359,20,8,12
DKI JAKARTA,JAKARTA SELATAN,JAGAKARSA,CIPEDAK,3174091006,2020-10-05,583,219,364,1,-4,5
DKI JAKARTA,JAKARTA SELATAN,JAGAKARSA,CIPEDAK,3174091006,2020-10-06,607,227,380,24,8,16
DKI JAKARTA,JAKARTA SELATAN,JAGAKARSA,CIPEDAK,3174091006,2020-10-07,614,226,388,7,-1,8
DKI JAKARTA,JAKARTA SELATAN,JAGAKARSA,CIPEDAK,3174091006,2020-10-08,629,222,407,15,-4,19
DKI JAKARTA,JAKARTA SELATAN,JAGAKARSA,CIPEDAK,3174091006,2020-10-09,635,225,410,6,3,3
DKI JAKARTA,JAKARTA SELATAN,JAGAKARSA,CIPEDAK,3174091006,2020-10-10,643,76,567,8,-149,157
DKI JAKARTA,JAKARTA SELATAN,JAGAKARSA,CIPEDAK,3174091006,2020-10-11,675,86,589,32,10,22
DKI JAKARTA,JAKARTA SELATAN,JAGAKARSA,CIPEDAK,3174091006,2020-10-12,683,77,606,8,-9,17
DKI JAKARTA,JAKARTA SELATAN,JAGAKARSA,CIPEDAK,3174091006,2020-10-13,689,66,623,6,-11,17
DKI JAKARTA,JAKARTA SELATAN,JAGAKARSA,CIPEDAK,3174091006,2020-10-14,689,54,635,0,-12,12
DKI JAKARTA,JAKARTA SELATAN,JAGAKARSA,CIPEDAK,3174091006,2020-10-15,698,46,652,9,-8,17
DKI JAKARTA,JAKARTA SELATAN,JAGAKARSA,CIPEDAK,3174091006,2020-10-16,703,43,660,5,-3,8
DKI JAKARTA,JAKARTA SELATAN,JAGAKARSA,CIPEDAK,3174091006,2020-10-17,709,47,662,6,4,2
DKI JAKARTA,JAKARTA SELATAN,JAGAKARSA,CIPEDAK,3174091006,2020-10-18,715,51,664,6,4,2
DKI JAKARTA,JAKARTA SELATAN,JAGAKARSA,CIPEDAK,3174091006,2020-10-19,718,50,668,3,-1,4
DKI JAKARTA,JAKARTA SELATAN,JAGAKARSA,CIPEDAK,3174091006,2020-10-20,727,55,672,9,5,4
DKI JAKARTA,JAKARTA SELATAN,JAGAKARSA,CIPEDAK,3174091006,2020-10-21,734,53,681,7,-2,9
DKI JAKARTA,JAKARTA SELATAN,JAGAKARSA,CIPEDAK,3174091006,2020-10-22,734,45,689,0,-8,8
DKI JAKARTA,JAKARTA SELATAN,JAGAKARSA,CIPEDAK,3174091006,2020-10-23,751,61,690,17,16,1
DKI JAKARTA,JAKARTA SELATAN,JAGAKARSA,CIPEDAK,3174091006,2020-10-24,769,54,715,18,-7,25
DKI JAKARTA,JAKARTA SELATAN,JAGAKARSA,CIPEDAK,3174091006,2020-10-25,774,58,716,5,4,1
DKI JAKARTA,JAKARTA SELATAN,JAGAKARSA,CIPEDAK,3174091006,2020-10-26,779,51,728,5,-7,12
DKI JAKARTA,JAKARTA SELATAN,JAGAKARSA,CIPEDAK,3174091006,2020-10-27,783,52,731,4,1,3
DKI JAKARTA,JAKARTA SELATAN,JAGAKARSA,CIPEDAK,3174091006,2020-10-28,791,57,734,8,5,3
DKI JAKARTA,JAKARTA SELATAN,JAGAKARSA,CIPEDAK,3174091006,2020-10-29,810,46,764,19,-11,30
DKI JAKARTA,JAKARTA SELATAN,JAGAKARSA,CIPEDAK,3174091006,2020-10-30,827,60,767,17,14,3
DKI JAKARTA,JAKARTA SELATAN,JAGAKARSA,CIPEDAK,3174091006,2020-10-31,838,70,768,11,10,1
DKI JAKARTA,JAKARTA SELATAN,JAGAKARSA,JAGAKARSA,3174091001,2020-10-01,832,107,725,0,0,0
DKI JAKARTA,JAKARTA SELATAN,JAGAKARSA,JAGAKARSA,3174091001,2020-10-02,843,97,746,11,-10,21
DKI JAKARTA,JAKARTA SELATAN,JAGAKARSA,JAGAKARSA,3174091001,2020-10-03,876,127,749,33,30,3
DKI JAKARTA,JAKARTA SELATAN,JAGAKARSA,JAGAKARSA,3174091001,2020-10-04,892,140,752,16,13,3
DKI JAKARTA,JAKARTA SELATAN,JAGAKARSA,JAGAKARSA,3174091001,2020-10-05,901,142,759,9,2,7
DKI JAKARTA,JAKARTA SELATAN,JAGAKARSA,JAGAKARSA,3174091001,2020-10-06,938,154,784,37,12,25
DKI JAKARTA,JAKARTA SELATAN,JAGAKARSA,JAGAKARSA,3174091001,2020-10-07,955,151,804,17,-3,20
DKI JAKARTA,JAKARTA SELATAN,JAGAKARSA,JAGAKARSA,3174091001,2020-10-08,971,147,824,16,-4,20
DKI JAKARTA,JAKARTA SELATAN,JAGAKARSA,JAGAKARSA,3174091001,2020-10-09,982,158,824,11,11,0
DKI JAKARTA,JAKARTA SELATAN,JAGAKARSA,JAGAKARSA,3174091001,2020-10-10,989,144,845,7,-14,21
DKI JAKARTA,JAKARTA SELATAN,JAGAKARSA,JAGAKARSA,3174091001,2020-10-11,1001,151,850,12,7,5
DKI JAKARTA,JAKARTA SELATAN,JAGAKARSA,JAGAKARSA,3174091001,2020-10-12,1015,138,877,14,-13,27
DKI JAKARTA,JAKARTA SELATAN,JAGAKARSA,JAGAKARSA,3174091001,2020-10-13,1022,101,921,7,-37,44
DKI JAKARTA,JAKARTA SELATAN,JAGAKARSA,JAGAKARSA,3174091001,2020-10-14,1023,78,945,1,-23,24
DKI JAKARTA,JAKARTA SELATAN,JAGAKARSA,JAGAKARSA,3174091001,2020-10-15,1033,69,964,10,-9,19
DKI JAKARTA,JAKARTA SELATAN,JAGAKARSA,JAGAKARSA,3174091001,2020-10-16,1041,64,977,8,-5,13
DKI JAKARTA,JAKARTA SELATAN,JAGAKARSA,JAGAKARSA,3174091001,2020-10-17,1063,85,978,22,21,1
DKI JAKARTA,JAKARTA SELATAN,JAGAKARSA,JAGAKARSA,3174091001,2020-10-18,1075,93,982,12,8,4
DKI JAKARTA,JAKARTA SELATAN,JAGAKARSA,JAGAKARSA,3174091001,2020-10-19,1082,87,995,7,-6,13
DKI JAKARTA,JAKARTA SELATAN,JAGAKARSA,JAGAKARSA,3174091001,2020-10-20,1087,78,1009,5,-9,14
DKI JAKARTA,JAKARTA SELATAN,JAGAKARSA,JAGAKARSA,3174091001,2020-10-21,1102,80,1022,15,2,13
DKI JAKARTA,JAKARTA SELATAN,JAGAKARSA,JAGAKARSA,3174091001,2020-10-22,1115,82,1033,13,2,11
DKI JAKARTA,JAKARTA SELATAN,JAGAKARSA,JAGAKARSA,3174091001,2020-10-23,1130,96,1034,15,14,1
DKI JAKARTA,JAKARTA SELATAN,JAGAKARSA,JAGAKARSA,3174091001,2020-10-24,1139,77,1062,9,-19,28
DKI JAKARTA,JAKARTA SELATAN,JAGAKARSA,JAGAKARSA,3174091001,2020-10-25,1144,78,1066,5,1,4
DKI JAKARTA,JAKARTA SELATAN,JAGAKARSA,JAGAKARSA,3174091001,2020-10-26,1155,79,1076,11,1,10
DKI JAKARTA,JAKARTA SELATAN,JAGAKARSA,JAGAKARSA,3174091001,2020-10-27,1159,82,1077,4,3,1
DKI JAKARTA,JAKARTA SELATAN,JAGAKARSA,JAGAKARSA,3174091001,2020-10-28,1168,84,1084,9,2,7
DKI JAKARTA,JAKARTA SELATAN,JAGAKARSA,JAGAKARSA,3174091001,2020-10-29,1179,64,1115,11,-20,31
DKI JAKARTA,JAKARTA SELATAN,JAGAKARSA,JAGAKARSA,3174091001,2020-10-30,1203,86,1117,24,22,2
DKI JAKARTA,JAKARTA SELATAN,JAGAKARSA,JAGAKARSA,3174091001,2020-10-31,1214,96,1118,11,10,1
DKI JAKARTA,JAKARTA SELATAN,JAGAKARSA,LENTENG AGUNG,3174091004,2020-10-01,507,68,439,0,0,0
DKI JAKARTA,JAKARTA SELATAN,JAGAKARSA,LENTENG AGUNG,3174091004,2020-10-02,520,74,446,13,6,7
DKI JAKARTA,JAKARTA SELATAN,JAGAKARSA,LENTENG AGUNG,3174091004,2020-10-03,529,83,446,9,9,0
DKI JAKARTA,JAKARTA SELATAN,JAGAKARSA,LENTENG AGUNG,3174091004,2020-10-04,540,92,448,11,9,2
DKI JAKARTA,JAKARTA SELATAN,JAGAKARSA,LENTENG AGUNG,3174091004,2020-10-05,541,89,452,1,-3,4
DKI JAKARTA,JAKARTA SELATAN,JAGAKARSA,LENTENG AGUNG,3174091004,2020-10-06,546,88,458,5,-1,6
DKI JAKARTA,JAKARTA SELATAN,JAGAKARSA,LENTENG AGUNG,3174091004,2020-10-07,568,93,475,22,5,17
DKI JAKARTA,JAKARTA SELATAN,JAGAKARSA,LENTENG AGUNG,3174091004,2020-10-08,577,77,500,9,-16,25
DKI JAKARTA,JAKARTA SELATAN,JAGAKARSA,LENTENG AGUNG,3174091004,2020-10-09,588,87,501,11,10,1
DKI JAKARTA,JAKARTA SELATAN,JAGAKARSA,LENTENG AGUNG,3174091004,2020-10-10,599,83,516,11,-4,15
DKI JAKARTA,JAKARTA SELATAN,JAGAKARSA,LENTENG AGUNG,3174091004,2020-10-11,620,100,520,21,17,4
DKI JAKARTA,JAKARTA SELATAN,JAGAKARSA,LENTENG AGUNG,3174091004,2020-10-12,625,90,535,5,-10,15
DKI JAKARTA,JAKARTA SELATAN,JAGAKARSA,LENTENG AGUNG,3174091004,2020-10-13,632,88,544,7,-2,9
DKI JAKARTA,JAKARTA SELATAN,JAGAKARSA,LENTENG AGUNG,3174091004,2020-10-14,636,67,569,4,-21,25
DKI JAKARTA,JAKARTA SELATAN,JAGAKARSA,LENTENG AGUNG,3174091004,2020-10-15,667,94,573,31,27,4
DKI JAKARTA,JAKARTA SELATAN,JAGAKARSA,LENTENG AGUNG,3174091004,2020-10-16,669,93,576,2,-1,3
DKI JAKARTA,JAKARTA SELATAN,JAGAKARSA,LENTENG AGUNG,3174091004,2020-10-17,686,108,578,17,15,2
DKI JAKARTA,JAKARTA SELATAN,JAGAKARSA,LENTENG AGUNG,3174091004,2020-10-18,690,108,582,4,0,4
DKI JAKARTA,JAKARTA SELATAN,JAGAKARSA,LENTENG AGUNG,3174091004,2020-10-19,695,90,605,5,-18,23
DKI JAKARTA,JAKARTA SELATAN,JAGAKARSA,LENTENG AGUNG,3174091004,2020-10-20,701,80,621,6,-10,16
DKI JAKARTA,JAKARTA SELATAN,JAGAKARSA,LENTENG AGUNG,3174091004,2020-10-21,713,81,632,12,1,11
DKI JAKARTA,JAKARTA SELATAN,JAGAKARSA,LENTENG AGUNG,3174091004,2020-10-22,720,72,648,7,-9,16
DKI JAKARTA,JAKARTA SELATAN,JAGAKARSA,LENTENG AGUNG,3174091004,2020-10-23,741,90,651,21,18,3
DKI JAKARTA,JAKARTA SELATAN,JAGAKARSA,LENTENG AGUNG,3174091004,2020-10-24,752,82,670,11,-8,19
DKI JAKARTA,JAKARTA SELATAN,JAGAKARSA,LENTENG AGUNG,3174091004,2020-10-25,755,85,670,3,3,0
DKI JAKARTA,JAKARTA SELATAN,JAGAKARSA,LENTENG AGUNG,3174091004,2020-10-26,761,67,694,6,-18,24
DKI JAKARTA,JAKARTA SELATAN,JAGAKARSA,LENTENG AGUNG,3174091004,2020-10-27,766,68,698,5,1,4
DKI JAKARTA,JAKARTA SELATAN,JAGAKARSA,LENTENG AGUNG,3174091004,2020-10-28,774,71,703,8,3,5
DKI JAKARTA,JAKARTA SELATAN,JAGAKARSA,LENTENG AGUNG,3174091004,2020-10-29,778,56,722,4,-15,19
DKI JAKARTA,JAKARTA SELATAN,JAGAKARSA,LENTENG AGUNG,3174091004,2020-10-30,787,61,726,9,5,4
DKI JAKARTA,JAKARTA SELATAN,JAGAKARSA,LENTENG AGUNG,3174091004,2020-10-31,794,67,727,7,6,1
DKI JAKARTA,JAKARTA SELATAN,JAGAKARSA,SRENGSENG SAWAH,3174091002,2020-10-01,644,59,585,0,0,0
DKI JAKARTA,JAKARTA SELATAN,JAGAKARSA,SRENGSENG SAWAH,3174091002,2020-10-02,654,65,589,10,6,4
DKI JAKARTA,JAKARTA SELATAN,JAGAKARSA,SRENGSENG SAWAH,3174091002,2020-10-03,674,89,585,20,24,-4
DKI JAKARTA,JAKARTA SELATAN,JAGAKARSA,SRENGSENG SAWAH,3174091002,2020-10-04,700,105,595,26,16,10
DKI JAKARTA,JAKARTA SELATAN,JAGAKARSA,SRENGSENG SAWAH,3174091002,2020-10-05,703,101,602,3,-4,7
DKI JAKARTA,JAKARTA SELATAN,JAGAKARSA,SRENGSENG SAWAH,3174091002,2020-10-06,732,122,610,29,21,8
DKI JAKARTA,JAKARTA SELATAN,JAGAKARSA,SRENGSENG SAWAH,3174091002,2020-10-07,748,128,620,16,6,10
DKI JAKARTA,JAKARTA SELATAN,JAGAKARSA,SRENGSENG SAWAH,3174091002,2020-10-08,763,124,639,15,-4,19
DKI JAKARTA,JAKARTA SELATAN,JAGAKARSA,SRENGSENG SAWAH,3174091002,2020-10-09,787,147,640,24,23,1
DKI JAKARTA,JAKARTA SELATAN,JAGAKARSA,SRENGSENG SAWAH,3174091002,2020-10-10,797,140,657,10,-7,17
DKI JAKARTA,JAKARTA SELATAN,JAGAKARSA,SRENGSENG SAWAH,3174091002,2020-10-11,812,149,663,15,9,6
DKI JAKARTA,JAKARTA SELATAN,JAGAKARSA,SRENGSENG SAWAH,3174091002,2020-10-12,835,159,676,23,10,13
DKI JAKARTA,JAKARTA SELATAN,JAGAKARSA,SRENGSENG SAWAH,3174091002,2020-10-13,849,126,723,14,-33,47
DKI JAKARTA,JAKARTA SELATAN,JAGAKARSA,SRENGSENG SAWAH,3174091002,2020-10-14,850,108,742,1,-18,19
DKI JAKARTA,JAKARTA SELATAN,JAGAKARSA,SRENGSENG SAWAH,3174091002,2020-10-15,868,105,763,18,-3,21
DKI JAKARTA,JAKARTA SELATAN,JAGAKARSA,SRENGSENG SAWAH,3174091002,2020-10-16,874,100,774,6,-5,11
DKI JAKARTA,JAKARTA SELATAN,JAGAKARSA,SRENGSENG SAWAH,3174091002,2020-10-17,893,119,774,19,19,0
DKI JAKARTA,JAKARTA SELATAN,JAGAKARSA,SRENGSENG SAWAH,3174091002,2020-10-18,902,127,775,9,8,1
DKI JAKARTA,JAKARTA SELATAN,JAGAKARSA,SRENGSENG SAWAH,3174091002,2020-10-19,904,108,796,2,-19,21
DKI JAKARTA,JAKARTA SELATAN,JAGAKARSA,SRENGSENG SAWAH,3174091002,2020-10-20,911,111,800,7,3,4
DKI JAKARTA,JAKARTA SELATAN,JAGAKARSA,SRENGSENG SAWAH,3174091002,2020-10-21,912,100,812,1,-11,12
DKI JAKARTA,JAKARTA SELATAN,JAGAKARSA,SRENGSENG SAWAH,3174091002,2020-10-22,921,86,835,9,-14,23
DKI JAKARTA,JAKARTA SELATAN,JAGAKARSA,SRENGSENG SAWAH,3174091002,2020-10-23,955,118,837,34,32,2
DKI JAKARTA,JAKARTA SELATAN,JAGAKARSA,SRENGSENG SAWAH,3174091002,2020-10-24,960,69,891,5,-49,54
DKI JAKARTA,JAKARTA SELATAN,JAGAKARSA,SRENGSENG SAWAH,3174091002,2020-10-25,969,76,893,9,7,2
DKI JAKARTA,JAKARTA SELATAN,JAGAKARSA,SRENGSENG SAWAH,3174091002,2020-10-26,977,77,900,8,1,7
DKI JAKARTA,JAKARTA SELATAN,JAGAKARSA,SRENGSENG SAWAH,3174091002,2020-10-27,986,75,911,9,-2,11
DKI JAKARTA,JAKARTA SELATAN,JAGAKARSA,SRENGSENG SAWAH,3174091002,2020-10-28,1000,73,927,14,-2,16
DKI JAKARTA,JAKARTA SELATAN,JAGAKARSA,SRENGSENG SAWAH,3174091002,2020-10-29,1034,52,982,34,-21,55
DKI JAKARTA,JAKARTA SELATAN,JAGAKARSA,SRENGSENG SAWAH,3174091002,2020-10-30,1068,77,991,34,25,9
DKI JAKARTA,JAKARTA SELATAN,JAGAKARSA,SRENGSENG SAWAH,3174091002,2020-10-31,1078,86,992,10,9,1
DKI JAKARTA,JAKARTA SELATAN,JAGAKARSA,TANJUNG BARAT,3174091005,2020-10-01,420,47,373,0,0,0
DKI JAKARTA,JAKARTA SELATAN,JAGAKARSA,TANJUNG BARAT,3174091005,2020-10-02,430,49,381,10,2,8
DKI JAKARTA,JAKARTA SELATAN,JAGAKARSA,TANJUNG BARAT,3174091005,2020-10-03,433,51,382,3,2,1
DKI JAKARTA,JAKARTA SELATAN,JAGAKARSA,TANJUNG BARAT,3174091005,2020-10-04,450,67,383,17,16,1
DKI JAKARTA,JAKARTA SELATAN,JAGAKARSA,TANJUNG BARAT,3174091005,2020-10-05,451,64,387,1,-3,4
DKI JAKARTA,JAKARTA SELATAN,JAGAKARSA,TANJUNG BARAT,3174091005,2020-10-06,457,64,393,6,0,6
DKI JAKARTA,JAKARTA SELATAN,JAGAKARSA,TANJUNG BARAT,3174091005,2020-10-07,474,74,400,17,10,7
DKI JAKARTA,JAKARTA SELATAN,JAGAKARSA,TANJUNG BARAT,3174091005,2020-10-08,483,68,415,9,-6,15
DKI JAKARTA,JAKARTA SELATAN,JAGAKARSA,TANJUNG BARAT,3174091005,2020-10-09,490,75,415,7,7,0
DKI JAKARTA,JAKARTA SELATAN,JAGAKARSA,TANJUNG BARAT,3174091005,2020-10-10,495,73,422,5,-2,7
DKI JAKARTA,JAKARTA SELATAN,JAGAKARSA,TANJUNG BARAT,3174091005,2020-10-11,512,88,424,17,15,2
DKI JAKARTA,JAKARTA SELATAN,JAGAKARSA,TANJUNG BARAT,3174091005,2020-10-12,520,82,438,8,-6,14
DKI JAKARTA,JAKARTA SELATAN,JAGAKARSA,TANJUNG BARAT,3174091005,2020-10-13,523,80,443,3,-2,5
DKI JAKARTA,JAKARTA SELATAN,JAGAKARSA,TANJUNG BARAT,3174091005,2020-10-14,524,58,466,1,-22,23
DKI JAKARTA,JAKARTA SELATAN,JAGAKARSA,TANJUNG BARAT,3174091005,2020-10-15,538,62,476,14,4,10
DKI JAKARTA,JAKARTA SELATAN,JAGAKARSA,TANJUNG BARAT,3174091005,2020-10-16,541,57,484,3,-5,8
DKI JAKARTA,JAKARTA SELATAN,JAGAKARSA,TANJUNG BARAT,3174091005,2020-10-17,567,70,497,26,13,13
DKI JAKARTA,JAKARTA SELATAN,JAGAKARSA,TANJUNG BARAT,3174091005,2020-10-18,571,72,499,4,2,2
DKI JAKARTA,JAKARTA SELATAN,JAGAKARSA,TANJUNG BARAT,3174091005,2020-10-19,576,51,525,5,-21,26
DKI JAKARTA,JAKARTA SELATAN,JAGAKARSA,TANJUNG BARAT,3174091005,2020-10-20,588,53,535,12,2,10
DKI JAKARTA,JAKARTA SELATAN,JAGAKARSA,TANJUNG BARAT,3174091005,2020-10-21,590,51,539,2,-2,4
DKI JAKARTA,JAKARTA SELATAN,JAGAKARSA,TANJUNG BARAT,3174091005,2020-10-22,592,44,548,2,-7,9
DKI JAKARTA,JAKARTA SELATAN,JAGAKARSA,TANJUNG BARAT,3174091005,2020-10-23,597,47,550,5,3,2
DKI JAKARTA,JAKARTA SELATAN,JAGAKARSA,TANJUNG BARAT,3174091005,2020-10-24,603,39,564,6,-8,14
DKI JAKARTA,JAKARTA SELATAN,JAGAKARSA,TANJUNG BARAT,3174091005,2020-10-25,605,36,569,2,-3,5
DKI JAKARTA,JAKARTA SELATAN,JAGAKARSA,TANJUNG BARAT,3174091005,2020-10-26,610,28,582,5,-8,13
DKI JAKARTA,JAKARTA SELATAN,JAGAKARSA,TANJUNG BARAT,3174091005,2020-10-27,612,29,583,2,1,1
DKI JAKARTA,JAKARTA SELATAN,JAGAKARSA,TANJUNG BARAT,3174091005,2020-10-28,620,32,588,8,3,5
DKI JAKARTA,JAKARTA SELATAN,JAGAKARSA,TANJUNG BARAT,3174091005,2020-10-29,630,26,604,10,-6,16
DKI JAKARTA,JAKARTA SELATAN,JAGAKARSA,TANJUNG BARAT,3174091005,2020-10-30,640,28,612,10,2,8
DKI JAKARTA,JAKARTA SELATAN,JAGAKARSA,TANJUNG BARAT,3174091005,2020-10-31,643,28,615,3,0,3
DKI JAKARTA,JAKARTA SELATAN,KEBAYORAN BARU,CIPETE UTARA,3174071010,2020-10-01,402,43,359,0,0,0
DKI JAKARTA,JAKARTA SELATAN,KEBAYORAN BARU,CIPETE UTARA,3174071010,2020-10-02,411,50,361,9,7,2
DKI JAKARTA,JAKARTA SELATAN,KEBAYORAN BARU,CIPETE UTARA,3174071010,2020-10-03,420,58,362,9,8,1
DKI JAKARTA,JAKARTA SELATAN,KEBAYORAN BARU,CIPETE UTARA,3174071010,2020-10-04,426,64,362,6,6,0
DKI JAKARTA,JAKARTA SELATAN,KEBAYORAN BARU,CIPETE UTARA,3174071010,2020-10-05,454,89,365,28,25,3
DKI JAKARTA,JAKARTA SELATAN,KEBAYORAN BARU,CIPETE UTARA,3174071010,2020-10-06,455,86,369,1,-3,4
DKI JAKARTA,JAKARTA SELATAN,KEBAYORAN BARU,CIPETE UTARA,3174071010,2020-10-07,460,86,374,5,0,5
DKI JAKARTA,JAKARTA SELATAN,KEBAYORAN BARU,CIPETE UTARA,3174071010,2020-10-08,465,89,376,5,3,2
DKI JAKARTA,JAKARTA SELATAN,KEBAYORAN BARU,CIPETE UTARA,3174071010,2020-10-09,472,94,378,7,5,2
DKI JAKARTA,JAKARTA SELATAN,KEBAYORAN BARU,CIPETE UTARA,3174071010,2020-10-10,480,74,406,8,-20,28
DKI JAKARTA,JAKARTA SELATAN,KEBAYORAN BARU,CIPETE UTARA,3174071010,2020-10-11,482,73,409,2,-1,3
DKI JAKARTA,JAKARTA SELATAN,KEBAYORAN BARU,CIPETE UTARA,3174071010,2020-10-12,486,66,420,4,-7,11
DKI JAKARTA,JAKARTA SELATAN,KEBAYORAN BARU,CIPETE UTARA,3174071010,2020-10-13,490,63,427,4,-3,7
DKI JAKARTA,JAKARTA SELATAN,KEBAYORAN BARU,CIPETE UTARA,3174071010,2020-10-14,492,56,436,2,-7,9
DKI JAKARTA,JAKARTA SELATAN,KEBAYORAN BARU,CIPETE UTARA,3174071010,2020-10-15,495,29,466,3,-27,30
DKI JAKARTA,JAKARTA SELATAN,KEBAYORAN BARU,CIPETE UTARA,3174071010,2020-10-16,504,32,472,9,3,6
DKI JAKARTA,JAKARTA SELATAN,KEBAYORAN BARU,CIPETE UTARA,3174071010,2020-10-17,508,34,474,4,2,2
DKI JAKARTA,JAKARTA SELATAN,KEBAYORAN BARU,CIPETE UTARA,3174071010,2020-10-18,517,41,476,9,7,2
DKI JAKARTA,JAKARTA SELATAN,KEBAYORAN BARU,CIPETE UTARA,3174071010,2020-10-19,530,46,484,13,5,8
DKI JAKARTA,JAKARTA SELATAN,KEBAYORAN BARU,CIPETE UTARA,3174071010,2020-10-20,537,45,492,7,-1,8
DKI JAKARTA,JAKARTA SELATAN,KEBAYORAN BARU,CIPETE UTARA,3174071010,2020-10-21,539,42,497,2,-3,5
DKI JAKARTA,JAKARTA SELATAN,KEBAYORAN BARU,CIPETE UTARA,3174071010,2020-10-22,541,40,501,2,-2,4
DKI JAKARTA,JAKARTA SELATAN,KEBAYORAN BARU,CIPETE UTARA,3174071010,2020-10-23,547,46,501,6,6,0
DKI JAKARTA,JAKARTA SELATAN,KEBAYORAN BARU,CIPETE UTARA,3174071010,2020-10-24,549,43,506,2,-3,5
DKI JAKARTA,JAKARTA SELATAN,KEBAYORAN BARU,CIPETE UTARA,3174071010,2020-10-25,557,47,510,8,4,4
DKI JAKARTA,JAKARTA SELATAN,KEBAYORAN BARU,CIPETE UTARA,3174071010,2020-10-26,561,44,517,4,-3,7
DKI JAKARTA,JAKARTA SELATAN,KEBAYORAN BARU,CIPETE UTARA,3174071010,2020-10-27,566,46,520,5,2,3
DKI JAKARTA,JAKARTA SELATAN,KEBAYORAN BARU,CIPETE UTARA,3174071010,2020-10-28,566,42,524,0,-4,4
DKI JAKARTA,JAKARTA SELATAN,KEBAYORAN BARU,CIPETE UTARA,3174071010,2020-10-29,567,38,529,1,-4,5
DKI JAKARTA,JAKARTA SELATAN,KEBAYORAN BARU,CIPETE UTARA,3174071010,2020-10-30,609,67,542,42,29,13
DKI JAKARTA,JAKARTA SELATAN,KEBAYORAN BARU,CIPETE UTARA,3174071010,2020-10-31,614,71,543,5,4,1
DKI JAKARTA,JAKARTA SELATAN,KEBAYORAN BARU,GANDARIA UTARA,3174071009,2020-10-01,494,24,470,0,0,0
DKI JAKARTA,JAKARTA SELATAN,KEBAYORAN BARU,GANDARIA UTARA,3174071009,2020-10-02,504,33,471,10,9,1
DKI JAKARTA,JAKARTA SELATAN,KEBAYORAN BARU,GANDARIA UTARA,3174071009,2020-10-03,510,39,471,6,6,0
DKI JAKARTA,JAKARTA SELATAN,KEBAYORAN BARU,GANDARIA UTARA,3174071009,2020-10-04,515,43,472,5,4,1
DKI JAKARTA,JAKARTA SELATAN,KEBAYORAN BARU,GANDARIA UTARA,3174071009,2020-10-05,526,52,474,11,9,2
DKI JAKARTA,JAKARTA SELATAN,KEBAYORAN BARU,GANDARIA UTARA,3174071009,2020-10-06,527,53,474,1,1,0
DKI JAKARTA,JAKARTA SELATAN,KEBAYORAN BARU,GANDARIA UTARA,3174071009,2020-10-07,534,54,480,7,1,6
DKI JAKARTA,JAKARTA SELATAN,KEBAYORAN BARU,GANDARIA UTARA,3174071009,2020-10-08,536,54,482,2,0,2
DKI JAKARTA,JAKARTA SELATAN,KEBAYORAN BARU,GANDARIA UTARA,3174071009,2020-10-09,542,60,482,6,6,0
DKI JAKARTA,JAKARTA SELATAN,KEBAYORAN BARU,GANDARIA UTARA,3174071009,2020-10-10,560,67,493,18,7,11
DKI JAKARTA,JAKARTA SELATAN,KEBAYORAN BARU,GANDARIA UTARA,3174071009,2020-10-11,561,67,494,1,0,1
DKI JAKARTA,JAKARTA SELATAN,KEBAYORAN BARU,GANDARIA UTARA,3174071009,2020-10-12,574,67,507,13,0,13
DKI JAKARTA,JAKARTA SELATAN,KEBAYORAN BARU,GANDARIA UTARA,3174071009,2020-10-13,577,65,512,3,-2,5
DKI JAKARTA,JAKARTA SELATAN,KEBAYORAN BARU,GANDARIA UTARA,3174071009,2020-10-14,578,61,517,1,-4,5
DKI JAKARTA,JAKARTA SELATAN,KEBAYORAN BARU,GANDARIA UTARA,3174071009,2020-10-15,596,56,540,18,-5,23
DKI JAKARTA,JAKARTA SELATAN,KEBAYORAN BARU,GANDARIA UTARA,3174071009,2020-10-16,605,58,547,9,2,7
DKI JAKARTA,JAKARTA SELATAN,KEBAYORAN BARU,GANDARIA UTARA,3174071009,2020-10-17,608,57,551,3,-1,4
DKI JAKARTA,JAKARTA SELATAN,KEBAYORAN BARU,GANDARIA UTARA,3174071009,2020-10-18,622,66,556,14,9,5
DKI JAKARTA,JAKARTA SELATAN,KEBAYORAN BARU,GANDARIA UTARA,3174071009,2020-10-19,633,68,565,11,2,9
DKI JAKARTA,JAKARTA SELATAN,KEBAYORAN BARU,GANDARIA UTARA,3174071009,2020-10-20,640,68,572,7,0,7
DKI JAKARTA,JAKARTA SELATAN,KEBAYORAN BARU,GANDARIA UTARA,3174071009,2020-10-21,641,47,594,1,-21,22
DKI JAKARTA,JAKARTA SELATAN,KEBAYORAN BARU,GANDARIA UTARA,3174071009,2020-10-22,641,42,599,0,-5,5
DKI JAKARTA,JAKARTA SELATAN,KEBAYORAN BARU,GANDARIA UTARA,3174071009,2020-10-23,643,42,601,2,0,2
DKI JAKARTA,JAKARTA SELATAN,KEBAYORAN BARU,GANDARIA UTARA,3174071009,2020-10-24,646,41,605,3,-1,4
DKI JAKARTA,JAKARTA SELATAN,KEBAYORAN BARU,GANDARIA UTARA,3174071009,2020-10-25,649,36,613,3,-5,8
DKI JAKARTA,JAKARTA SELATAN,KEBAYORAN BARU,GANDARIA UTARA,3174071009,2020-10-26,672,50,622,23,14,9
DKI JAKARTA,JAKARTA SELATAN,KEBAYORAN BARU,GANDARIA UTARA,3174071009,2020-10-27,676,46,630,4,-4,8
DKI JAKARTA,JAKARTA SELATAN,KEBAYORAN BARU,GANDARIA UTARA,3174071009,2020-10-28,680,45,635,4,-1,5
DKI JAKARTA,JAKARTA SELATAN,KEBAYORAN BARU,GANDARIA UTARA,3174071009,2020-10-29,686,45,641,6,0,6
DKI JAKARTA,JAKARTA SELATAN,KEBAYORAN BARU,GANDARIA UTARA,3174071009,2020-10-30,699,48,651,13,3,10
DKI JAKARTA,JAKARTA SELATAN,KEBAYORAN BARU,GANDARIA UTARA,3174071009,2020-10-31,701,50,651,2,2,0
DKI JAKARTA,JAKARTA SELATAN,KEBAYORAN BARU,GUNUNG,3174071002,2020-10-01,301,15,286,0,0,0
DKI JAKARTA,JAKARTA SELATAN,KEBAYORAN BARU,GUNUNG,3174071002,2020-10-02,308,19,289,7,4,3
DKI JAKARTA,JAKARTA SELATAN,KEBAYORAN BARU,GUNUNG,3174071002,2020-10-03,311,21,290,3,2,1
DKI JAKARTA,JAKARTA SELATAN,KEBAYORAN BARU,GUNUNG,3174071002,2020-10-04,312,22,290,1,1,0
DKI JAKARTA,JAKARTA SELATAN,KEBAYORAN BARU,GUNUNG,3174071002,2020-10-05,315,23,292,3,1,2
DKI JAKARTA,JAKARTA SELATAN,KEBAYORAN BARU,GUNUNG,3174071002,2020-10-06,315,23,292,0,0,0
DKI JAKARTA,JAKARTA SELATAN,KEBAYORAN BARU,GUNUNG,3174071002,2020-10-07,315,23,292,0,0,0
DKI JAKARTA,JAKARTA SELATAN,KEBAYORAN BARU,GUNUNG,3174071002,2020-10-08,321,20,301,6,-3,9
DKI JAKARTA,JAKARTA SELATAN,KEBAYORAN BARU,GUNUNG,3174071002,2020-10-09,326,25,301,5,5,0
DKI JAKARTA,JAKARTA SELATAN,KEBAYORAN BARU,GUNUNG,3174071002,2020-10-10,330,24,306,4,-1,5
DKI JAKARTA,JAKARTA SELATAN,KEBAYORAN BARU,GUNUNG,3174071002,2020-10-11,330,22,308,0,-2,2
DKI JAKARTA,JAKARTA SELATAN,KEBAYORAN BARU,GUNUNG,3174071002,2020-10-12,339,28,311,9,6,3
DKI JAKARTA,JAKARTA SELATAN,KEBAYORAN BARU,GUNUNG,3174071002,2020-10-13,341,30,311,2,2,0
DKI JAKARTA,JAKARTA SELATAN,KEBAYORAN BARU,GUNUNG,3174071002,2020-10-14,342,27,315,1,-3,4
DKI JAKARTA,JAKARTA SELATAN,KEBAYORAN BARU,GUNUNG,3174071002,2020-10-15,342,19,323,0,-8,8
DKI JAKARTA,JAKARTA SELATAN,KEBAYORAN BARU,GUNUNG,3174071002,2020-10-16,346,21,325,4,2,2
DKI JAKARTA,JAKARTA SELATAN,KEBAYORAN BARU,GUNUNG,3174071002,2020-10-17,346,20,326,0,-1,1
DKI JAKARTA,JAKARTA SELATAN,KEBAYORAN BARU,GUNUNG,3174071002,2020-10-18,347,20,327,1,0,1
DKI JAKARTA,JAKARTA SELATAN,KEBAYORAN BARU,GUNUNG,3174071002,2020-10-19,355,21,334,8,1,7
DKI JAKARTA,JAKARTA SELATAN,KEBAYORAN BARU,GUNUNG,3174071002,2020-10-20,356,22,334,1,1,0
DKI JAKARTA,JAKARTA SELATAN,KEBAYORAN BARU,GUNUNG,3174071002,2020-10-21,356,15,341,0,-7,7
DKI JAKARTA,JAKARTA SELATAN,KEBAYORAN BARU,GUNUNG,3174071002,2020-10-22,356,14,342,0,-1,1
DKI JAKARTA,JAKARTA SELATAN,KEBAYORAN BARU,GUNUNG,3174071002,2020-10-23,356,14,342,0,0,0
DKI JAKARTA,JAKARTA SELATAN,KEBAYORAN BARU,GUNUNG,3174071002,2020-10-24,356,13,343,0,-1,1
DKI JAKARTA,JAKARTA SELATAN,KEBAYORAN BARU,GUNUNG,3174071002,2020-10-25,359,11,348,3,-2,5
DKI JAKARTA,JAKARTA SELATAN,KEBAYORAN BARU,GUNUNG,3174071002,2020-10-26,361,11,350,2,0,2
DKI JAKARTA,JAKARTA SELATAN,KEBAYORAN BARU,GUNUNG,3174071002,2020-10-27,361,9,352,0,-2,2
DKI JAKARTA,JAKARTA SELATAN,KEBAYORAN BARU,GUNUNG,3174071002,2020-10-28,362,9,353,1,0,1
DKI JAKARTA,JAKARTA SELATAN,KEBAYORAN BARU,GUNUNG,3174071002,2020-10-29,366,12,354,4,3,1
DKI JAKARTA,JAKARTA SELATAN,KEBAYORAN BARU,GUNUNG,3174071002,2020-10-30,375,14,361,9,2,7
DKI JAKARTA,JAKARTA SELATAN,KEBAYORAN BARU,GUNUNG,3174071002,2020-10-31,377,16,361,2,2,0
DKI JAKARTA,JAKARTA SELATAN,KEBAYORAN BARU,KRAMAT PELA,3174071003,2020-10-01,467,17,450,0,0,0
DKI JAKARTA,JAKARTA SELATAN,KEBAYORAN BARU,KRAMAT PELA,3174071003,2020-10-02,472,22,450,5,5,0
DKI JAKARTA,JAKARTA SELATAN,KEBAYORAN BARU,KRAMAT PELA,3174071003,2020-10-03,474,23,451,2,1,1
DKI JAKARTA,JAKARTA SELATAN,KEBAYORAN BARU,KRAMAT PELA,3174071003,2020-10-04,477,26,451,3,3,0
DKI JAKARTA,JAKARTA SELATAN,KEBAYORAN BARU,KRAMAT PELA,3174071003,2020-10-05,480,29,451,3,3,0
DKI JAKARTA,JAKARTA SELATAN,KEBAYORAN BARU,KRAMAT PELA,3174071003,2020-10-06,483,29,454,3,0,3
DKI JAKARTA,JAKARTA SELATAN,KEBAYORAN BARU,KRAMAT PELA,3174071003,2020-10-07,484,28,456,1,-1,2
DKI JAKARTA,JAKARTA SELATAN,KEBAYORAN BARU,KRAMAT PELA,3174071003,2020-10-08,485,18,467,1,-10,11
DKI JAKARTA,JAKARTA SELATAN,KEBAYORAN BARU,KRAMAT PELA,3174071003,2020-10-09,486,19,467,1,1,0
DKI JAKARTA,JAKARTA SELATAN,KEBAYORAN BARU,KRAMAT PELA,3174071003,2020-10-10,488,21,467,2,2,0
DKI JAKARTA,JAKARTA SELATAN,KEBAYORAN BARU,KRAMAT PELA,3174071003,2020-10-11,488,21,467,0,0,0
DKI JAKARTA,JAKARTA SELATAN,KEBAYORAN BARU,KRAMAT PELA,3174071003,2020-10-12,490,17,473,2,-4,6
DKI JAKARTA,JAKARTA SELATAN,KEBAYORAN BARU,KRAMAT PELA,3174071003,2020-10-13,492,15,477,2,-2,4
DKI JAKARTA,JAKARTA SELATAN,KEBAYORAN BARU,KRAMAT PELA,3174071003,2020-10-14,492,15,477,0,0,0
DKI JAKARTA,JAKARTA SELATAN,KEBAYORAN BARU,KRAMAT PELA,3174071003,2020-10-15,493,9,484,1,-6,7
DKI JAKARTA,JAKARTA SELATAN,KEBAYORAN BARU,KRAMAT PELA,3174071003,2020-10-16,497,9,488,4,0,4
DKI JAKARTA,JAKARTA SELATAN,KEBAYORAN BARU,KRAMAT PELA,3174071003,2020-10-17,498,9,489,1,0,1
DKI JAKARTA,JAKARTA SELATAN,KEBAYORAN BARU,KRAMAT PELA,3174071003,2020-10-18,498,9,489,0,0,0
DKI JAKARTA,JAKARTA SELATAN,KEBAYORAN BARU,KRAMAT PELA,3174071003,2020-10-19,499,10,489,1,1,0
DKI JAKARTA,JAKARTA SELATAN,KEBAYORAN BARU,KRAMAT PELA,3174071003,2020-10-20,499,9,490,0,-1,1
DKI JAKARTA,JAKARTA SELATAN,KEBAYORAN BARU,KRAMAT PELA,3174071003,2020-10-21,500,8,492,1,-1,2
DKI JAKARTA,JAKARTA SELATAN,KEBAYORAN BARU,KRAMAT PELA,3174071003,2020-10-22,502,9,493,2,1,1
DKI JAKARTA,JAKARTA SELATAN,KEBAYORAN BARU,KRAMAT PELA,3174071003,2020-10-23,502,9,493,0,0,0
DKI JAKARTA,JAKARTA SELATAN,KEBAYORAN BARU,KRAMAT PELA,3174071003,2020-10-24,502,9,493,0,0,0
DKI JAKARTA,JAKARTA SELATAN,KEBAYORAN BARU,KRAMAT PELA,3174071003,2020-10-25,505,11,494,3,2,1
DKI JAKARTA,JAKARTA SELATAN,KEBAYORAN BARU,KRAMAT PELA,3174071003,2020-10-26,508,9,499,3,-2,5
DKI JAKARTA,JAKARTA SELATAN,KEBAYORAN BARU,KRAMAT PELA,3174071003,2020-10-27,508,9,499,0,0,0
DKI JAKARTA,JAKARTA SELATAN,KEBAYORAN BARU,KRAMAT PELA,3174071003,2020-10-28,509,8,501,1,-1,2
DKI JAKARTA,JAKARTA SELATAN,KEBAYORAN BARU,KRAMAT PELA,3174071003,2020-10-29,514,13,501,5,5,0
DKI JAKARTA,JAKARTA SELATAN,KEBAYORAN BARU,KRAMAT PELA,3174071003,2020-10-30,517,15,502,3,2,1
DKI JAKARTA,JAKARTA SELATAN,KEBAYORAN BARU,KRAMAT PELA,3174071003,2020-10-31,518,16,502,1,1,0
DKI JAKARTA,JAKARTA SELATAN,KEBAYORAN BARU,MELAWAI,3174071001,2020-10-01,60,8,52,0,0,0
DKI JAKARTA,JAKARTA SELATAN,KEBAYORAN BARU,MELAWAI,3174071001,2020-10-02,63,10,53,3,2,1
DKI JAKARTA,JAKARTA SELATAN,KEBAYORAN BARU,MELAWAI,3174071001,2020-10-03,67,13,54,4,3,1
DKI JAKARTA,JAKARTA SELATAN,KEBAYORAN BARU,MELAWAI,3174071001,2020-10-04,67,13,54,0,0,0
DKI JAKARTA,JAKARTA SELATAN,KEBAYORAN BARU,MELAWAI,3174071001,2020-10-05,67,12,55,0,-1,1
DKI JAKARTA,JAKARTA SELATAN,KEBAYORAN BARU,MELAWAI,3174071001,2020-10-06,67,11,56,0,-1,1
DKI JAKARTA,JAKARTA SELATAN,KEBAYORAN BARU,MELAWAI,3174071001,2020-10-07,68,10,58,1,-1,2
DKI JAKARTA,JAKARTA SELATAN,KEBAYORAN BARU,MELAWAI,3174071001,2020-10-08,71,11,60,3,1,2
DKI JAKARTA,JAKARTA SELATAN,KEBAYORAN BARU,MELAWAI,3174071001,2020-10-09,72,12,60,1,1,0
DKI JAKARTA,JAKARTA SELATAN,KEBAYORAN BARU,MELAWAI,3174071001,2020-10-10,74,14,60,2,2,0
DKI JAKARTA,JAKARTA SELATAN,KEBAYORAN BARU,MELAWAI,3174071001,2020-10-11,74,14,60,0,0,0
DKI JAKARTA,JAKARTA SELATAN,KEBAYORAN BARU,MELAWAI,3174071001,2020-10-12,74,10,64,0,-4,4
DKI JAKARTA,JAKARTA SELATAN,KEBAYORAN BARU,MELAWAI,3174071001,2020-10-13,74,9,65,0,-1,1
DKI JAKARTA,JAKARTA SELATAN,KEBAYORAN BARU,MELAWAI,3174071001,2020-10-14,74,6,68,0,-3,3
DKI JAKARTA,JAKARTA SELATAN,KEBAYORAN BARU,MELAWAI,3174071001,2020-10-15,77,7,70,3,1,2
DKI JAKARTA,JAKARTA SELATAN,KEBAYORAN BARU,MELAWAI,3174071001,2020-10-16,79,7,72,2,0,2
DKI JAKARTA,JAKARTA SELATAN,KEBAYORAN BARU,MELAWAI,3174071001,2020-10-17,79,6,73,0,-1,1
DKI JAKARTA,JAKARTA SELATAN,KEBAYORAN BARU,MELAWAI,3174071001,2020-10-18,81,8,73,2,2,0
DKI JAKARTA,JAKARTA SELATAN,KEBAYORAN BARU,MELAWAI,3174071001,2020-10-19,82,8,74,1,0,1
DKI JAKARTA,JAKARTA SELATAN,KEBAYORAN BARU,MELAWAI,3174071001,2020-10-20,82,6,76,0,-2,2
DKI JAKARTA,JAKARTA SELATAN,KEBAYORAN BARU,MELAWAI,3174071001,2020-10-21,82,5,77,0,-1,1
DKI JAKARTA,JAKARTA SELATAN,KEBAYORAN BARU,MELAWAI,3174071001,2020-10-22,82,5,77,0,0,0
DKI JAKARTA,JAKARTA SELATAN,KEBAYORAN BARU,MELAWAI,3174071001,2020-10-23,82,5,77,0,0,0
DKI JAKARTA,JAKARTA SELATAN,KEBAYORAN BARU,MELAWAI,3174071001,2020-10-24,82,4,78,0,-1,1
DKI JAKARTA,JAKARTA SELATAN,KEBAYORAN BARU,MELAWAI,3174071001,2020-10-25,82,4,78,0,0,0
DKI JAKARTA,JAKARTA SELATAN,KEBAYORAN BARU,MELAWAI,3174071001,2020-10-26,84,4,80,2,0,2
DKI JAKARTA,JAKARTA SELATAN,KEBAYORAN BARU,MELAWAI,3174071001,2020-10-27,87,6,81,3,2,1
DKI JAKARTA,JAKARTA SELATAN,KEBAYORAN BARU,MELAWAI,3174071001,2020-10-28,88,5,83,1,-1,2
DKI JAKARTA,JAKARTA SELATAN,KEBAYORAN BARU,MELAWAI,3174071001,2020-10-29,89,5,84,1,0,1
DKI JAKARTA,JAKARTA SELATAN,KEBAYORAN BARU,MELAWAI,3174071001,2020-10-30,91,6,85,2,1,1
DKI JAKARTA,JAKARTA SELATAN,KEBAYORAN BARU,MELAWAI,3174071001,2020-10-31,91,5,86,0,-1,1
DKI JAKARTA,JAKARTA SELATAN,KEBAYORAN BARU,PETOGOGAN,3174071008,2020-10-01,213,10,203,0,0,0
DKI JAKARTA,JAKARTA SELATAN,KEBAYORAN BARU,PETOGOGAN,3174071008,2020-10-02,217,14,203,4,4,0
DKI JAKARTA,JAKARTA SELATAN,KEBAYORAN BARU,PETOGOGAN,3174071008,2020-10-03,224,20,204,7,6,1
DKI JAKARTA,JAKARTA SELATAN,KEBAYORAN BARU,PETOGOGAN,3174071008,2020-10-04,225,21,204,1,1,0
DKI JAKARTA,JAKARTA SELATAN,KEBAYORAN BARU,PETOGOGAN,3174071008,2020-10-05,225,21,204,0,0,0
DKI JAKARTA,JAKARTA SELATAN,KEBAYORAN BARU,PETOGOGAN,3174071008,2020-10-06,225,21,204,0,0,0
DKI JAKARTA,JAKARTA SELATAN,KEBAYORAN BARU,PETOGOGAN,3174071008,2020-10-07,226,22,204,1,1,0
DKI JAKARTA,JAKARTA SELATAN,KEBAYORAN BARU,PETOGOGAN,3174071008,2020-10-08,235,27,208,9,5,4
DKI JAKARTA,JAKARTA SELATAN,KEBAYORAN BARU,PETOGOGAN,3174071008,2020-10-09,249,41,208,14,14,0
DKI JAKARTA,JAKARTA SELATAN,KEBAYORAN BARU,PETOGOGAN,3174071008,2020-10-10,250,38,212,1,-3,4
DKI JAKARTA,JAKARTA SELATAN,KEBAYORAN BARU,PETOGOGAN,3174071008,2020-10-11,251,37,214,1,-1,2
DKI JAKARTA,JAKARTA SELATAN,KEBAYORAN BARU,PETOGOGAN,3174071008,2020-10-12,252,27,225,1,-10,11
DKI JAKARTA,JAKARTA SELATAN,KEBAYORAN BARU,PETOGOGAN,3174071008,2020-10-13,252,25,227,0,-2,2
DKI JAKARTA,JAKARTA SELATAN,KEBAYORAN BARU,PETOGOGAN,3174071008,2020-10-14,254,23,231,2,-2,4
DKI JAKARTA,JAKARTA SELATAN,KEBAYORAN BARU,PETOGOGAN,3174071008,2020-10-15,259,26,233,5,3,2
DKI JAKARTA,JAKARTA SELATAN,KEBAYORAN BARU,PETOGOGAN,3174071008,2020-10-16,264,31,233,5,5,0
DKI JAKARTA,JAKARTA SELATAN,KEBAYORAN BARU,PETOGOGAN,3174071008,2020-10-17,267,34,233,3,3,0
DKI JAKARTA,JAKARTA SELATAN,KEBAYORAN BARU,PETOGOGAN,3174071008,2020-10-18,269,36,233,2,2,0
DKI JAKARTA,JAKARTA SELATAN,KEBAYORAN BARU,PETOGOGAN,3174071008,2020-10-19,270,16,254,1,-20,21
DKI JAKARTA,JAKARTA SELATAN,KEBAYORAN BARU,PETOGOGAN,3174071008,2020-10-20,274,17,257,4,1,3
DKI JAKARTA,JAKARTA SELATAN,KEBAYORAN BARU,PETOGOGAN,3174071008,2020-10-21,276,18,258,2,1,1
DKI JAKARTA,JAKARTA SELATAN,KEBAYORAN BARU,PETOGOGAN,3174071008,2020-10-22,277,15,262,1,-3,4
DKI JAKARTA,JAKARTA SELATAN,KEBAYORAN BARU,PETOGOGAN,3174071008,2020-10-23,277,15,262,0,0,0
DKI JAKARTA,JAKARTA SELATAN,KEBAYORAN BARU,PETOGOGAN,3174071008,2020-10-24,277,14,263,0,-1,1
DKI JAKARTA,JAKARTA SELATAN,KEBAYORAN BARU,PETOGOGAN,3174071008,2020-10-25,280,16,264,3,2,1
DKI JAKARTA,JAKARTA SELATAN,KEBAYORAN BARU,PETOGOGAN,3174071008,2020-10-26,289,22,267,9,6,3
DKI JAKARTA,JAKARTA SELATAN,KEBAYORAN BARU,PETOGOGAN,3174071008,2020-10-27,292,21,271,3,-1,4
DKI JAKARTA,JAKARTA SELATAN,KEBAYORAN BARU,PETOGOGAN,3174071008,2020-10-28,293,21,272,1,0,1
DKI JAKARTA,JAKARTA SELATAN,KEBAYORAN BARU,PETOGOGAN,3174071008,2020-10-29,295,21,274,2,0,2
DKI JAKARTA,JAKARTA SELATAN,KEBAYORAN BARU,PETOGOGAN,3174071008,2020-10-30,304,28,276,9,7,2
DKI JAKARTA,JAKARTA SELATAN,KEBAYORAN BARU,PETOGOGAN,3174071008,2020-10-31,306,29,277,2,1,1
DKI JAKARTA,JAKARTA SELATAN,KEBAYORAN BARU,PULO,3174071007,2020-10-01,177,32,145,0,0,0
DKI JAKARTA,JAKARTA SELATAN,KEBAYORAN BARU,PULO,3174071007,2020-10-02,187,40,147,10,8,2
DKI JAKARTA,JAKARTA SELATAN,KEBAYORAN BARU,PULO,3174071007,2020-10-03,194,43,151,7,3,4
DKI JAKARTA,JAKARTA SELATAN,KEBAYORAN BARU,PULO,3174071007,2020-10-04,195,44,151,1,1,0
DKI JAKARTA,JAKARTA SELATAN,KEBAYORAN BARU,PULO,3174071007,2020-10-05,195,39,156,0,-5,5
DKI JAKARTA,JAKARTA SELATAN,KEBAYORAN BARU,PULO,3174071007,2020-10-06,195,39,156,0,0,0
DKI JAKARTA,JAKARTA SELATAN,KEBAYORAN BARU,PULO,3174071007,2020-10-07,198,20,178,3,-19,22
DKI JAKARTA,JAKARTA SELATAN,KEBAYORAN BARU,PULO,3174071007,2020-10-08,199,20,179,1,0,1
DKI JAKARTA,JAKARTA SELATAN,KEBAYORAN BARU,PULO,3174071007,2020-10-09,200,21,179,1,1,0
DKI JAKARTA,JAKARTA SELATAN,KEBAYORAN BARU,PULO,3174071007,2020-10-10,205,24,181,5,3,2
DKI JAKARTA,JAKARTA SELATAN,KEBAYORAN BARU,PULO,3174071007,2020-10-11,205,22,183,0,-2,2
DKI JAKARTA,JAKARTA SELATAN,KEBAYORAN BARU,PULO,3174071007,2020-10-12,211,22,189,6,0,6
DKI JAKARTA,JAKARTA SELATAN,KEBAYORAN BARU,PULO,3174071007,2020-10-13,213,18,195,2,-4,6
DKI JAKARTA,JAKARTA SELATAN,KEBAYORAN BARU,PULO,3174071007,2020-10-14,214,15,199,1,-3,4
DKI JAKARTA,JAKARTA SELATAN,KEBAYORAN BARU,PULO,3174071007,2020-10-15,214,15,199,0,0,0
DKI JAKARTA,JAKARTA SELATAN,KEBAYORAN BARU,PULO,3174071007,2020-10-16,215,11,204,1,-4,5
DKI JAKARTA,JAKARTA SELATAN,KEBAYORAN BARU,PULO,3174071007,2020-10-17,215,11,204,0,0,0
DKI JAKARTA,JAKARTA SELATAN,KEBAYORAN BARU,PULO,3174071007,2020-10-18,216,12,204,1,1,0
DKI JAKARTA,JAKARTA SELATAN,KEBAYORAN BARU,PULO,3174071007,2020-10-19,216,9,207,0,-3,3
DKI JAKARTA,JAKARTA SELATAN,KEBAYORAN BARU,PULO,3174071007,2020-10-20,219,10,209,3,1,2
DKI JAKARTA,JAKARTA SELATAN,KEBAYORAN BARU,PULO,3174071007,2020-10-21,219,6,213,0,-4,4
DKI JAKARTA,JAKARTA SELATAN,KEBAYORAN BARU,PULO,3174071007,2020-10-22,219,4,215,0,-2,2
DKI JAKARTA,JAKARTA SELATAN,KEBAYORAN BARU,PULO,3174071007,2020-10-23,220,4,216,1,0,1
DKI JAKARTA,JAKARTA SELATAN,KEBAYORAN BARU,PULO,3174071007,2020-10-24,220,3,217,0,-1,1
DKI JAKARTA,JAKARTA SELATAN,KEBAYORAN BARU,PULO,3174071007,2020-10-25,222,4,218,2,1,1
DKI JAKARTA,JAKARTA SELATAN,KEBAYORAN BARU,PULO,3174071007,2020-10-26,223,4,219,1,0,1
DKI JAKARTA,JAKARTA SELATAN,KEBAYORAN BARU,PULO,3174071007,2020-10-27,224,5,219,1,1,0
DKI JAKARTA,JAKARTA SELATAN,KEBAYORAN BARU,PULO,3174071007,2020-10-28,224,4,220,0,-1,1
DKI JAKARTA,JAKARTA SELATAN,KEBAYORAN BARU,PULO,3174071007,2020-10-29,224,4,220,0,0,0
DKI JAKARTA,JAKARTA SELATAN,KEBAYORAN BARU,PULO,3174071007,2020-10-30,228,8,220,4,4,0
DKI JAKARTA,JAKARTA SELATAN,KEBAYORAN BARU,PULO,3174071007,2020-10-31,228,8,220,0,0,0
DKI JAKARTA,JAKARTA SELATAN,KEBAYORAN BARU,RAWA BARAT,3174071005,2020-10-01,133,7,126,0,0,0
DKI JAKARTA,JAKARTA SELATAN,KEBAYORAN BARU,RAWA BARAT,3174071005,2020-10-02,135,9,126,2,2,0
DKI JAKARTA,JAKARTA SELATAN,KEBAYORAN BARU,RAWA BARAT,3174071005,2020-10-03,138,11,127,3,2,1
DKI JAKARTA,JAKARTA SELATAN,KEBAYORAN BARU,RAWA BARAT,3174071005,2020-10-04,139,12,127,1,1,0
DKI JAKARTA,JAKARTA SELATAN,KEBAYORAN BARU,RAWA BARAT,3174071005,2020-10-05,139,11,128,0,-1,1
DKI JAKARTA,JAKARTA SELATAN,KEBAYORAN BARU,RAWA BARAT,3174071005,2020-10-06,140,11,129,1,0,1
DKI JAKARTA,JAKARTA SELATAN,KEBAYORAN BARU,RAWA BARAT,3174071005,2020-10-07,142,13,129,2,2,0
DKI JAKARTA,JAKARTA SELATAN,KEBAYORAN BARU,RAWA BARAT,3174071005,2020-10-08,144,13,131,2,0,2
DKI JAKARTA,JAKARTA SELATAN,KEBAYORAN BARU,RAWA BARAT,3174071005,2020-10-09,147,15,132,3,2,1
DKI JAKARTA,JAKARTA SELATAN,KEBAYORAN BARU,RAWA BARAT,3174071005,2020-10-10,152,18,134,5,3,2
DKI JAKARTA,JAKARTA SELATAN,KEBAYORAN BARU,RAWA BARAT,3174071005,2020-10-11,152,16,136,0,-2,2
DKI JAKARTA,JAKARTA SELATAN,KEBAYORAN BARU,RAWA BARAT,3174071005,2020-10-12,153,15,138,1,-1,2
DKI JAKARTA,JAKARTA SELATAN,KEBAYORAN BARU,RAWA BARAT,3174071005,2020-10-13,156,16,140,3,1,2
DKI JAKARTA,JAKARTA SELATAN,KEBAYORAN BARU,RAWA BARAT,3174071005,2020-10-14,157,17,140,1,1,0
DKI JAKARTA,JAKARTA SELATAN,KEBAYORAN BARU,RAWA BARAT,3174071005,2020-10-15,158,15,143,1,-2,3
DKI JAKARTA,JAKARTA SELATAN,KEBAYORAN BARU,RAWA BARAT,3174071005,2020-10-16,159,12,147,1,-3,4
DKI JAKARTA,JAKARTA SELATAN,KEBAYORAN BARU,RAWA BARAT,3174071005,2020-10-17,160,12,148,1,0,1
DKI JAKARTA,JAKARTA SELATAN,KEBAYORAN BARU,RAWA BARAT,3174071005,2020-10-18,160,12,148,0,0,0
DKI JAKARTA,JAKARTA SELATAN,KEBAYORAN BARU,RAWA BARAT,3174071005,2020-10-19,160,10,150,0,-2,2
DKI JAKARTA,JAKARTA SELATAN,KEBAYORAN BARU,RAWA BARAT,3174071005,2020-10-20,161,11,150,1,1,0
DKI JAKARTA,JAKARTA SELATAN,KEBAYORAN BARU,RAWA BARAT,3174071005,2020-10-21,162,7,155,1,-4,5
DKI JAKARTA,JAKARTA SELATAN,KEBAYORAN BARU,RAWA BARAT,3174071005,2020-10-22,162,6,156,0,-1,1
DKI JAKARTA,JAKARTA SELATAN,KEBAYORAN BARU,RAWA BARAT,3174071005,2020-10-23,162,6,156,0,0,0
DKI JAKARTA,JAKARTA SELATAN,KEBAYORAN BARU,RAWA BARAT,3174071005,2020-10-24,163,7,156,1,1,0
DKI JAKARTA,JAKARTA SELATAN,KEBAYORAN BARU,RAWA BARAT,3174071005,2020-10-25,165,7,158,2,0,2
DKI JAKARTA,JAKARTA SELATAN,KEBAYORAN BARU,RAWA BARAT,3174071005,2020-10-26,171,10,161,6,3,3
DKI JAKARTA,JAKARTA SELATAN,KEBAYORAN BARU,RAWA BARAT,3174071005,2020-10-27,171,9,162,0,-1,1
DKI JAKARTA,JAKARTA SELATAN,KEBAYORAN BARU,RAWA BARAT,3174071005,2020-10-28,173,8,165,2,-1,3
DKI JAKARTA,JAKARTA SELATAN,KEBAYORAN BARU,RAWA BARAT,3174071005,2020-10-29,174,8,166,1,0,1
DKI JAKARTA,JAKARTA SELATAN,KEBAYORAN BARU,RAWA BARAT,3174071005,2020-10-30,175,9,166,1,1,0
DKI JAKARTA,JAKARTA SELATAN,KEBAYORAN BARU,RAWA BARAT,3174071005,2020-10-31,175,9,166,0,0,0
DKI JAKARTA,JAKARTA SELATAN,KEBAYORAN BARU,SELONG,3174071004,2020-10-01,98,12,86,0,0,0
DKI JAKARTA,JAKARTA SELATAN,KEBAYORAN BARU,SELONG,3174071004,2020-10-02,103,16,87,5,4,1
DKI JAKARTA,JAKARTA SELATAN,KEBAYORAN BARU,SELONG,3174071004,2020-10-03,108,16,92,5,0,5
DKI JAKARTA,JAKARTA SELATAN,KEBAYORAN BARU,SELONG,3174071004,2020-10-04,109,17,92,1,1,0
DKI JAKARTA,JAKARTA SELATAN,KEBAYORAN BARU,SELONG,3174071004,2020-10-05,109,16,93,0,-1,1
DKI JAKARTA,JAKARTA SELATAN,KEBAYORAN BARU,SELONG,3174071004,2020-10-06,109,15,94,0,-1,1
DKI JAKARTA,JAKARTA SELATAN,KEBAYORAN BARU,SELONG,3174071004,2020-10-07,110,14,96,1,-1,2
DKI JAKARTA,JAKARTA SELATAN,KEBAYORAN BARU,SELONG,3174071004,2020-10-08,111,14,97,1,0,1
DKI JAKARTA,JAKARTA SELATAN,KEBAYORAN BARU,SELONG,3174071004,2020-10-09,112,14,98,1,0,1
DKI JAKARTA,JAKARTA SELATAN,KEBAYORAN BARU,SELONG,3174071004,2020-10-10,112,10,102,0,-4,4
DKI JAKARTA,JAKARTA SELATAN,KEBAYORAN BARU,SELONG,3174071004,2020-10-11,112,10,102,0,0,0
DKI JAKARTA,JAKARTA SELATAN,KEBAYORAN BARU,SELONG,3174071004,2020-10-12,113,5,108,1,-5,6
DKI JAKARTA,JAKARTA SELATAN,KEBAYORAN BARU,SELONG,3174071004,2020-10-13,113,2,111,0,-3,3
DKI JAKARTA,JAKARTA SELATAN,KEBAYORAN BARU,SELONG,3174071004,2020-10-14,113,2,111,0,0,0
DKI JAKARTA,JAKARTA SELATAN,KEBAYORAN BARU,SELONG,3174071004,2020-10-15,114,3,111,1,1,0
DKI JAKARTA,JAKARTA SELATAN,KEBAYORAN BARU,SELONG,3174071004,2020-10-16,124,13,111,10,10,0
DKI JAKARTA,JAKARTA SELATAN,KEBAYORAN BARU,SELONG,3174071004,2020-10-17,125,14,111,1,1,0
DKI JAKARTA,JAKARTA SELATAN,KEBAYORAN BARU,SELONG,3174071004,2020-10-18,125,13,112,0,-1,1
DKI JAKARTA,JAKARTA SELATAN,KEBAYORAN BARU,SELONG,3174071004,2020-10-19,126,11,115,1,-2,3
DKI JAKARTA,JAKARTA SELATAN,KEBAYORAN BARU,SELONG,3174071004,2020-10-20,127,11,116,1,0,1
DKI JAKARTA,JAKARTA SELATAN,KEBAYORAN BARU,SELONG,3174071004,2020-10-21,127,8,119,0,-3,3
DKI JAKARTA,JAKARTA SELATAN,KEBAYORAN BARU,SELONG,3174071004,2020-10-22,128,2,126,1,-6,7
DKI JAKARTA,JAKARTA SELATAN,KEBAYORAN BARU,SELONG,3174071004,2020-10-23,128,2,126,0,0,0
DKI JAKARTA,JAKARTA SELATAN,KEBAYORAN BARU,SELONG,3174071004,2020-10-24,129,2,127,1,0,1
DKI JAKARTA,JAKARTA SELATAN,KEBAYORAN BARU,SELONG,3174071004,2020-10-25,130,2,128,1,0,1
DKI JAKARTA,JAKARTA SELATAN,KEBAYORAN BARU,SELONG,3174071004,2020-10-26,132,4,128,2,2,0
DKI JAKARTA,JAKARTA SELATAN,KEBAYORAN BARU,SELONG,3174071004,2020-10-27,133,5,128,1,1,0
DKI JAKARTA,JAKARTA SELATAN,KEBAYORAN BARU,SELONG,3174071004,2020-10-28,133,4,129,0,-1,1
DKI JAKARTA,JAKARTA SELATAN,KEBAYORAN BARU,SELONG,3174071004,2020-10-29,133,2,131,0,-2,2
DKI JAKARTA,JAKARTA SELATAN,KEBAYORAN BARU,SELONG,3174071004,2020-10-30,136,5,131,3,3,0
DKI JAKARTA,JAKARTA SELATAN,KEBAYORAN BARU,SELONG,3174071004,2020-10-31,136,5,131,0,0,0
DKI JAKARTA,JAKARTA SELATAN,KEBAYORAN BARU,SENAYAN,3174071006,2020-10-01,199,8,191,0,0,0
DKI JAKARTA,JAKARTA SELATAN,KEBAYORAN BARU,SENAYAN,3174071006,2020-10-02,207,14,193,8,6,2
DKI JAKARTA,JAKARTA SELATAN,KEBAYORAN BARU,SENAYAN,3174071006,2020-10-03,293,95,198,86,81,5
DKI JAKARTA,JAKARTA SELATAN,KEBAYORAN BARU,SENAYAN,3174071006,2020-10-04,297,99,198,4,4,0
DKI JAKARTA,JAKARTA SELATAN,KEBAYORAN BARU,SENAYAN,3174071006,2020-10-05,305,106,199,8,7,1
DKI JAKARTA,JAKARTA SELATAN,KEBAYORAN BARU,SENAYAN,3174071006,2020-10-06,308,109,199,3,3,0
DKI JAKARTA,JAKARTA SELATAN,KEBAYORAN BARU,SENAYAN,3174071006,2020-10-07,309,110,199,1,1,0
DKI JAKARTA,JAKARTA SELATAN,KEBAYORAN BARU,SENAYAN,3174071006,2020-10-08,312,113,199,3,3,0
DKI JAKARTA,JAKARTA SELATAN,KEBAYORAN BARU,SENAYAN,3174071006,2020-10-09,312,113,199,0,0,0
DKI JAKARTA,JAKARTA SELATAN,KEBAYORAN BARU,SENAYAN,3174071006,2020-10-10,314,113,201,2,0,2
DKI JAKARTA,JAKARTA SELATAN,KEBAYORAN BARU,SENAYAN,3174071006,2020-10-11,320,119,201,6,6,0
DKI JAKARTA,JAKARTA SELATAN,KEBAYORAN BARU,SENAYAN,3174071006,2020-10-12,320,15,305,0,-104,104
DKI JAKARTA,JAKARTA SELATAN,KEBAYORAN BARU,SENAYAN,3174071006,2020-10-13,324,11,313,4,-4,8
DKI JAKARTA,JAKARTA SELATAN,KEBAYORAN BARU,SENAYAN,3174071006,2020-10-14,324,11,313,0,0,0
DKI JAKARTA,JAKARTA SELATAN,KEBAYORAN BARU,SENAYAN,3174071006,2020-10-15,324,6,318,0,-5,5
DKI JAKARTA,JAKARTA SELATAN,KEBAYORAN BARU,SENAYAN,3174071006,2020-10-16,324,6,318,0,0,0
DKI JAKARTA,JAKARTA SELATAN,KEBAYORAN BARU,SENAYAN,3174071006,2020-10-17,511,192,319,187,186,1
DKI JAKARTA,JAKARTA SELATAN,KEBAYORAN BARU,SENAYAN,3174071006,2020-10-18,542,192,350,31,0,31
DKI JAKARTA,JAKARTA SELATAN,KEBAYORAN BARU,SENAYAN,3174071006,2020-10-19,569,219,350,27,27,0
DKI JAKARTA,JAKARTA SELATAN,KEBAYORAN BARU,SENAYAN,3174071006,2020-10-20,631,279,352,62,60,2
DKI JAKARTA,JAKARTA SELATAN,KEBAYORAN BARU,SENAYAN,3174071006,2020-10-21,632,280,352,1,1,0
DKI JAKARTA,JAKARTA SELATAN,KEBAYORAN BARU,SENAYAN,3174071006,2020-10-22,632,280,352,0,0,0
DKI JAKARTA,JAKARTA SELATAN,KEBAYORAN BARU,SENAYAN,3174071006,2020-10-23,632,280,352,0,0,0
DKI JAKARTA,JAKARTA SELATAN,KEBAYORAN BARU,SENAYAN,3174071006,2020-10-24,632,276,356,0,-4,4
DKI JAKARTA,JAKARTA SELATAN,KEBAYORAN BARU,SENAYAN,3174071006,2020-10-25,634,278,356,2,2,0
DKI JAKARTA,JAKARTA SELATAN,KEBAYORAN BARU,SENAYAN,3174071006,2020-10-26,635,277,358,1,-1,2
DKI JAKARTA,JAKARTA SELATAN,KEBAYORAN BARU,SENAYAN,3174071006,2020-10-27,640,279,361,5,2,3
DKI JAKARTA,JAKARTA SELATAN,KEBAYORAN BARU,SENAYAN,3174071006,2020-10-28,645,280,365,5,1,4
DKI JAKARTA,JAKARTA SELATAN,KEBAYORAN BARU,SENAYAN,3174071006,2020-10-29,645,34,611,0,-246,246
DKI JAKARTA,JAKARTA SELATAN,KEBAYORAN BARU,SENAYAN,3174071006,2020-10-30,716,78,638,71,44,27
DKI JAKARTA,JAKARTA SELATAN,KEBAYORAN BARU,SENAYAN,3174071006,2020-10-31,739,98,641,23,20,3
DKI JAKARTA,JAKARTA SELATAN,KEBAYORAN LAMA,CIPULIR,3174051003,2020-10-01,459,16,443,0,0,0
DKI JAKARTA,JAKARTA SELATAN,KEBAYORAN LAMA,CIPULIR,3174051003,2020-10-02,465,17,448,6,1,5
DKI JAKARTA,JAKARTA SELATAN,KEBAYORAN LAMA,CIPULIR,3174051003,2020-10-03,471,21,450,6,4,2
DKI JAKARTA,JAKARTA SELATAN,KEBAYORAN LAMA,CIPULIR,3174051003,2020-10-04,471,20,451,0,-1,1
DKI JAKARTA,JAKARTA SELATAN,KEBAYORAN LAMA,CIPULIR,3174051003,2020-10-05,473,19,454,2,-1,3
DKI JAKARTA,JAKARTA SELATAN,KEBAYORAN LAMA,CIPULIR,3174051003,2020-10-06,473,18,455,0,-1,1
DKI JAKARTA,JAKARTA SELATAN,KEBAYORAN LAMA,CIPULIR,3174051003,2020-10-07,479,20,459,6,2,4
DKI JAKARTA,JAKARTA SELATAN,KEBAYORAN LAMA,CIPULIR,3174051003,2020-10-08,485,24,461,6,4,2
DKI JAKARTA,JAKARTA SELATAN,KEBAYORAN LAMA,CIPULIR,3174051003,2020-10-09,488,27,461,3,3,0
DKI JAKARTA,JAKARTA SELATAN,KEBAYORAN LAMA,CIPULIR,3174051003,2020-10-10,496,33,463,8,6,2
DKI JAKARTA,JAKARTA SELATAN,KEBAYORAN LAMA,CIPULIR,3174051003,2020-10-11,497,33,464,1,0,1
DKI JAKARTA,JAKARTA SELATAN,KEBAYORAN LAMA,CIPULIR,3174051003,2020-10-12,500,35,465,3,2,1
DKI JAKARTA,JAKARTA SELATAN,KEBAYORAN LAMA,CIPULIR,3174051003,2020-10-13,503,33,470,3,-2,5
DKI JAKARTA,JAKARTA SELATAN,KEBAYORAN LAMA,CIPULIR,3174051003,2020-10-14,504,28,476,1,-5,6
DKI JAKARTA,JAKARTA SELATAN,KEBAYORAN LAMA,CIPULIR,3174051003,2020-10-15,509,31,478,5,3,2
DKI JAKARTA,JAKARTA SELATAN,KEBAYORAN LAMA,CIPULIR,3174051003,2020-10-16,512,27,485,3,-4,7
DKI JAKARTA,JAKARTA SELATAN,KEBAYORAN LAMA,CIPULIR,3174051003,2020-10-17,517,32,485,5,5,0
DKI JAKARTA,JAKARTA SELATAN,KEBAYORAN LAMA,CIPULIR,3174051003,2020-10-18,518,31,487,1,-1,2
DKI JAKARTA,JAKARTA SELATAN,KEBAYORAN LAMA,CIPULIR,3174051003,2020-10-19,519,26,493,1,-5,6
DKI JAKARTA,JAKARTA SELATAN,KEBAYORAN LAMA,CIPULIR,3174051003,2020-10-20,524,28,496,5,2,3
DKI JAKARTA,JAKARTA SELATAN,KEBAYORAN LAMA,CIPULIR,3174051003,2020-10-21,525,26,499,1,-2,3
DKI JAKARTA,JAKARTA SELATAN,KEBAYORAN LAMA,CIPULIR,3174051003,2020-10-22,527,25,502,2,-1,3
DKI JAKARTA,JAKARTA SELATAN,KEBAYORAN LAMA,CIPULIR,3174051003,2020-10-23,527,25,502,0,0,0
DKI JAKARTA,JAKARTA SELATAN,KEBAYORAN LAMA,CIPULIR,3174051003,2020-10-24,529,22,507,2,-3,5
DKI JAKARTA,JAKARTA SELATAN,KEBAYORAN LAMA,CIPULIR,3174051003,2020-10-25,534,23,511,5,1,4
DKI JAKARTA,JAKARTA SELATAN,KEBAYORAN LAMA,CIPULIR,3174051003,2020-10-26,537,19,518,3,-4,7
DKI JAKARTA,JAKARTA SELATAN,KEBAYORAN LAMA,CIPULIR,3174051003,2020-10-27,540,19,521,3,0,3
DKI JAKARTA,JAKARTA SELATAN,KEBAYORAN LAMA,CIPULIR,3174051003,2020-10-28,540,15,525,0,-4,4
DKI JAKARTA,JAKARTA SELATAN,KEBAYORAN LAMA,CIPULIR,3174051003,2020-10-29,542,11,531,2,-4,6
DKI JAKARTA,JAKARTA SELATAN,KEBAYORAN LAMA,CIPULIR,3174051003,2020-10-30,544,12,532,2,1,1
DKI JAKARTA,JAKARTA SELATAN,KEBAYORAN LAMA,CIPULIR,3174051003,2020-10-31,548,16,532,4,4,0
DKI JAKARTA,JAKARTA SELATAN,KEBAYORAN LAMA,GROGOL SELATAN,3174051005,2020-10-01,515,22,493,0,0,0
DKI JAKARTA,JAKARTA SELATAN,KEBAYORAN LAMA,GROGOL SELATAN,3174051005,2020-10-02,523,25,498,8,3,5
DKI JAKARTA,JAKARTA SELATAN,KEBAYORAN LAMA,GROGOL SELATAN,3174051005,2020-10-03,525,29,496,2,4,-2
DKI JAKARTA,JAKARTA SELATAN,KEBAYORAN LAMA,GROGOL SELATAN,3174051005,2020-10-04,540,37,503,15,8,7
DKI JAKARTA,JAKARTA SELATAN,KEBAYORAN LAMA,GROGOL SELATAN,3174051005,2020-10-05,541,36,505,1,-1,2
DKI JAKARTA,JAKARTA SELATAN,KEBAYORAN LAMA,GROGOL SELATAN,3174051005,2020-10-06,545,35,510,4,-1,5
DKI JAKARTA,JAKARTA SELATAN,KEBAYORAN LAMA,GROGOL SELATAN,3174051005,2020-10-07,551,39,512,6,4,2
DKI JAKARTA,JAKARTA SELATAN,KEBAYORAN LAMA,GROGOL SELATAN,3174051005,2020-10-08,559,43,516,8,4,4
DKI JAKARTA,JAKARTA SELATAN,KEBAYORAN LAMA,GROGOL SELATAN,3174051005,2020-10-09,564,47,517,5,4,1
DKI JAKARTA,JAKARTA SELATAN,KEBAYORAN LAMA,GROGOL SELATAN,3174051005,2020-10-10,571,53,518,7,6,1
DKI JAKARTA,JAKARTA SELATAN,KEBAYORAN LAMA,GROGOL SELATAN,3174051005,2020-10-11,573,48,525,2,-5,7
DKI JAKARTA,JAKARTA SELATAN,KEBAYORAN LAMA,GROGOL SELATAN,3174051005,2020-10-12,576,42,534,3,-6,9
DKI JAKARTA,JAKARTA SELATAN,KEBAYORAN LAMA,GROGOL SELATAN,3174051005,2020-10-13,582,37,545,6,-5,11
DKI JAKARTA,JAKARTA SELATAN,KEBAYORAN LAMA,GROGOL SELATAN,3174051005,2020-10-14,583,34,549,1,-3,4
DKI JAKARTA,JAKARTA SELATAN,KEBAYORAN LAMA,GROGOL SELATAN,3174051005,2020-10-15,587,33,554,4,-1,5
DKI JAKARTA,JAKARTA SELATAN,KEBAYORAN LAMA,GROGOL SELATAN,3174051005,2020-10-16,589,24,565,2,-9,11
DKI JAKARTA,JAKARTA SELATAN,KEBAYORAN LAMA,GROGOL SELATAN,3174051005,2020-10-17,592,24,568,3,0,3
DKI JAKARTA,JAKARTA SELATAN,KEBAYORAN LAMA,GROGOL SELATAN,3174051005,2020-10-18,596,27,569,4,3,1
DKI JAKARTA,JAKARTA SELATAN,KEBAYORAN LAMA,GROGOL SELATAN,3174051005,2020-10-19,598,26,572,2,-1,3
DKI JAKARTA,JAKARTA SELATAN,KEBAYORAN LAMA,GROGOL SELATAN,3174051005,2020-10-20,601,26,575,3,0,3
DKI JAKARTA,JAKARTA SELATAN,KEBAYORAN LAMA,GROGOL SELATAN,3174051005,2020-10-21,602,21,581,1,-5,6
DKI JAKARTA,JAKARTA SELATAN,KEBAYORAN LAMA,GROGOL SELATAN,3174051005,2020-10-22,607,23,584,5,2,3
DKI JAKARTA,JAKARTA SELATAN,KEBAYORAN LAMA,GROGOL SELATAN,3174051005,2020-10-23,608,23,585,1,0,1
DKI JAKARTA,JAKARTA SELATAN,KEBAYORAN LAMA,GROGOL SELATAN,3174051005,2020-10-24,609,17,592,1,-6,7
DKI JAKARTA,JAKARTA SELATAN,KEBAYORAN LAMA,GROGOL SELATAN,3174051005,2020-10-25,616,17,599,7,0,7
DKI JAKARTA,JAKARTA SELATAN,KEBAYORAN LAMA,GROGOL SELATAN,3174051005,2020-10-26,619,16,603,3,-1,4
DKI JAKARTA,JAKARTA SELATAN,KEBAYORAN LAMA,GROGOL SELATAN,3174051005,2020-10-27,626,19,607,7,3,4
DKI JAKARTA,JAKARTA SELATAN,KEBAYORAN LAMA,GROGOL SELATAN,3174051005,2020-10-28,627,18,609,1,-1,2
DKI JAKARTA,JAKARTA SELATAN,KEBAYORAN LAMA,GROGOL SELATAN,3174051005,2020-10-29,628,18,611,1,0,2
DKI JAKARTA,JAKARTA SELATAN,KEBAYORAN LAMA,GROGOL SELATAN,3174051005,2020-10-30,636,25,612,8,7,1
DKI JAKARTA,JAKARTA SELATAN,KEBAYORAN LAMA,GROGOL SELATAN,3174051005,2020-10-31,649,37,613,13,12,1
DKI JAKARTA,JAKARTA SELATAN,KEBAYORAN LAMA,GROGOL UTARA,3174051004,2020-10-01,517,25,492,0,0,0
DKI JAKARTA,JAKARTA SELATAN,KEBAYORAN LAMA,GROGOL UTARA,3174051004,2020-10-02,526,32,494,9,7,2
DKI JAKARTA,JAKARTA SELATAN,KEBAYORAN LAMA,GROGOL UTARA,3174051004,2020-10-03,531,33,498,5,1,4
DKI JAKARTA,JAKARTA SELATAN,KEBAYORAN LAMA,GROGOL UTARA,3174051004,2020-10-04,536,37,499,5,4,1
DKI JAKARTA,JAKARTA SELATAN,KEBAYORAN LAMA,GROGOL UTARA,3174051004,2020-10-05,536,32,504,0,-5,5
DKI JAKARTA,JAKARTA SELATAN,KEBAYORAN LAMA,GROGOL UTARA,3174051004,2020-10-06,537,33,504,1,1,0
DKI JAKARTA,JAKARTA SELATAN,KEBAYORAN LAMA,GROGOL UTARA,3174051004,2020-10-07,548,38,510,11,5,6
DKI JAKARTA,JAKARTA SELATAN,KEBAYORAN LAMA,GROGOL UTARA,3174051004,2020-10-08,558,45,513,10,7,3
DKI JAKARTA,JAKARTA SELATAN,KEBAYORAN LAMA,GROGOL UTARA,3174051004,2020-10-09,567,53,514,9,8,1
DKI JAKARTA,JAKARTA SELATAN,KEBAYORAN LAMA,GROGOL UTARA,3174051004,2020-10-10,577,54,523,10,1,9
DKI JAKARTA,JAKARTA SELATAN,KEBAYORAN LAMA,GROGOL UTARA,3174051004,2020-10-11,580,52,528,3,-2,5
DKI JAKARTA,JAKARTA SELATAN,KEBAYORAN LAMA,GROGOL UTARA,3174051004,2020-10-12,585,51,534,5,-1,6
DKI JAKARTA,JAKARTA SELATAN,KEBAYORAN LAMA,GROGOL UTARA,3174051004,2020-10-13,586,52,534,1,1,0
DKI JAKARTA,JAKARTA SELATAN,KEBAYORAN LAMA,GROGOL UTARA,3174051004,2020-10-14,586,42,544,0,-10,10
DKI JAKARTA,JAKARTA SELATAN,KEBAYORAN LAMA,GROGOL UTARA,3174051004,2020-10-15,597,43,554,11,1,10
DKI JAKARTA,JAKARTA SELATAN,KEBAYORAN LAMA,GROGOL UTARA,3174051004,2020-10-16,601,38,563,4,-5,9
DKI JAKARTA,JAKARTA SELATAN,KEBAYORAN LAMA,GROGOL UTARA,3174051004,2020-10-17,610,45,565,9,7,2
DKI JAKARTA,JAKARTA SELATAN,KEBAYORAN LAMA,GROGOL UTARA,3174051004,2020-10-18,613,44,569,3,-1,4
DKI JAKARTA,JAKARTA SELATAN,KEBAYORAN LAMA,GROGOL UTARA,3174051004,2020-10-19,614,40,574,1,-4,5
DKI JAKARTA,JAKARTA SELATAN,KEBAYORAN LAMA,GROGOL UTARA,3174051004,2020-10-20,615,34,581,1,-6,7
DKI JAKARTA,JAKARTA SELATAN,KEBAYORAN LAMA,GROGOL UTARA,3174051004,2020-10-21,617,26,591,2,-8,10
DKI JAKARTA,JAKARTA SELATAN,KEBAYORAN LAMA,GROGOL UTARA,3174051004,2020-10-22,617,23,594,0,-3,3
DKI JAKARTA,JAKARTA SELATAN,KEBAYORAN LAMA,GROGOL UTARA,3174051004,2020-10-23,621,27,594,4,4,0
DKI JAKARTA,JAKARTA SELATAN,KEBAYORAN LAMA,GROGOL UTARA,3174051004,2020-10-24,621,26,595,0,-1,1
DKI JAKARTA,JAKARTA SELATAN,KEBAYORAN LAMA,GROGOL UTARA,3174051004,2020-10-25,623,24,599,2,-2,4
DKI JAKARTA,JAKARTA SELATAN,KEBAYORAN LAMA,GROGOL UTARA,3174051004,2020-10-26,627,25,602,4,1,3
DKI JAKARTA,JAKARTA SELATAN,KEBAYORAN LAMA,GROGOL UTARA,3174051004,2020-10-27,628,22,606,1,-3,4
DKI JAKARTA,JAKARTA SELATAN,KEBAYORAN LAMA,GROGOL UTARA,3174051004,2020-10-28,628,18,610,0,-4,4
DKI JAKARTA,JAKARTA SELATAN,KEBAYORAN LAMA,GROGOL UTARA,3174051004,2020-10-29,632,12,620,4,-6,10
DKI JAKARTA,JAKARTA SELATAN,KEBAYORAN LAMA,GROGOL UTARA,3174051004,2020-10-30,644,18,626,12,6,6
DKI JAKARTA,JAKARTA SELATAN,KEBAYORAN LAMA,GROGOL UTARA,3174051004,2020-10-31,649,22,627,5,4,1
DKI JAKARTA,JAKARTA SELATAN,KEBAYORAN LAMA,KEBAYORAN LAMA SELATAN,3174051006,2020-10-01,684,19,665,0,0,0
DKI JAKARTA,JAKARTA SELATAN,KEBAYORAN LAMA,KEBAYORAN LAMA SELATAN,3174051006,2020-10-02,691,22,669,7,3,4
DKI JAKARTA,JAKARTA SELATAN,KEBAYORAN LAMA,KEBAYORAN LAMA SELATAN,3174051006,2020-10-03,700,28,672,9,6,3
DKI JAKARTA,JAKARTA SELATAN,KEBAYORAN LAMA,KEBAYORAN LAMA SELATAN,3174051006,2020-10-04,703,30,673,3,2,1
DKI JAKARTA,JAKARTA SELATAN,KEBAYORAN LAMA,KEBAYORAN LAMA SELATAN,3174051006,2020-10-05,707,31,676,4,1,3
DKI JAKARTA,JAKARTA SELATAN,KEBAYORAN LAMA,KEBAYORAN LAMA SELATAN,3174051006,2020-10-06,707,28,679,0,-3,3
DKI JAKARTA,JAKARTA SELATAN,KEBAYORAN LAMA,KEBAYORAN LAMA SELATAN,3174051006,2020-10-07,708,25,683,1,-3,4
DKI JAKARTA,JAKARTA SELATAN,KEBAYORAN LAMA,KEBAYORAN LAMA SELATAN,3174051006,2020-10-08,715,32,683,7,7,0
DKI JAKARTA,JAKARTA SELATAN,KEBAYORAN LAMA,KEBAYORAN LAMA SELATAN,3174051006,2020-10-09,716,33,683,1,1,0
DKI JAKARTA,JAKARTA SELATAN,KEBAYORAN LAMA,KEBAYORAN LAMA SELATAN,3174051006,2020-10-10,728,40,688,12,7,5
DKI JAKARTA,JAKARTA SELATAN,KEBAYORAN LAMA,KEBAYORAN LAMA SELATAN,3174051006,2020-10-11,729,39,690,1,-1,2
DKI JAKARTA,JAKARTA SELATAN,KEBAYORAN LAMA,KEBAYORAN LAMA SELATAN,3174051006,2020-10-12,731,33,698,2,-6,8
DKI JAKARTA,JAKARTA SELATAN,KEBAYORAN LAMA,KEBAYORAN LAMA SELATAN,3174051006,2020-10-13,735,32,703,4,-1,5
DKI JAKARTA,JAKARTA SELATAN,KEBAYORAN LAMA,KEBAYORAN LAMA SELATAN,3174051006,2020-10-14,735,28,707,0,-4,4
DKI JAKARTA,JAKARTA SELATAN,KEBAYORAN LAMA,KEBAYORAN LAMA SELATAN,3174051006,2020-10-15,739,26,713,4,-2,6
DKI JAKARTA,JAKARTA SELATAN,KEBAYORAN LAMA,KEBAYORAN LAMA SELATAN,3174051006,2020-10-16,746,30,716,7,4,3
DKI JAKARTA,JAKARTA SELATAN,KEBAYORAN LAMA,KEBAYORAN LAMA SELATAN,3174051006,2020-10-17,758,41,717,12,11,1
DKI JAKARTA,JAKARTA SELATAN,KEBAYORAN LAMA,KEBAYORAN LAMA SELATAN,3174051006,2020-10-18,766,49,717,8,8,0
DKI JAKARTA,JAKARTA SELATAN,KEBAYORAN LAMA,KEBAYORAN LAMA SELATAN,3174051006,2020-10-19,772,51,721,6,2,4
DKI JAKARTA,JAKARTA SELATAN,KEBAYORAN LAMA,KEBAYORAN LAMA SELATAN,3174051006,2020-10-20,775,50,725,3,-1,4
DKI JAKARTA,JAKARTA SELATAN,KEBAYORAN LAMA,KEBAYORAN LAMA SELATAN,3174051006,2020-10-21,775,40,735,0,-10,10
DKI JAKARTA,JAKARTA SELATAN,KEBAYORAN LAMA,KEBAYORAN LAMA SELATAN,3174051006,2020-10-22,776,38,738,1,-2,3
DKI JAKARTA,JAKARTA SELATAN,KEBAYORAN LAMA,KEBAYORAN LAMA SELATAN,3174051006,2020-10-23,780,41,739,4,3,1
DKI JAKARTA,JAKARTA SELATAN,KEBAYORAN LAMA,KEBAYORAN LAMA SELATAN,3174051006,2020-10-24,781,35,746,1,-6,7
DKI JAKARTA,JAKARTA SELATAN,KEBAYORAN LAMA,KEBAYORAN LAMA SELATAN,3174051006,2020-10-25,782,33,749,1,-2,3
DKI JAKARTA,JAKARTA SELATAN,KEBAYORAN LAMA,KEBAYORAN LAMA SELATAN,3174051006,2020-10-26,784,29,755,2,-4,6
DKI JAKARTA,JAKARTA SELATAN,KEBAYORAN LAMA,KEBAYORAN LAMA SELATAN,3174051006,2020-10-27,789,29,760,5,0,5
DKI JAKARTA,JAKARTA SELATAN,KEBAYORAN LAMA,KEBAYORAN LAMA SELATAN,3174051006,2020-10-28,791,19,772,2,-10,12
DKI JAKARTA,JAKARTA SELATAN,KEBAYORAN LAMA,KEBAYORAN LAMA SELATAN,3174051006,2020-10-29,792,16,776,1,-3,4
DKI JAKARTA,JAKARTA SELATAN,KEBAYORAN LAMA,KEBAYORAN LAMA SELATAN,3174051006,2020-10-30,804,22,782,12,6,6
DKI JAKARTA,JAKARTA SELATAN,KEBAYORAN LAMA,KEBAYORAN LAMA SELATAN,3174051006,2020-10-31,810,25,785,6,3,3
DKI JAKARTA,JAKARTA SELATAN,KEBAYORAN LAMA,KEBAYORAN LAMA UTARA,3174051001,2020-10-01,418,15,403,0,0,0
DKI JAKARTA,JAKARTA SELATAN,KEBAYORAN LAMA,KEBAYORAN LAMA UTARA,3174051001,2020-10-02,432,27,405,14,12,2
DKI JAKARTA,JAKARTA SELATAN,KEBAYORAN LAMA,KEBAYORAN LAMA UTARA,3174051001,2020-10-03,436,31,405,4,4,0
DKI JAKARTA,JAKARTA SELATAN,KEBAYORAN LAMA,KEBAYORAN LAMA UTARA,3174051001,2020-10-04,437,31,406,1,0,1
DKI JAKARTA,JAKARTA SELATAN,KEBAYORAN LAMA,KEBAYORAN LAMA UTARA,3174051001,2020-10-05,438,27,411,1,-4,5
DKI JAKARTA,JAKARTA SELATAN,KEBAYORAN LAMA,KEBAYORAN LAMA UTARA,3174051001,2020-10-06,441,29,412,3,2,1
DKI JAKARTA,JAKARTA SELATAN,KEBAYORAN LAMA,KEBAYORAN LAMA UTARA,3174051001,2020-10-07,445,30,415,4,1,3
DKI JAKARTA,JAKARTA SELATAN,KEBAYORAN LAMA,KEBAYORAN LAMA UTARA,3174051001,2020-10-08,448,30,418,3,0,3
DKI JAKARTA,JAKARTA SELATAN,KEBAYORAN LAMA,KEBAYORAN LAMA UTARA,3174051001,2020-10-09,456,35,421,8,5,3
DKI JAKARTA,JAKARTA SELATAN,KEBAYORAN LAMA,KEBAYORAN LAMA UTARA,3174051001,2020-10-10,467,43,424,11,8,3
DKI JAKARTA,JAKARTA SELATAN,KEBAYORAN LAMA,KEBAYORAN LAMA UTARA,3174051001,2020-10-11,469,44,425,2,1,1
DKI JAKARTA,JAKARTA SELATAN,KEBAYORAN LAMA,KEBAYORAN LAMA UTARA,3174051001,2020-10-12,474,36,438,5,-8,13
DKI JAKARTA,JAKARTA SELATAN,KEBAYORAN LAMA,KEBAYORAN LAMA UTARA,3174051001,2020-10-13,481,41,440,7,5,2
DKI JAKARTA,JAKARTA SELATAN,KEBAYORAN LAMA,KEBAYORAN LAMA UTARA,3174051001,2020-10-14,483,36,447,2,-5,7
DKI JAKARTA,JAKARTA SELATAN,KEBAYORAN LAMA,KEBAYORAN LAMA UTARA,3174051001,2020-10-15,487,38,449,4,2,2
DKI JAKARTA,JAKARTA SELATAN,KEBAYORAN LAMA,KEBAYORAN LAMA UTARA,3174051001,2020-10-16,490,35,455,3,-3,6
DKI JAKARTA,JAKARTA SELATAN,KEBAYORAN LAMA,KEBAYORAN LAMA UTARA,3174051001,2020-10-17,493,38,455,3,3,0
DKI JAKARTA,JAKARTA SELATAN,KEBAYORAN LAMA,KEBAYORAN LAMA UTARA,3174051001,2020-10-18,498,42,456,5,4,1
DKI JAKARTA,JAKARTA SELATAN,KEBAYORAN LAMA,KEBAYORAN LAMA UTARA,3174051001,2020-10-19,500,36,464,2,-6,8
DKI JAKARTA,JAKARTA SELATAN,KEBAYORAN LAMA,KEBAYORAN LAMA UTARA,3174051001,2020-10-20,504,34,470,4,-2,6
DKI JAKARTA,JAKARTA SELATAN,KEBAYORAN LAMA,KEBAYORAN LAMA UTARA,3174051001,2020-10-21,504,24,480,0,-10,10
DKI JAKARTA,JAKARTA SELATAN,KEBAYORAN LAMA,KEBAYORAN LAMA UTARA,3174051001,2020-10-22,506,19,487,2,-5,7
DKI JAKARTA,JAKARTA SELATAN,KEBAYORAN LAMA,KEBAYORAN LAMA UTARA,3174051001,2020-10-23,508,20,488,2,1,1
DKI JAKARTA,JAKARTA SELATAN,KEBAYORAN LAMA,KEBAYORAN LAMA UTARA,3174051001,2020-10-24,513,18,495,5,-2,7
DKI JAKARTA,JAKARTA SELATAN,KEBAYORAN LAMA,KEBAYORAN LAMA UTARA,3174051001,2020-10-25,517,19,498,4,1,3
DKI JAKARTA,JAKARTA SELATAN,KEBAYORAN LAMA,KEBAYORAN LAMA UTARA,3174051001,2020-10-26,522,15,507,5,-4,9
DKI JAKARTA,JAKARTA SELATAN,KEBAYORAN LAMA,KEBAYORAN LAMA UTARA,3174051001,2020-10-27,524,14,510,2,-1,3
DKI JAKARTA,JAKARTA SELATAN,KEBAYORAN LAMA,KEBAYORAN LAMA UTARA,3174051001,2020-10-28,525,12,513,1,-2,3
DKI JAKARTA,JAKARTA SELATAN,KEBAYORAN LAMA,KEBAYORAN LAMA UTARA,3174051001,2020-10-29,526,12,514,1,0,1
DKI JAKARTA,JAKARTA SELATAN,KEBAYORAN LAMA,KEBAYORAN LAMA UTARA,3174051001,2020-10-30,535,19,516,9,7,2
DKI JAKARTA,JAKARTA SELATAN,KEBAYORAN LAMA,KEBAYORAN LAMA UTARA,3174051001,2020-10-31,544,28,516,9,9,0
DKI JAKARTA,JAKARTA SELATAN,KEBAYORAN LAMA,PONDOK PINANG,3174051002,2020-10-01,684,30,654,0,0,0
DKI JAKARTA,JAKARTA SELATAN,KEBAYORAN LAMA,PONDOK PINANG,3174051002,2020-10-02,710,47,663,26,17,9
DKI JAKARTA,JAKARTA SELATAN,KEBAYORAN LAMA,PONDOK PINANG,3174051002,2020-10-03,740,71,669,30,24,6
DKI JAKARTA,JAKARTA SELATAN,KEBAYORAN LAMA,PONDOK PINANG,3174051002,2020-10-04,749,79,670,9,8,1
DKI JAKARTA,JAKARTA SELATAN,KEBAYORAN LAMA,PONDOK PINANG,3174051002,2020-10-05,755,83,672,6,4,2
DKI JAKARTA,JAKARTA SELATAN,KEBAYORAN LAMA,PONDOK PINANG,3174051002,2020-10-06,756,81,675,1,-2,3
DKI JAKARTA,JAKARTA SELATAN,KEBAYORAN LAMA,PONDOK PINANG,3174051002,2020-10-07,765,85,680,9,4,5
DKI JAKARTA,JAKARTA SELATAN,KEBAYORAN LAMA,PONDOK PINANG,3174051002,2020-10-08,774,90,684,9,5,4
DKI JAKARTA,JAKARTA SELATAN,KEBAYORAN LAMA,PONDOK PINANG,3174051002,2020-10-09,785,96,689,11,6,5
DKI JAKARTA,JAKARTA SELATAN,KEBAYORAN LAMA,PONDOK PINANG,3174051002,2020-10-10,797,96,701,12,0,12
DKI JAKARTA,JAKARTA SELATAN,KEBAYORAN LAMA,PONDOK PINANG,3174051002,2020-10-11,799,94,705,2,-2,4
DKI JAKARTA,JAKARTA SELATAN,KEBAYORAN LAMA,PONDOK PINANG,3174051002,2020-10-12,805,72,733,6,-22,28
DKI JAKARTA,JAKARTA SELATAN,KEBAYORAN LAMA,PONDOK PINANG,3174051002,2020-10-13,810,61,749,5,-11,16
DKI JAKARTA,JAKARTA SELATAN,KEBAYORAN LAMA,PONDOK PINANG,3174051002,2020-10-14,810,44,766,0,-17,17
DKI JAKARTA,JAKARTA SELATAN,KEBAYORAN LAMA,PONDOK PINANG,3174051002,2020-10-15,820,44,776,10,0,10
DKI JAKARTA,JAKARTA SELATAN,KEBAYORAN LAMA,PONDOK PINANG,3174051002,2020-10-16,828,47,781,8,3,5
DKI JAKARTA,JAKARTA SELATAN,KEBAYORAN LAMA,PONDOK PINANG,3174051002,2020-10-17,844,61,783,16,14,2
DKI JAKARTA,JAKARTA SELATAN,KEBAYORAN LAMA,PONDOK PINANG,3174051002,2020-10-18,847,63,784,3,2,1
DKI JAKARTA,JAKARTA SELATAN,KEBAYORAN LAMA,PONDOK PINANG,3174051002,2020-10-19,849,55,794,2,-8,10
DKI JAKARTA,JAKARTA SELATAN,KEBAYORAN LAMA,PONDOK PINANG,3174051002,2020-10-20,858,58,800,9,3,6
DKI JAKARTA,JAKARTA SELATAN,KEBAYORAN LAMA,PONDOK PINANG,3174051002,2020-10-21,859,48,811,1,-10,11
DKI JAKARTA,JAKARTA SELATAN,KEBAYORAN LAMA,PONDOK PINANG,3174051002,2020-10-22,865,41,824,6,-7,13
DKI JAKARTA,JAKARTA SELATAN,KEBAYORAN LAMA,PONDOK PINANG,3174051002,2020-10-23,872,42,830,7,1,6
DKI JAKARTA,JAKARTA SELATAN,KEBAYORAN LAMA,PONDOK PINANG,3174051002,2020-10-24,874,34,840,2,-8,10
DKI JAKARTA,JAKARTA SELATAN,KEBAYORAN LAMA,PONDOK PINANG,3174051002,2020-10-25,889,39,850,15,5,10
DKI JAKARTA,JAKARTA SELATAN,KEBAYORAN LAMA,PONDOK PINANG,3174051002,2020-10-26,896,31,865,7,-8,15
DKI JAKARTA,JAKARTA SELATAN,KEBAYORAN LAMA,PONDOK PINANG,3174051002,2020-10-27,908,40,868,12,9,3
DKI JAKARTA,JAKARTA SELATAN,KEBAYORAN LAMA,PONDOK PINANG,3174051002,2020-10-28,908,36,872,0,-4,4
DKI JAKARTA,JAKARTA SELATAN,KEBAYORAN LAMA,PONDOK PINANG,3174051002,2020-10-29,917,36,881,9,0,9
DKI JAKARTA,JAKARTA SELATAN,KEBAYORAN LAMA,PONDOK PINANG,3174051002,2020-10-30,926,40,886,9,4,5
DKI JAKARTA,JAKARTA SELATAN,KEBAYORAN LAMA,PONDOK PINANG,3174051002,2020-10-31,939,51,888,13,11,2
DKI JAKARTA,JAKARTA SELATAN,MAMPANG PRAPATAN,BANGKA,3174031002,2020-10-01,555,40,515,0,0,0
DKI JAKARTA,JAKARTA SELATAN,MAMPANG PRAPATAN,BANGKA,3174031002,2020-10-02,563,38,525,8,-2,10
DKI JAKARTA,JAKARTA SELATAN,MAMPANG PRAPATAN,BANGKA,3174031002,2020-10-03,564,38,526,1,0,1
DKI JAKARTA,JAKARTA SELATAN,MAMPANG PRAPATAN,BANGKA,3174031002,2020-10-04,569,41,528,5,3,2
DKI JAKARTA,JAKARTA SELATAN,MAMPANG PRAPATAN,BANGKA,3174031002,2020-10-05,569,38,531,0,-3,3
DKI JAKARTA,JAKARTA SELATAN,MAMPANG PRAPATAN,BANGKA,3174031002,2020-10-06,577,38,539,8,0,8
DKI JAKARTA,JAKARTA SELATAN,MAMPANG PRAPATAN,BANGKA,3174031002,2020-10-07,581,40,541,4,2,2
DKI JAKARTA,JAKARTA SELATAN,MAMPANG PRAPATAN,BANGKA,3174031002,2020-10-08,594,40,554,13,0,13
DKI JAKARTA,JAKARTA SELATAN,MAMPANG PRAPATAN,BANGKA,3174031002,2020-10-09,596,42,554,2,2,0
DKI JAKARTA,JAKARTA SELATAN,MAMPANG PRAPATAN,BANGKA,3174031002,2020-10-10,606,48,558,10,6,4
DKI JAKARTA,JAKARTA SELATAN,MAMPANG PRAPATAN,BANGKA,3174031002,2020-10-11,624,65,559,18,17,1
DKI JAKARTA,JAKARTA SELATAN,MAMPANG PRAPATAN,BANGKA,3174031002,2020-10-12,626,62,564,2,-3,5
DKI JAKARTA,JAKARTA SELATAN,MAMPANG PRAPATAN,BANGKA,3174031002,2020-10-13,628,63,565,2,1,1
DKI JAKARTA,JAKARTA SELATAN,MAMPANG PRAPATAN,BANGKA,3174031002,2020-10-14,634,67,567,6,4,2
DKI JAKARTA,JAKARTA SELATAN,MAMPANG PRAPATAN,BANGKA,3174031002,2020-10-15,641,60,581,7,-7,14
DKI JAKARTA,JAKARTA SELATAN,MAMPANG PRAPATAN,BANGKA,3174031002,2020-10-16,643,56,587,2,-4,6
DKI JAKARTA,JAKARTA SELATAN,MAMPANG PRAPATAN,BANGKA,3174031002,2020-10-17,648,57,591,5,1,4
DKI JAKARTA,JAKARTA SELATAN,MAMPANG PRAPATAN,BANGKA,3174031002,2020-10-18,649,58,591,1,1,0
DKI JAKARTA,JAKARTA SELATAN,MAMPANG PRAPATAN,BANGKA,3174031002,2020-10-19,649,53,596,0,-5,5
DKI JAKARTA,JAKARTA SELATAN,MAMPANG PRAPATAN,BANGKA,3174031002,2020-10-20,651,47,604,2,-6,8
DKI JAKARTA,JAKARTA SELATAN,MAMPANG PRAPATAN,BANGKA,3174031002,2020-10-21,654,35,619,3,-12,15
DKI JAKARTA,JAKARTA SELATAN,MAMPANG PRAPATAN,BANGKA,3174031002,2020-10-22,655,21,634,1,-14,15
DKI JAKARTA,JAKARTA SELATAN,MAMPANG PRAPATAN,BANGKA,3174031002,2020-10-23,661,27,634,6,6,0
DKI JAKARTA,JAKARTA SELATAN,MAMPANG PRAPATAN,BANGKA,3174031002,2020-10-24,665,28,637,4,1,3
DKI JAKARTA,JAKARTA SELATAN,MAMPANG PRAPATAN,BANGKA,3174031002,2020-10-25,667,29,638,2,1,1
DKI JAKARTA,JAKARTA SELATAN,MAMPANG PRAPATAN,BANGKA,3174031002,2020-10-26,668,22,646,1,-7,8
DKI JAKARTA,JAKARTA SELATAN,MAMPANG PRAPATAN,BANGKA,3174031002,2020-10-27,674,23,651,6,1,5
DKI JAKARTA,JAKARTA SELATAN,MAMPANG PRAPATAN,BANGKA,3174031002,2020-10-28,683,29,654,9,6,3
DKI JAKARTA,JAKARTA SELATAN,MAMPANG PRAPATAN,BANGKA,3174031002,2020-10-29,685,24,661,2,-5,7
DKI JAKARTA,JAKARTA SELATAN,MAMPANG PRAPATAN,BANGKA,3174031002,2020-10-30,689,28,661,4,4,0
DKI JAKARTA,JAKARTA SELATAN,MAMPANG PRAPATAN,BANGKA,3174031002,2020-10-31,695,34,661,6,6,0
DKI JAKARTA,JAKARTA SELATAN,MAMPANG PRAPATAN,KUNINGAN BARAT,3174031005,2020-10-01,424,55,369,0,0,0
DKI JAKARTA,JAKARTA SELATAN,MAMPANG PRAPATAN,KUNINGAN BARAT,3174031005,2020-10-02,428,43,385,4,-12,16
DKI JAKARTA,JAKARTA SELATAN,MAMPANG PRAPATAN,KUNINGAN BARAT,3174031005,2020-10-03,432,45,387,4,2,2
DKI JAKARTA,JAKARTA SELATAN,MAMPANG PRAPATAN,KUNINGAN BARAT,3174031005,2020-10-04,433,45,388,1,0,1
DKI JAKARTA,JAKARTA SELATAN,MAMPANG PRAPATAN,KUNINGAN BARAT,3174031005,2020-10-05,438,44,394,5,-1,6
DKI JAKARTA,JAKARTA SELATAN,MAMPANG PRAPATAN,KUNINGAN BARAT,3174031005,2020-10-06,439,39,400,1,-5,6
DKI JAKARTA,JAKARTA SELATAN,MAMPANG PRAPATAN,KUNINGAN BARAT,3174031005,2020-10-07,445,33,412,6,-6,12
DKI JAKARTA,JAKARTA SELATAN,MAMPANG PRAPATAN,KUNINGAN BARAT,3174031005,2020-10-08,451,37,414,6,4,2
DKI JAKARTA,JAKARTA SELATAN,MAMPANG PRAPATAN,KUNINGAN BARAT,3174031005,2020-10-09,451,37,414,0,0,0
DKI JAKARTA,JAKARTA SELATAN,MAMPANG PRAPATAN,KUNINGAN BARAT,3174031005,2020-10-10,452,34,418,1,-3,4
DKI JAKARTA,JAKARTA SELATAN,MAMPANG PRAPATAN,KUNINGAN BARAT,3174031005,2020-10-11,453,35,418,1,1,0
DKI JAKARTA,JAKARTA SELATAN,MAMPANG PRAPATAN,KUNINGAN BARAT,3174031005,2020-10-12,454,25,429,1,-10,11
DKI JAKARTA,JAKARTA SELATAN,MAMPANG PRAPATAN,KUNINGAN BARAT,3174031005,2020-10-13,455,22,433,1,-3,4
DKI JAKARTA,JAKARTA SELATAN,MAMPANG PRAPATAN,KUNINGAN BARAT,3174031005,2020-10-14,460,24,436,5,2,3
DKI JAKARTA,JAKARTA SELATAN,MAMPANG PRAPATAN,KUNINGAN BARAT,3174031005,2020-10-15,464,26,438,4,2,2
DKI JAKARTA,JAKARTA SELATAN,MAMPANG PRAPATAN,KUNINGAN BARAT,3174031005,2020-10-16,465,18,447,1,-8,9
DKI JAKARTA,JAKARTA SELATAN,MAMPANG PRAPATAN,KUNINGAN BARAT,3174031005,2020-10-17,470,23,447,5,5,0
DKI JAKARTA,JAKARTA SELATAN,MAMPANG PRAPATAN,KUNINGAN BARAT,3174031005,2020-10-18,471,23,448,1,0,1
DKI JAKARTA,JAKARTA SELATAN,MAMPANG PRAPATAN,KUNINGAN BARAT,3174031005,2020-10-19,471,19,452,0,-4,4
DKI JAKARTA,JAKARTA SELATAN,MAMPANG PRAPATAN,KUNINGAN BARAT,3174031005,2020-10-20,471,19,452,0,0,0
DKI JAKARTA,JAKARTA SELATAN,MAMPANG PRAPATAN,KUNINGAN BARAT,3174031005,2020-10-21,472,19,453,1,0,1
DKI JAKARTA,JAKARTA SELATAN,MAMPANG PRAPATAN,KUNINGAN BARAT,3174031005,2020-10-22,476,23,453,4,4,0
DKI JAKARTA,JAKARTA SELATAN,MAMPANG PRAPATAN,KUNINGAN BARAT,3174031005,2020-10-23,476,23,453,0,0,0
DKI JAKARTA,JAKARTA SELATAN,MAMPANG PRAPATAN,KUNINGAN BARAT,3174031005,2020-10-24,477,22,455,1,-1,2
DKI JAKARTA,JAKARTA SELATAN,MAMPANG PRAPATAN,KUNINGAN BARAT,3174031005,2020-10-25,477,21,456,0,-1,1
DKI JAKARTA,JAKARTA SELATAN,MAMPANG PRAPATAN,KUNINGAN BARAT,3174031005,2020-10-26,478,16,462,1,-5,6
DKI JAKARTA,JAKARTA SELATAN,MAMPANG PRAPATAN,KUNINGAN BARAT,3174031005,2020-10-27,478,11,467,0,-5,5
DKI JAKARTA,JAKARTA SELATAN,MAMPANG PRAPATAN,KUNINGAN BARAT,3174031005,2020-10-28,484,16,468,6,5,1
DKI JAKARTA,JAKARTA SELATAN,MAMPANG PRAPATAN,KUNINGAN BARAT,3174031005,2020-10-29,485,12,473,1,-4,5
DKI JAKARTA,JAKARTA SELATAN,MAMPANG PRAPATAN,KUNINGAN BARAT,3174031005,2020-10-30,491,16,475,6,4,2
DKI JAKARTA,JAKARTA SELATAN,MAMPANG PRAPATAN,KUNINGAN BARAT,3174031005,2020-10-31,492,14,478,1,-2,3
DKI JAKARTA,JAKARTA SELATAN,MAMPANG PRAPATAN,MAMPANG PRAPATAN,3174031001,2020-10-01,888,67,821,0,0,0
DKI JAKARTA,JAKARTA SELATAN,MAMPANG PRAPATAN,MAMPANG PRAPATAN,3174031001,2020-10-02,900,69,831,12,2,10
DKI JAKARTA,JAKARTA SELATAN,MAMPANG PRAPATAN,MAMPANG PRAPATAN,3174031001,2020-10-03,908,77,831,8,8,0
DKI JAKARTA,JAKARTA SELATAN,MAMPANG PRAPATAN,MAMPANG PRAPATAN,3174031001,2020-10-04,917,82,835,9,5,4
DKI JAKARTA,JAKARTA SELATAN,MAMPANG PRAPATAN,MAMPANG PRAPATAN,3174031001,2020-10-05,922,72,850,5,-10,15
DKI JAKARTA,JAKARTA SELATAN,MAMPANG PRAPATAN,MAMPANG PRAPATAN,3174031001,2020-10-06,932,79,853,10,7,3
DKI JAKARTA,JAKARTA SELATAN,MAMPANG PRAPATAN,MAMPANG PRAPATAN,3174031001,2020-10-07,935,73,862,3,-6,9
DKI JAKARTA,JAKARTA SELATAN,MAMPANG PRAPATAN,MAMPANG PRAPATAN,3174031001,2020-10-08,942,72,870,7,-1,8
DKI JAKARTA,JAKARTA SELATAN,MAMPANG PRAPATAN,MAMPANG PRAPATAN,3174031001,2020-10-09,945,75,870,3,3,0
DKI JAKARTA,JAKARTA SELATAN,MAMPANG PRAPATAN,MAMPANG PRAPATAN,3174031001,2020-10-10,950,70,880,5,-5,10
DKI JAKARTA,JAKARTA SELATAN,MAMPANG PRAPATAN,MAMPANG PRAPATAN,3174031001,2020-10-11,965,83,882,15,13,2
DKI JAKARTA,JAKARTA SELATAN,MAMPANG PRAPATAN,MAMPANG PRAPATAN,3174031001,2020-10-12,970,65,905,5,-18,23
DKI JAKARTA,JAKARTA SELATAN,MAMPANG PRAPATAN,MAMPANG PRAPATAN,3174031001,2020-10-13,971,58,913,1,-7,8
DKI JAKARTA,JAKARTA SELATAN,MAMPANG PRAPATAN,MAMPANG PRAPATAN,3174031001,2020-10-14,974,54,920,3,-4,7
DKI JAKARTA,JAKARTA SELATAN,MAMPANG PRAPATAN,MAMPANG PRAPATAN,3174031001,2020-10-15,981,46,935,7,-8,15
DKI JAKARTA,JAKARTA SELATAN,MAMPANG PRAPATAN,MAMPANG PRAPATAN,3174031001,2020-10-16,982,39,943,1,-7,8
DKI JAKARTA,JAKARTA SELATAN,MAMPANG PRAPATAN,MAMPANG PRAPATAN,3174031001,2020-10-17,989,44,945,7,5,2
DKI JAKARTA,JAKARTA SELATAN,MAMPANG PRAPATAN,MAMPANG PRAPATAN,3174031001,2020-10-18,993,47,946,4,3,1
DKI JAKARTA,JAKARTA SELATAN,MAMPANG PRAPATAN,MAMPANG PRAPATAN,3174031001,2020-10-19,993,44,949,0,-3,3
DKI JAKARTA,JAKARTA SELATAN,MAMPANG PRAPATAN,MAMPANG PRAPATAN,3174031001,2020-10-20,996,44,952,3,0,3
DKI JAKARTA,JAKARTA SELATAN,MAMPANG PRAPATAN,MAMPANG PRAPATAN,3174031001,2020-10-21,1010,45,965,14,1,13
DKI JAKARTA,JAKARTA SELATAN,MAMPANG PRAPATAN,MAMPANG PRAPATAN,3174031001,2020-10-22,1012,39,973,2,-6,8
DKI JAKARTA,JAKARTA SELATAN,MAMPANG PRAPATAN,MAMPANG PRAPATAN,3174031001,2020-10-23,1022,48,974,10,9,1
DKI JAKARTA,JAKARTA SELATAN,MAMPANG PRAPATAN,MAMPANG PRAPATAN,3174031001,2020-10-24,1025,46,979,3,-2,5
DKI JAKARTA,JAKARTA SELATAN,MAMPANG PRAPATAN,MAMPANG PRAPATAN,3174031001,2020-10-25,1029,48,981,4,2,2
DKI JAKARTA,JAKARTA SELATAN,MAMPANG PRAPATAN,MAMPANG PRAPATAN,3174031001,2020-10-26,1030,45,985,1,-3,4
DKI JAKARTA,JAKARTA SELATAN,MAMPANG PRAPATAN,MAMPANG PRAPATAN,3174031001,2020-10-27,1033,44,989,3,-1,4
DKI JAKARTA,JAKARTA SELATAN,MAMPANG PRAPATAN,MAMPANG PRAPATAN,3174031001,2020-10-28,1035,42,993,2,-2,4
DKI JAKARTA,JAKARTA SELATAN,MAMPANG PRAPATAN,MAMPANG PRAPATAN,3174031001,2020-10-29,1037,31,1006,2,-11,13
DKI JAKARTA,JAKARTA SELATAN,MAMPANG PRAPATAN,MAMPANG PRAPATAN,3174031001,2020-10-30,1039,28,1011,2,-3,5
DKI JAKARTA,JAKARTA SELATAN,MAMPANG PRAPATAN,MAMPANG PRAPATAN,3174031001,2020-10-31,1050,37,1013,11,9,2
DKI JAKARTA,JAKARTA SELATAN,MAMPANG PRAPATAN,PELA MAMPANG,3174031003,2020-10-01,1234,172,1062,0,0,0
DKI JAKARTA,JAKARTA SELATAN,MAMPANG PRAPATAN,PELA MAMPANG,3174031003,2020-10-02,1261,173,1088,27,1,26
DKI JAKARTA,JAKARTA SELATAN,MAMPANG PRAPATAN,PELA MAMPANG,3174031003,2020-10-03,1287,195,1092,26,22,4
DKI JAKARTA,JAKARTA SELATAN,MAMPANG PRAPATAN,PELA MAMPANG,3174031003,2020-10-04,1296,204,1092,9,9,0
DKI JAKARTA,JAKARTA SELATAN,MAMPANG PRAPATAN,PELA MAMPANG,3174031003,2020-10-05,1303,174,1129,7,-30,37
DKI JAKARTA,JAKARTA SELATAN,MAMPANG PRAPATAN,PELA MAMPANG,3174031003,2020-10-06,1312,157,1155,9,-17,26
DKI JAKARTA,JAKARTA SELATAN,MAMPANG PRAPATAN,PELA MAMPANG,3174031003,2020-10-07,1325,149,1176,13,-8,21
DKI JAKARTA,JAKARTA SELATAN,MAMPANG PRAPATAN,PELA MAMPANG,3174031003,2020-10-08,1348,151,1197,23,2,21
DKI JAKARTA,JAKARTA SELATAN,MAMPANG PRAPATAN,PELA MAMPANG,3174031003,2020-10-09,1351,154,1197,3,3,0
DKI JAKARTA,JAKARTA SELATAN,MAMPANG PRAPATAN,PELA MAMPANG,3174031003,2020-10-10,1369,149,1220,18,-5,23
DKI JAKARTA,JAKARTA SELATAN,MAMPANG PRAPATAN,PELA MAMPANG,3174031003,2020-10-11,1404,182,1222,35,33,2
DKI JAKARTA,JAKARTA SELATAN,MAMPANG PRAPATAN,PELA MAMPANG,3174031003,2020-10-12,1406,148,1258,2,-34,36
DKI JAKARTA,JAKARTA SELATAN,MAMPANG PRAPATAN,PELA MAMPANG,3174031003,2020-10-13,1409,114,1295,3,-34,37
DKI JAKARTA,JAKARTA SELATAN,MAMPANG PRAPATAN,PELA MAMPANG,3174031003,2020-10-14,1418,109,1309,9,-5,14
DKI JAKARTA,JAKARTA SELATAN,MAMPANG PRAPATAN,PELA MAMPANG,3174031003,2020-10-15,1425,104,1321,7,-5,12
DKI JAKARTA,JAKARTA SELATAN,MAMPANG PRAPATAN,PELA MAMPANG,3174031003,2020-10-16,1429,87,1342,4,-17,21
DKI JAKARTA,JAKARTA SELATAN,MAMPANG PRAPATAN,PELA MAMPANG,3174031003,2020-10-17,1442,98,1344,13,11,2
DKI JAKARTA,JAKARTA SELATAN,MAMPANG PRAPATAN,PELA MAMPANG,3174031003,2020-10-18,1448,101,1347,6,3,3
DKI JAKARTA,JAKARTA SELATAN,MAMPANG PRAPATAN,PELA MAMPANG,3174031003,2020-10-19,1450,88,1362,2,-13,15
DKI JAKARTA,JAKARTA SELATAN,MAMPANG PRAPATAN,PELA MAMPANG,3174031003,2020-10-20,1462,86,1376,12,-2,14
DKI JAKARTA,JAKARTA SELATAN,MAMPANG PRAPATAN,PELA MAMPANG,3174031003,2020-10-21,1480,95,1385,18,9,9
DKI JAKARTA,JAKARTA SELATAN,MAMPANG PRAPATAN,PELA MAMPANG,3174031003,2020-10-22,1495,93,1402,15,-2,17
DKI JAKARTA,JAKARTA SELATAN,MAMPANG PRAPATAN,PELA MAMPANG,3174031003,2020-10-23,1503,101,1402,8,8,0
DKI JAKARTA,JAKARTA SELATAN,MAMPANG PRAPATAN,PELA MAMPANG,3174031003,2020-10-24,1511,85,1426,8,-16,24
DKI JAKARTA,JAKARTA SELATAN,MAMPANG PRAPATAN,PELA MAMPANG,3174031003,2020-10-25,1516,88,1428,5,3,2
DKI JAKARTA,JAKARTA SELATAN,MAMPANG PRAPATAN,PELA MAMPANG,3174031003,2020-10-26,1518,77,1441,2,-11,13
DKI JAKARTA,JAKARTA SELATAN,MAMPANG PRAPATAN,PELA MAMPANG,3174031003,2020-10-27,1526,78,1448,8,1,7
DKI JAKARTA,JAKARTA SELATAN,MAMPANG PRAPATAN,PELA MAMPANG,3174031003,2020-10-28,1537,83,1454,11,5,6
DKI JAKARTA,JAKARTA SELATAN,MAMPANG PRAPATAN,PELA MAMPANG,3174031003,2020-10-29,1544,71,1473,7,-12,19
DKI JAKARTA,JAKARTA SELATAN,MAMPANG PRAPATAN,PELA MAMPANG,3174031003,2020-10-30,1552,63,1489,8,-8,16
DKI JAKARTA,JAKARTA SELATAN,MAMPANG PRAPATAN,PELA MAMPANG,3174031003,2020-10-31,1556,66,1490,4,3,1
DKI JAKARTA,JAKARTA SELATAN,MAMPANG PRAPATAN,TEGAL PARANG,3174031004,2020-10-01,811,71,740,0,0,0
DKI JAKARTA,JAKARTA SELATAN,MAMPANG PRAPATAN,TEGAL PARANG,3174031004,2020-10-02,831,82,749,20,11,9
DKI JAKARTA,JAKARTA SELATAN,MAMPANG PRAPATAN,TEGAL PARANG,3174031004,2020-10-03,846,96,750,15,14,1
DKI JAKARTA,JAKARTA SELATAN,MAMPANG PRAPATAN,TEGAL PARANG,3174031004,2020-10-04,858,106,752,12,10,2
DKI JAKARTA,JAKARTA SELATAN,MAMPANG PRAPATAN,TEGAL PARANG,3174031004,2020-10-05,862,104,758,4,-2,6
DKI JAKARTA,JAKARTA SELATAN,MAMPANG PRAPATAN,TEGAL PARANG,3174031004,2020-10-06,869,103,766,7,-1,8
DKI JAKARTA,JAKARTA SELATAN,MAMPANG PRAPATAN,TEGAL PARANG,3174031004,2020-10-07,890,115,775,21,12,9
DKI JAKARTA,JAKARTA SELATAN,MAMPANG PRAPATAN,TEGAL PARANG,3174031004,2020-10-08,898,110,788,8,-5,13
DKI JAKARTA,JAKARTA SELATAN,MAMPANG PRAPATAN,TEGAL PARANG,3174031004,2020-10-09,900,112,788,2,2,0
DKI JAKARTA,JAKARTA SELATAN,MAMPANG PRAPATAN,TEGAL PARANG,3174031004,2020-10-10,911,112,799,11,0,11
DKI JAKARTA,JAKARTA SELATAN,MAMPANG PRAPATAN,TEGAL PARANG,3174031004,2020-10-11,932,133,799,21,21,0
DKI JAKARTA,JAKARTA SELATAN,MAMPANG PRAPATAN,TEGAL PARANG,3174031004,2020-10-12,932,103,829,0,-30,30
DKI JAKARTA,JAKARTA SELATAN,MAMPANG PRAPATAN,TEGAL PARANG,3174031004,2020-10-13,934,82,852,2,-21,23
DKI JAKARTA,JAKARTA SELATAN,MAMPANG PRAPATAN,TEGAL PARANG,3174031004,2020-10-14,939,80,859,5,-2,7
DKI JAKARTA,JAKARTA SELATAN,MAMPANG PRAPATAN,TEGAL PARANG,3174031004,2020-10-15,951,80,871,12,0,12
DKI JAKARTA,JAKARTA SELATAN,MAMPANG PRAPATAN,TEGAL PARANG,3174031004,2020-10-16,956,75,881,5,-5,10
DKI JAKARTA,JAKARTA SELATAN,MAMPANG PRAPATAN,TEGAL PARANG,3174031004,2020-10-17,966,84,882,10,9,1
DKI JAKARTA,JAKARTA SELATAN,MAMPANG PRAPATAN,TEGAL PARANG,3174031004,2020-10-18,970,87,883,4,3,1
DKI JAKARTA,JAKARTA SELATAN,MAMPANG PRAPATAN,TEGAL PARANG,3174031004,2020-10-19,971,71,900,1,-16,17
DKI JAKARTA,JAKARTA SELATAN,MAMPANG PRAPATAN,TEGAL PARANG,3174031004,2020-10-20,980,75,905,9,4,5
DKI JAKARTA,JAKARTA SELATAN,MAMPANG PRAPATAN,TEGAL PARANG,3174031004,2020-10-21,1018,91,927,38,16,22
DKI JAKARTA,JAKARTA SELATAN,MAMPANG PRAPATAN,TEGAL PARANG,3174031004,2020-10-22,1018,76,942,0,-15,15
DKI JAKARTA,JAKARTA SELATAN,MAMPANG PRAPATAN,TEGAL PARANG,3174031004,2020-10-23,1023,80,943,5,4,1
DKI JAKARTA,JAKARTA SELATAN,MAMPANG PRAPATAN,TEGAL PARANG,3174031004,2020-10-24,1023,78,945,0,-2,2
DKI JAKARTA,JAKARTA SELATAN,MAMPANG PRAPATAN,TEGAL PARANG,3174031004,2020-10-25,1027,79,948,4,1,3
DKI JAKARTA,JAKARTA SELATAN,MAMPANG PRAPATAN,TEGAL PARANG,3174031004,2020-10-26,1032,73,959,5,-6,11
DKI JAKARTA,JAKARTA SELATAN,MAMPANG PRAPATAN,TEGAL PARANG,3174031004,2020-10-27,1040,73,967,8,0,8
DKI JAKARTA,JAKARTA SELATAN,MAMPANG PRAPATAN,TEGAL PARANG,3174031004,2020-10-28,1048,73,975,8,0,8
DKI JAKARTA,JAKARTA SELATAN,MAMPANG PRAPATAN,TEGAL PARANG,3174031004,2020-10-29,1051,58,993,3,-15,18
DKI JAKARTA,JAKARTA SELATAN,MAMPANG PRAPATAN,TEGAL PARANG,3174031004,2020-10-30,1056,56,1000,5,-2,7
DKI JAKARTA,JAKARTA SELATAN,MAMPANG PRAPATAN,TEGAL PARANG,3174031004,2020-10-31,1057,55,1002,1,-1,2
DKI JAKARTA,JAKARTA SELATAN,PANCORAN,CIKOKO,3174081006,2020-10-01,237,10,227,0,0,0
DKI JAKARTA,JAKARTA SELATAN,PANCORAN,CIKOKO,3174081006,2020-10-02,241,13,228,4,3,1
DKI JAKARTA,JAKARTA SELATAN,PANCORAN,CIKOKO,3174081006,2020-10-03,240,14,226,-1,1,-2
DKI JAKARTA,JAKARTA SELATAN,PANCORAN,CIKOKO,3174081006,2020-10-04,246,16,230,6,2,4
DKI JAKARTA,JAKARTA SELATAN,PANCORAN,CIKOKO,3174081006,2020-10-05,246,16,230,0,0,0
DKI JAKARTA,JAKARTA SELATAN,PANCORAN,CIKOKO,3174081006,2020-10-06,249,19,230,3,3,0
DKI JAKARTA,JAKARTA SELATAN,PANCORAN,CIKOKO,3174081006,2020-10-07,254,21,233,5,2,3
DKI JAKARTA,JAKARTA SELATAN,PANCORAN,CIKOKO,3174081006,2020-10-08,257,21,236,3,0,3
DKI JAKARTA,JAKARTA SELATAN,PANCORAN,CIKOKO,3174081006,2020-10-09,258,22,236,1,1,0
DKI JAKARTA,JAKARTA SELATAN,PANCORAN,CIKOKO,3174081006,2020-10-10,261,23,238,3,1,2
DKI JAKARTA,JAKARTA SELATAN,PANCORAN,CIKOKO,3174081006,2020-10-11,262,22,240,1,-1,2
DKI JAKARTA,JAKARTA SELATAN,PANCORAN,CIKOKO,3174081006,2020-10-12,263,17,246,1,-5,6
DKI JAKARTA,JAKARTA SELATAN,PANCORAN,CIKOKO,3174081006,2020-10-13,265,19,246,2,2,0
DKI JAKARTA,JAKARTA SELATAN,PANCORAN,CIKOKO,3174081006,2020-10-14,267,16,251,2,-3,5
DKI JAKARTA,JAKARTA SELATAN,PANCORAN,CIKOKO,3174081006,2020-10-15,268,15,253,1,-1,2
DKI JAKARTA,JAKARTA SELATAN,PANCORAN,CIKOKO,3174081006,2020-10-16,269,15,254,1,0,1
DKI JAKARTA,JAKARTA SELATAN,PANCORAN,CIKOKO,3174081006,2020-10-17,271,17,254,2,2,0
DKI JAKARTA,JAKARTA SELATAN,PANCORAN,CIKOKO,3174081006,2020-10-18,271,16,255,0,-1,1
DKI JAKARTA,JAKARTA SELATAN,PANCORAN,CIKOKO,3174081006,2020-10-19,272,13,259,1,-3,4
DKI JAKARTA,JAKARTA SELATAN,PANCORAN,CIKOKO,3174081006,2020-10-20,274,9,265,2,-4,6
DKI JAKARTA,JAKARTA SELATAN,PANCORAN,CIKOKO,3174081006,2020-10-21,274,8,266,0,-1,1
DKI JAKARTA,JAKARTA SELATAN,PANCORAN,CIKOKO,3174081006,2020-10-22,274,7,267,0,-1,1
DKI JAKARTA,JAKARTA SELATAN,PANCORAN,CIKOKO,3174081006,2020-10-23,275,7,268,1,0,1
DKI JAKARTA,JAKARTA SELATAN,PANCORAN,CIKOKO,3174081006,2020-10-24,275,7,268,0,0,0
DKI JAKARTA,JAKARTA SELATAN,PANCORAN,CIKOKO,3174081006,2020-10-25,276,8,268,1,1,0
DKI JAKARTA,JAKARTA SELATAN,PANCORAN,CIKOKO,3174081006,2020-10-26,276,7,269,0,-1,1
DKI JAKARTA,JAKARTA SELATAN,PANCORAN,CIKOKO,3174081006,2020-10-27,279,9,270,3,2,1
DKI JAKARTA,JAKARTA SELATAN,PANCORAN,CIKOKO,3174081006,2020-10-28,279,9,270,0,0,0
DKI JAKARTA,JAKARTA SELATAN,PANCORAN,CIKOKO,3174081006,2020-10-29,281,8,273,2,-1,3
DKI JAKARTA,JAKARTA SELATAN,PANCORAN,CIKOKO,3174081006,2020-10-30,282,7,275,1,-1,2
DKI JAKARTA,JAKARTA SELATAN,PANCORAN,CIKOKO,3174081006,2020-10-31,282,7,275,0,0,0
DKI JAKARTA,JAKARTA SELATAN,PANCORAN,DUREN TIGA,3174081004,2020-10-01,487,38,449,0,0,0
DKI JAKARTA,JAKARTA SELATAN,PANCORAN,DUREN TIGA,3174081004,2020-10-02,492,37,455,5,-1,6
DKI JAKARTA,JAKARTA SELATAN,PANCORAN,DUREN TIGA,3174081004,2020-10-03,502,47,455,10,10,0
DKI JAKARTA,JAKARTA SELATAN,PANCORAN,DUREN TIGA,3174081004,2020-10-04,504,48,456,2,1,1
DKI JAKARTA,JAKARTA SELATAN,PANCORAN,DUREN TIGA,3174081004,2020-10-05,507,48,459,3,0,3
DKI JAKARTA,JAKARTA SELATAN,PANCORAN,DUREN TIGA,3174081004,2020-10-06,512,50,462,5,2,3
DKI JAKARTA,JAKARTA SELATAN,PANCORAN,DUREN TIGA,3174081004,2020-10-07,530,57,473,18,7,11
DKI JAKARTA,JAKARTA SELATAN,PANCORAN,DUREN TIGA,3174081004,2020-10-08,535,53,482,5,-4,9
DKI JAKARTA,JAKARTA SELATAN,PANCORAN,DUREN TIGA,3174081004,2020-10-09,540,57,483,5,4,1
DKI JAKARTA,JAKARTA SELATAN,PANCORAN,DUREN TIGA,3174081004,2020-10-10,550,61,489,10,4,6
DKI JAKARTA,JAKARTA SELATAN,PANCORAN,DUREN TIGA,3174081004,2020-10-11,552,61,491,2,0,2
DKI JAKARTA,JAKARTA SELATAN,PANCORAN,DUREN TIGA,3174081004,2020-10-12,558,60,498,6,-1,7
DKI JAKARTA,JAKARTA SELATAN,PANCORAN,DUREN TIGA,3174081004,2020-10-13,571,59,512,13,-1,14
DKI JAKARTA,JAKARTA SELATAN,PANCORAN,DUREN TIGA,3174081004,2020-10-14,575,58,517,4,-1,5
DKI JAKARTA,JAKARTA SELATAN,PANCORAN,DUREN TIGA,3174081004,2020-10-15,588,62,526,13,4,9
DKI JAKARTA,JAKARTA SELATAN,PANCORAN,DUREN TIGA,3174081004,2020-10-16,591,54,537,3,-8,11
DKI JAKARTA,JAKARTA SELATAN,PANCORAN,DUREN TIGA,3174081004,2020-10-17,595,56,539,4,2,2
DKI JAKARTA,JAKARTA SELATAN,PANCORAN,DUREN TIGA,3174081004,2020-10-18,600,60,540,5,4,1
DKI JAKARTA,JAKARTA SELATAN,PANCORAN,DUREN TIGA,3174081004,2020-10-19,600,52,548,0,-8,8
DKI JAKARTA,JAKARTA SELATAN,PANCORAN,DUREN TIGA,3174081004,2020-10-20,614,59,555,14,7,7
DKI JAKARTA,JAKARTA SELATAN,PANCORAN,DUREN TIGA,3174081004,2020-10-21,615,54,561,1,-5,6
DKI JAKARTA,JAKARTA SELATAN,PANCORAN,DUREN TIGA,3174081004,2020-10-22,615,44,571,0,-10,10
DKI JAKARTA,JAKARTA SELATAN,PANCORAN,DUREN TIGA,3174081004,2020-10-23,617,44,573,2,0,2
DKI JAKARTA,JAKARTA SELATAN,PANCORAN,DUREN TIGA,3174081004,2020-10-24,619,35,584,2,-9,11
DKI JAKARTA,JAKARTA SELATAN,PANCORAN,DUREN TIGA,3174081004,2020-10-25,619,33,586,0,-2,2
DKI JAKARTA,JAKARTA SELATAN,PANCORAN,DUREN TIGA,3174081004,2020-10-26,624,27,597,5,-6,11
DKI JAKARTA,JAKARTA SELATAN,PANCORAN,DUREN TIGA,3174081004,2020-10-27,630,18,612,6,-9,15
DKI JAKARTA,JAKARTA SELATAN,PANCORAN,DUREN TIGA,3174081004,2020-10-28,631,15,616,1,-3,4
DKI JAKARTA,JAKARTA SELATAN,PANCORAN,DUREN TIGA,3174081004,2020-10-29,632,12,620,1,-3,4
DKI JAKARTA,JAKARTA SELATAN,PANCORAN,DUREN TIGA,3174081004,2020-10-30,644,20,624,12,8,4
DKI JAKARTA,JAKARTA SELATAN,PANCORAN,DUREN TIGA,3174081004,2020-10-31,645,21,624,1,1,0
DKI JAKARTA,JAKARTA SELATAN,PANCORAN,KALIBATA,3174081002,2020-10-01,672,66,606,0,0,0
DKI JAKARTA,JAKARTA SELATAN,PANCORAN,KALIBATA,3174081002,2020-10-02,683,57,626,11,-9,20
DKI JAKARTA,JAKARTA SELATAN,PANCORAN,KALIBATA,3174081002,2020-10-03,699,69,630,16,12,4
DKI JAKARTA,JAKARTA SELATAN,PANCORAN,KALIBATA,3174081002,2020-10-04,702,71,631,3,2,1
DKI JAKARTA,JAKARTA SELATAN,PANCORAN,KALIBATA,3174081002,2020-10-05,707,71,636,5,0,5
DKI JAKARTA,JAKARTA SELATAN,PANCORAN,KALIBATA,3174081002,2020-10-06,715,63,652,8,-8,16
DKI JAKARTA,JAKARTA SELATAN,PANCORAN,KALIBATA,3174081002,2020-10-07,729,70,659,14,7,7
DKI JAKARTA,JAKARTA SELATAN,PANCORAN,KALIBATA,3174081002,2020-10-08,734,69,665,5,-1,6
DKI JAKARTA,JAKARTA SELATAN,PANCORAN,KALIBATA,3174081002,2020-10-09,738,73,665,4,4,0
DKI JAKARTA,JAKARTA SELATAN,PANCORAN,KALIBATA,3174081002,2020-10-10,752,80,672,14,7,7
DKI JAKARTA,JAKARTA SELATAN,PANCORAN,KALIBATA,3174081002,2020-10-11,757,81,676,5,1,4
DKI JAKARTA,JAKARTA SELATAN,PANCORAN,KALIBATA,3174081002,2020-10-12,759,64,695,2,-17,19
DKI JAKARTA,JAKARTA SELATAN,PANCORAN,KALIBATA,3174081002,2020-10-13,767,64,703,8,0,8
DKI JAKARTA,JAKARTA SELATAN,PANCORAN,KALIBATA,3174081002,2020-10-14,768,48,720,1,-16,17
DKI JAKARTA,JAKARTA SELATAN,PANCORAN,KALIBATA,3174081002,2020-10-15,774,49,725,6,1,5
DKI JAKARTA,JAKARTA SELATAN,PANCORAN,KALIBATA,3174081002,2020-10-16,778,45,733,4,-4,8
DKI JAKARTA,JAKARTA SELATAN,PANCORAN,KALIBATA,3174081002,2020-10-17,795,62,733,17,17,0
DKI JAKARTA,JAKARTA SELATAN,PANCORAN,KALIBATA,3174081002,2020-10-18,804,67,737,9,5,4
DKI JAKARTA,JAKARTA SELATAN,PANCORAN,KALIBATA,3174081002,2020-10-19,804,62,742,0,-5,5
DKI JAKARTA,JAKARTA SELATAN,PANCORAN,KALIBATA,3174081002,2020-10-20,814,60,754,10,-2,12
DKI JAKARTA,JAKARTA SELATAN,PANCORAN,KALIBATA,3174081002,2020-10-21,819,61,758,5,1,4
DKI JAKARTA,JAKARTA SELATAN,PANCORAN,KALIBATA,3174081002,2020-10-22,824,48,776,5,-13,18
DKI JAKARTA,JAKARTA SELATAN,PANCORAN,KALIBATA,3174081002,2020-10-23,826,49,777,2,1,1
DKI JAKARTA,JAKARTA SELATAN,PANCORAN,KALIBATA,3174081002,2020-10-24,831,44,787,5,-5,10
DKI JAKARTA,JAKARTA SELATAN,PANCORAN,KALIBATA,3174081002,2020-10-25,838,47,791,7,3,4
DKI JAKARTA,JAKARTA SELATAN,PANCORAN,KALIBATA,3174081002,2020-10-26,852,54,798,14,7,7
DKI JAKARTA,JAKARTA SELATAN,PANCORAN,KALIBATA,3174081002,2020-10-27,876,76,800,24,22,2
DKI JAKARTA,JAKARTA SELATAN,PANCORAN,KALIBATA,3174081002,2020-10-28,877,57,820,1,-19,20
DKI JAKARTA,JAKARTA SELATAN,PANCORAN,KALIBATA,3174081002,2020-10-29,881,41,840,4,-16,20
DKI JAKARTA,JAKARTA SELATAN,PANCORAN,KALIBATA,3174081002,2020-10-30,892,42,850,11,1,10
DKI JAKARTA,JAKARTA SELATAN,PANCORAN,KALIBATA,3174081002,2020-10-31,896,46,850,4,4,0
DKI JAKARTA,JAKARTA SELATAN,PANCORAN,PANCORAN,3174081001,2020-10-01,519,41,478,0,0,0
DKI JAKARTA,JAKARTA SELATAN,PANCORAN,PANCORAN,3174081001,2020-10-02,520,37,483,1,-4,5
DKI JAKARTA,JAKARTA SELATAN,PANCORAN,PANCORAN,3174081001,2020-10-03,530,44,486,10,7,3
DKI JAKARTA,JAKARTA SELATAN,PANCORAN,PANCORAN,3174081001,2020-10-04,532,46,486,2,2,0
DKI JAKARTA,JAKARTA SELATAN,PANCORAN,PANCORAN,3174081001,2020-10-05,534,48,486,2,2,0
DKI JAKARTA,JAKARTA SELATAN,PANCORAN,PANCORAN,3174081001,2020-10-06,542,41,501,8,-7,15
DKI JAKARTA,JAKARTA SELATAN,PANCORAN,PANCORAN,3174081001,2020-10-07,547,43,504,5,2,3
DKI JAKARTA,JAKARTA SELATAN,PANCORAN,PANCORAN,3174081001,2020-10-08,548,35,513,1,-8,9
DKI JAKARTA,JAKARTA SELATAN,PANCORAN,PANCORAN,3174081001,2020-10-09,548,35,513,0,0,0
DKI JAKARTA,JAKARTA SELATAN,PANCORAN,PANCORAN,3174081001,2020-10-10,552,36,516,4,1,3
DKI JAKARTA,JAKARTA SELATAN,PANCORAN,PANCORAN,3174081001,2020-10-11,553,37,516,1,1,0
DKI JAKARTA,JAKARTA SELATAN,PANCORAN,PANCORAN,3174081001,2020-10-12,560,38,522,7,1,6
DKI JAKARTA,JAKARTA SELATAN,PANCORAN,PANCORAN,3174081001,2020-10-13,561,32,529,1,-6,7
DKI JAKARTA,JAKARTA SELATAN,PANCORAN,PANCORAN,3174081001,2020-10-14,564,22,542,3,-10,13
DKI JAKARTA,JAKARTA SELATAN,PANCORAN,PANCORAN,3174081001,2020-10-15,568,21,547,4,-1,5
DKI JAKARTA,JAKARTA SELATAN,PANCORAN,PANCORAN,3174081001,2020-10-16,571,24,547,3,3,0
DKI JAKARTA,JAKARTA SELATAN,PANCORAN,PANCORAN,3174081001,2020-10-17,576,26,550,5,2,3
DKI JAKARTA,JAKARTA SELATAN,PANCORAN,PANCORAN,3174081001,2020-10-18,579,29,550,3,3,0
DKI JAKARTA,JAKARTA SELATAN,PANCORAN,PANCORAN,3174081001,2020-10-19,581,28,553,2,-1,3
DKI JAKARTA,JAKARTA SELATAN,PANCORAN,PANCORAN,3174081001,2020-10-20,586,29,557,5,1,4
DKI JAKARTA,JAKARTA SELATAN,PANCORAN,PANCORAN,3174081001,2020-10-21,587,24,563,1,-5,6
DKI JAKARTA,JAKARTA SELATAN,PANCORAN,PANCORAN,3174081001,2020-10-22,591,22,569,4,-2,6
DKI JAKARTA,JAKARTA SELATAN,PANCORAN,PANCORAN,3174081001,2020-10-23,593,22,571,2,0,2
DKI JAKARTA,JAKARTA SELATAN,PANCORAN,PANCORAN,3174081001,2020-10-24,594,22,572,1,0,1
DKI JAKARTA,JAKARTA SELATAN,PANCORAN,PANCORAN,3174081001,2020-10-25,599,26,573,5,4,1
DKI JAKARTA,JAKARTA SELATAN,PANCORAN,PANCORAN,3174081001,2020-10-26,602,21,581,3,-5,8
DKI JAKARTA,JAKARTA SELATAN,PANCORAN,PANCORAN,3174081001,2020-10-27,611,22,589,9,1,8
DKI JAKARTA,JAKARTA SELATAN,PANCORAN,PANCORAN,3174081001,2020-10-28,612,21,591,1,-1,2
DKI JAKARTA,JAKARTA SELATAN,PANCORAN,PANCORAN,3174081001,2020-10-29,614,20,594,2,-1,3
DKI JAKARTA,JAKARTA SELATAN,PANCORAN,PANCORAN,3174081001,2020-10-30,628,27,601,14,7,7
DKI JAKARTA,JAKARTA SELATAN,PANCORAN,PANCORAN,3174081001,2020-10-31,634,31,603,6,4,2
DKI JAKARTA,JAKARTA SELATAN,PANCORAN,PENGADEGAN,3174081005,2020-10-01,346,26,320,0,0,0
DKI JAKARTA,JAKARTA SELATAN,PANCORAN,PENGADEGAN,3174081005,2020-10-02,350,26,324,4,0,4
DKI JAKARTA,JAKARTA SELATAN,PANCORAN,PENGADEGAN,3174081005,2020-10-03,356,28,328,6,2,4
DKI JAKARTA,JAKARTA SELATAN,PANCORAN,PENGADEGAN,3174081005,2020-10-04,356,28,328,0,0,0
DKI JAKARTA,JAKARTA SELATAN,PANCORAN,PENGADEGAN,3174081005,2020-10-05,357,26,331,1,-2,3
DKI JAKARTA,JAKARTA SELATAN,PANCORAN,PENGADEGAN,3174081005,2020-10-06,357,23,334,0,-3,3
DKI JAKARTA,JAKARTA SELATAN,PANCORAN,PENGADEGAN,3174081005,2020-10-07,360,22,338,3,-1,4
DKI JAKARTA,JAKARTA SELATAN,PANCORAN,PENGADEGAN,3174081005,2020-10-08,366,27,339,6,5,1
DKI JAKARTA,JAKARTA SELATAN,PANCORAN,PENGADEGAN,3174081005,2020-10-09,367,28,339,1,1,0
DKI JAKARTA,JAKARTA SELATAN,PANCORAN,PENGADEGAN,3174081005,2020-10-10,371,28,343,4,0,4
DKI JAKARTA,JAKARTA SELATAN,PANCORAN,PENGADEGAN,3174081005,2020-10-11,373,29,344,2,1,1
DKI JAKARTA,JAKARTA SELATAN,PANCORAN,PENGADEGAN,3174081005,2020-10-12,375,22,353,2,-7,9
DKI JAKARTA,JAKARTA SELATAN,PANCORAN,PENGADEGAN,3174081005,2020-10-13,378,23,355,3,1,2
DKI JAKARTA,JAKARTA SELATAN,PANCORAN,PENGADEGAN,3174081005,2020-10-14,383,24,359,5,1,4
DKI JAKARTA,JAKARTA SELATAN,PANCORAN,PENGADEGAN,3174081005,2020-10-15,391,29,362,8,5,3
DKI JAKARTA,JAKARTA SELATAN,PANCORAN,PENGADEGAN,3174081005,2020-10-16,392,29,363,1,0,1
DKI JAKARTA,JAKARTA SELATAN,PANCORAN,PENGADEGAN,3174081005,2020-10-17,398,35,363,6,6,0
DKI JAKARTA,JAKARTA SELATAN,PANCORAN,PENGADEGAN,3174081005,2020-10-18,404,41,363,6,6,0
DKI JAKARTA,JAKARTA SELATAN,PANCORAN,PENGADEGAN,3174081005,2020-10-19,406,41,365,2,0,2
DKI JAKARTA,JAKARTA SELATAN,PANCORAN,PENGADEGAN,3174081005,2020-10-20,407,40,367,1,-1,2
DKI JAKARTA,JAKARTA SELATAN,PANCORAN,PENGADEGAN,3174081005,2020-10-21,424,38,386,17,-2,19
DKI JAKARTA,JAKARTA SELATAN,PANCORAN,PENGADEGAN,3174081005,2020-10-22,408,30,378,-16,-8,-8
DKI JAKARTA,JAKARTA SELATAN,PANCORAN,PENGADEGAN,3174081005,2020-10-23,408,30,378,0,0,0
DKI JAKARTA,JAKARTA SELATAN,PANCORAN,PENGADEGAN,3174081005,2020-10-24,414,31,383,6,1,5
DKI JAKARTA,JAKARTA SELATAN,PANCORAN,PENGADEGAN,3174081005,2020-10-25,417,31,386,3,0,3
DKI JAKARTA,JAKARTA SELATAN,PANCORAN,PENGADEGAN,3174081005,2020-10-26,423,30,393,6,-1,7
DKI JAKARTA,JAKARTA SELATAN,PANCORAN,PENGADEGAN,3174081005,2020-10-27,427,26,401,4,-4,8
DKI JAKARTA,JAKARTA SELATAN,PANCORAN,PENGADEGAN,3174081005,2020-10-28,430,23,407,3,-3,6
DKI JAKARTA,JAKARTA SELATAN,PANCORAN,PENGADEGAN,3174081005,2020-10-29,433,15,418,3,-8,11
DKI JAKARTA,JAKARTA SELATAN,PANCORAN,PENGADEGAN,3174081005,2020-10-30,439,21,418,6,6,0
DKI JAKARTA,JAKARTA SELATAN,PANCORAN,PENGADEGAN,3174081005,2020-10-31,444,24,420,5,3,2
DKI JAKARTA,JAKARTA SELATAN,PANCORAN,RAWA JATI,3174081003,2020-10-01,412,18,394,0,0,0
DKI JAKARTA,JAKARTA SELATAN,PANCORAN,RAWA JATI,3174081003,2020-10-02,421,25,396,9,7,2
DKI JAKARTA,JAKARTA SELATAN,PANCORAN,RAWA JATI,3174081003,2020-10-03,425,28,397,4,3,1
DKI JAKARTA,JAKARTA SELATAN,PANCORAN,RAWA JATI,3174081003,2020-10-04,427,29,398,2,1,1
DKI JAKARTA,JAKARTA SELATAN,PANCORAN,RAWA JATI,3174081003,2020-10-05,429,30,399,2,1,1
DKI JAKARTA,JAKARTA SELATAN,PANCORAN,RAWA JATI,3174081003,2020-10-06,430,27,403,1,-3,4
DKI JAKARTA,JAKARTA SELATAN,PANCORAN,RAWA JATI,3174081003,2020-10-07,435,30,405,5,3,2
DKI JAKARTA,JAKARTA SELATAN,PANCORAN,RAWA JATI,3174081003,2020-10-08,441,29,412,6,-1,7
DKI JAKARTA,JAKARTA SELATAN,PANCORAN,RAWA JATI,3174081003,2020-10-09,443,29,414,2,0,2
DKI JAKARTA,JAKARTA SELATAN,PANCORAN,RAWA JATI,3174081003,2020-10-10,444,29,415,1,0,1
DKI JAKARTA,JAKARTA SELATAN,PANCORAN,RAWA JATI,3174081003,2020-10-11,455,38,417,11,9,2
DKI JAKARTA,JAKARTA SELATAN,PANCORAN,RAWA JATI,3174081003,2020-10-12,457,30,427,2,-8,10
DKI JAKARTA,JAKARTA SELATAN,PANCORAN,RAWA JATI,3174081003,2020-10-13,462,30,432,5,0,5
DKI JAKARTA,JAKARTA SELATAN,PANCORAN,RAWA JATI,3174081003,2020-10-14,465,30,435,3,0,3
DKI JAKARTA,JAKARTA SELATAN,PANCORAN,RAWA JATI,3174081003,2020-10-15,472,32,440,7,2,5
DKI JAKARTA,JAKARTA SELATAN,PANCORAN,RAWA JATI,3174081003,2020-10-16,472,30,442,0,-2,2
DKI JAKARTA,JAKARTA SELATAN,PANCORAN,RAWA JATI,3174081003,2020-10-17,476,33,443,4,3,1
DKI JAKARTA,JAKARTA SELATAN,PANCORAN,RAWA JATI,3174081003,2020-10-18,480,36,444,4,3,1
DKI JAKARTA,JAKARTA SELATAN,PANCORAN,RAWA JATI,3174081003,2020-10-19,481,34,447,1,-2,3
DKI JAKARTA,JAKARTA SELATAN,PANCORAN,RAWA JATI,3174081003,2020-10-20,487,39,448,6,5,1
DKI JAKARTA,JAKARTA SELATAN,PANCORAN,RAWA JATI,3174081003,2020-10-21,503,53,450,16,14,2
DKI JAKARTA,JAKARTA SELATAN,PANCORAN,RAWA JATI,3174081003,2020-10-22,505,41,464,2,-12,14
DKI JAKARTA,JAKARTA SELATAN,PANCORAN,RAWA JATI,3174081003,2020-10-23,508,41,467,3,0,3
DKI JAKARTA,JAKARTA SELATAN,PANCORAN,RAWA JATI,3174081003,2020-10-24,512,37,475,4,-4,8
DKI JAKARTA,JAKARTA SELATAN,PANCORAN,RAWA JATI,3174081003,2020-10-25,517,39,478,5,2,3
DKI JAKARTA,JAKARTA SELATAN,PANCORAN,RAWA JATI,3174081003,2020-10-26,519,34,485,2,-5,7
DKI JAKARTA,JAKARTA SELATAN,PANCORAN,RAWA JATI,3174081003,2020-10-27,541,53,488,22,19,3
DKI JAKARTA,JAKARTA SELATAN,PANCORAN,RAWA JATI,3174081003,2020-10-28,544,50,494,3,-3,6
DKI JAKARTA,JAKARTA SELATAN,PANCORAN,RAWA JATI,3174081003,2020-10-29,547,49,498,3,-1,4
DKI JAKARTA,JAKARTA SELATAN,PANCORAN,RAWA JATI,3174081003,2020-10-30,561,59,502,14,10,4
DKI JAKARTA,JAKARTA SELATAN,PANCORAN,RAWA JATI,3174081003,2020-10-31,561,59,502,0,0,0
DKI JAKARTA,JAKARTA SELATAN,PASAR MINGGU,CILANDAK TIMUR,3174041003,2020-10-01,344,35,309,0,0,0
DKI JAKARTA,JAKARTA SELATAN,PASAR MINGGU,CILANDAK TIMUR,3174041003,2020-10-02,351,37,314,7,2,5
DKI JAKARTA,JAKARTA SELATAN,PASAR MINGGU,CILANDAK TIMUR,3174041003,2020-10-03,350,36,314,-1,-1,0
DKI JAKARTA,JAKARTA SELATAN,PASAR MINGGU,CILANDAK TIMUR,3174041003,2020-10-04,358,40,318,8,4,4
DKI JAKARTA,JAKARTA SELATAN,PASAR MINGGU,CILANDAK TIMUR,3174041003,2020-10-05,361,42,319,3,2,1
DKI JAKARTA,JAKARTA SELATAN,PASAR MINGGU,CILANDAK TIMUR,3174041003,2020-10-06,363,42,321,2,0,2
DKI JAKARTA,JAKARTA SELATAN,PASAR MINGGU,CILANDAK TIMUR,3174041003,2020-10-07,369,44,325,6,2,4
DKI JAKARTA,JAKARTA SELATAN,PASAR MINGGU,CILANDAK TIMUR,3174041003,2020-10-08,374,45,329,5,1,4
DKI JAKARTA,JAKARTA SELATAN,PASAR MINGGU,CILANDAK TIMUR,3174041003,2020-10-09,378,49,329,4,4,0
DKI JAKARTA,JAKARTA SELATAN,PASAR MINGGU,CILANDAK TIMUR,3174041003,2020-10-10,380,33,347,2,-16,18
DKI JAKARTA,JAKARTA SELATAN,PASAR MINGGU,CILANDAK TIMUR,3174041003,2020-10-11,386,37,349,6,4,2
DKI JAKARTA,JAKARTA SELATAN,PASAR MINGGU,CILANDAK TIMUR,3174041003,2020-10-12,389,36,353,3,-1,4
DKI JAKARTA,JAKARTA SELATAN,PASAR MINGGU,CILANDAK TIMUR,3174041003,2020-10-13,397,38,359,8,2,6
DKI JAKARTA,JAKARTA SELATAN,PASAR MINGGU,CILANDAK TIMUR,3174041003,2020-10-14,401,40,361,4,2,2
DKI JAKARTA,JAKARTA SELATAN,PASAR MINGGU,CILANDAK TIMUR,3174041003,2020-10-15,407,42,365,6,2,4
DKI JAKARTA,JAKARTA SELATAN,PASAR MINGGU,CILANDAK TIMUR,3174041003,2020-10-16,411,41,370,4,-1,5
DKI JAKARTA,JAKARTA SELATAN,PASAR MINGGU,CILANDAK TIMUR,3174041003,2020-10-17,422,49,373,11,8,3
DKI JAKARTA,JAKARTA SELATAN,PASAR MINGGU,CILANDAK TIMUR,3174041003,2020-10-18,422,48,374,0,-1,1
DKI JAKARTA,JAKARTA SELATAN,PASAR MINGGU,CILANDAK TIMUR,3174041003,2020-10-19,423,41,382,1,-7,8
DKI JAKARTA,JAKARTA SELATAN,PASAR MINGGU,CILANDAK TIMUR,3174041003,2020-10-20,438,49,389,15,8,7
DKI JAKARTA,JAKARTA SELATAN,PASAR MINGGU,CILANDAK TIMUR,3174041003,2020-10-21,438,46,392,0,-3,3
DKI JAKARTA,JAKARTA SELATAN,PASAR MINGGU,CILANDAK TIMUR,3174041003,2020-10-22,441,43,398,3,-3,6
DKI JAKARTA,JAKARTA SELATAN,PASAR MINGGU,CILANDAK TIMUR,3174041003,2020-10-23,442,44,398,1,1,0
DKI JAKARTA,JAKARTA SELATAN,PASAR MINGGU,CILANDAK TIMUR,3174041003,2020-10-24,447,39,408,5,-5,10
DKI JAKARTA,JAKARTA SELATAN,PASAR MINGGU,CILANDAK TIMUR,3174041003,2020-10-25,454,45,409,7,6,1
DKI JAKARTA,JAKARTA SELATAN,PASAR MINGGU,CILANDAK TIMUR,3174041003,2020-10-26,455,45,410,1,0,1
DKI JAKARTA,JAKARTA SELATAN,PASAR MINGGU,CILANDAK TIMUR,3174041003,2020-10-27,465,44,421,10,-1,11
DKI JAKARTA,JAKARTA SELATAN,PASAR MINGGU,CILANDAK TIMUR,3174041003,2020-10-28,468,41,427,3,-3,6
DKI JAKARTA,JAKARTA SELATAN,PASAR MINGGU,CILANDAK TIMUR,3174041003,2020-10-29,484,44,440,16,3,13
DKI JAKARTA,JAKARTA SELATAN,PASAR MINGGU,CILANDAK TIMUR,3174041003,2020-10-30,486,43,443,2,-1,3
DKI JAKARTA,JAKARTA SELATAN,PASAR MINGGU,CILANDAK TIMUR,3174041003,2020-10-31,489,43,446,3,0,3
DKI JAKARTA,JAKARTA SELATAN,PASAR MINGGU,JATI PADANG,3174041002,2020-10-01,480,21,459,0,0,0
DKI JAKARTA,JAKARTA SELATAN,PASAR MINGGU,JATI PADANG,3174041002,2020-10-02,495,30,465,15,9,6
DKI JAKARTA,JAKARTA SELATAN,PASAR MINGGU,JATI PADANG,3174041002,2020-10-03,503,37,466,8,7,1
DKI JAKARTA,JAKARTA SELATAN,PASAR MINGGU,JATI PADANG,3174041002,2020-10-04,526,60,466,23,23,0
DKI JAKARTA,JAKARTA SELATAN,PASAR MINGGU,JATI PADANG,3174041002,2020-10-05,528,54,474,2,-6,8
DKI JAKARTA,JAKARTA SELATAN,PASAR MINGGU,JATI PADANG,3174041002,2020-10-06,533,58,475,5,4,1
DKI JAKARTA,JAKARTA SELATAN,PASAR MINGGU,JATI PADANG,3174041002,2020-10-07,541,62,479,8,4,4
DKI JAKARTA,JAKARTA SELATAN,PASAR MINGGU,JATI PADANG,3174041002,2020-10-08,554,72,482,13,10,3
DKI JAKARTA,JAKARTA SELATAN,PASAR MINGGU,JATI PADANG,3174041002,2020-10-09,557,73,484,3,1,2
DKI JAKARTA,JAKARTA SELATAN,PASAR MINGGU,JATI PADANG,3174041002,2020-10-10,562,68,494,5,-5,10
DKI JAKARTA,JAKARTA SELATAN,PASAR MINGGU,JATI PADANG,3174041002,2020-10-11,582,80,502,20,12,8
DKI JAKARTA,JAKARTA SELATAN,PASAR MINGGU,JATI PADANG,3174041002,2020-10-12,590,79,511,8,-1,9
DKI JAKARTA,JAKARTA SELATAN,PASAR MINGGU,JATI PADANG,3174041002,2020-10-13,594,71,523,4,-8,12
DKI JAKARTA,JAKARTA SELATAN,PASAR MINGGU,JATI PADANG,3174041002,2020-10-14,601,63,538,7,-8,15
DKI JAKARTA,JAKARTA SELATAN,PASAR MINGGU,JATI PADANG,3174041002,2020-10-15,607,46,561,6,-17,23
DKI JAKARTA,JAKARTA SELATAN,PASAR MINGGU,JATI PADANG,3174041002,2020-10-16,613,47,566,6,1,5
DKI JAKARTA,JAKARTA SELATAN,PASAR MINGGU,JATI PADANG,3174041002,2020-10-17,622,55,567,9,8,1
DKI JAKARTA,JAKARTA SELATAN,PASAR MINGGU,JATI PADANG,3174041002,2020-10-18,631,58,573,9,3,6
DKI JAKARTA,JAKARTA SELATAN,PASAR MINGGU,JATI PADANG,3174041002,2020-10-19,631,50,581,0,-8,8
DKI JAKARTA,JAKARTA SELATAN,PASAR MINGGU,JATI PADANG,3174041002,2020-10-20,643,57,586,12,7,5
DKI JAKARTA,JAKARTA SELATAN,PASAR MINGGU,JATI PADANG,3174041002,2020-10-21,650,54,596,7,-3,10
DKI JAKARTA,JAKARTA SELATAN,PASAR MINGGU,JATI PADANG,3174041002,2020-10-22,653,51,602,3,-3,6
DKI JAKARTA,JAKARTA SELATAN,PASAR MINGGU,JATI PADANG,3174041002,2020-10-23,653,51,602,0,0,0
DKI JAKARTA,JAKARTA SELATAN,PASAR MINGGU,JATI PADANG,3174041002,2020-10-24,658,49,609,5,-2,7
DKI JAKARTA,JAKARTA SELATAN,PASAR MINGGU,JATI PADANG,3174041002,2020-10-25,663,45,618,5,-4,9
DKI JAKARTA,JAKARTA SELATAN,PASAR MINGGU,JATI PADANG,3174041002,2020-10-26,668,43,625,5,-2,7
DKI JAKARTA,JAKARTA SELATAN,PASAR MINGGU,JATI PADANG,3174041002,2020-10-27,672,43,629,4,0,4
DKI JAKARTA,JAKARTA SELATAN,PASAR MINGGU,JATI PADANG,3174041002,2020-10-28,674,41,633,2,-2,4
DKI JAKARTA,JAKARTA SELATAN,PASAR MINGGU,JATI PADANG,3174041002,2020-10-29,682,37,645,8,-4,12
DKI JAKARTA,JAKARTA SELATAN,PASAR MINGGU,JATI PADANG,3174041002,2020-10-30,690,36,654,8,-1,9
DKI JAKARTA,JAKARTA SELATAN,PASAR MINGGU,JATI PADANG,3174041002,2020-10-31,701,45,656,11,9,2
DKI JAKARTA,JAKARTA SELATAN,PASAR MINGGU,KEBAGUSAN,3174041007,2020-10-01,592,24,568,0,0,0
DKI JAKARTA,JAKARTA SELATAN,PASAR MINGGU,KEBAGUSAN,3174041007,2020-10-02,598,26,572,6,2,4
DKI JAKARTA,JAKARTA SELATAN,PASAR MINGGU,KEBAGUSAN,3174041007,2020-10-03,604,28,576,6,2,4
DKI JAKARTA,JAKARTA SELATAN,PASAR MINGGU,KEBAGUSAN,3174041007,2020-10-04,613,36,577,9,8,1
DKI JAKARTA,JAKARTA SELATAN,PASAR MINGGU,KEBAGUSAN,3174041007,2020-10-05,617,40,577,4,4,0
DKI JAKARTA,JAKARTA SELATAN,PASAR MINGGU,KEBAGUSAN,3174041007,2020-10-06,618,39,579,1,-1,2
DKI JAKARTA,JAKARTA SELATAN,PASAR MINGGU,KEBAGUSAN,3174041007,2020-10-07,623,37,586,5,-2,7
DKI JAKARTA,JAKARTA SELATAN,PASAR MINGGU,KEBAGUSAN,3174041007,2020-10-08,629,42,587,6,5,1
DKI JAKARTA,JAKARTA SELATAN,PASAR MINGGU,KEBAGUSAN,3174041007,2020-10-09,634,46,588,5,4,1
DKI JAKARTA,JAKARTA SELATAN,PASAR MINGGU,KEBAGUSAN,3174041007,2020-10-10,639,45,594,5,-1,6
DKI JAKARTA,JAKARTA SELATAN,PASAR MINGGU,KEBAGUSAN,3174041007,2020-10-11,647,48,599,8,3,5
DKI JAKARTA,JAKARTA SELATAN,PASAR MINGGU,KEBAGUSAN,3174041007,2020-10-12,654,45,609,7,-3,10
DKI JAKARTA,JAKARTA SELATAN,PASAR MINGGU,KEBAGUSAN,3174041007,2020-10-13,660,45,615,6,0,6
DKI JAKARTA,JAKARTA SELATAN,PASAR MINGGU,KEBAGUSAN,3174041007,2020-10-14,667,44,623,7,-1,8
DKI JAKARTA,JAKARTA SELATAN,PASAR MINGGU,KEBAGUSAN,3174041007,2020-10-15,673,46,627,6,2,4
DKI JAKARTA,JAKARTA SELATAN,PASAR MINGGU,KEBAGUSAN,3174041007,2020-10-16,679,49,630,6,3,3
DKI JAKARTA,JAKARTA SELATAN,PASAR MINGGU,KEBAGUSAN,3174041007,2020-10-17,689,58,631,10,9,1
DKI JAKARTA,JAKARTA SELATAN,PASAR MINGGU,KEBAGUSAN,3174041007,2020-10-18,692,60,632,3,2,1
DKI JAKARTA,JAKARTA SELATAN,PASAR MINGGU,KEBAGUSAN,3174041007,2020-10-19,693,57,636,1,-3,4
DKI JAKARTA,JAKARTA SELATAN,PASAR MINGGU,KEBAGUSAN,3174041007,2020-10-20,697,55,642,4,-2,6
DKI JAKARTA,JAKARTA SELATAN,PASAR MINGGU,KEBAGUSAN,3174041007,2020-10-21,701,51,650,4,-4,8
DKI JAKARTA,JAKARTA SELATAN,PASAR MINGGU,KEBAGUSAN,3174041007,2020-10-22,710,47,663,9,-4,13
DKI JAKARTA,JAKARTA SELATAN,PASAR MINGGU,KEBAGUSAN,3174041007,2020-10-23,713,47,666,3,0,3
DKI JAKARTA,JAKARTA SELATAN,PASAR MINGGU,KEBAGUSAN,3174041007,2020-10-24,717,42,675,4,-5,9
DKI JAKARTA,JAKARTA SELATAN,PASAR MINGGU,KEBAGUSAN,3174041007,2020-10-25,717,38,679,0,-4,4
DKI JAKARTA,JAKARTA SELATAN,PASAR MINGGU,KEBAGUSAN,3174041007,2020-10-26,718,34,684,1,-4,5
DKI JAKARTA,JAKARTA SELATAN,PASAR MINGGU,KEBAGUSAN,3174041007,2020-10-27,723,36,687,5,2,3
DKI JAKARTA,JAKARTA SELATAN,PASAR MINGGU,KEBAGUSAN,3174041007,2020-10-28,727,36,691,4,0,4
DKI JAKARTA,JAKARTA SELATAN,PASAR MINGGU,KEBAGUSAN,3174041007,2020-10-29,739,32,707,12,-4,16
DKI JAKARTA,JAKARTA SELATAN,PASAR MINGGU,KEBAGUSAN,3174041007,2020-10-30,752,42,710,13,10,3
DKI JAKARTA,JAKARTA SELATAN,PASAR MINGGU,KEBAGUSAN,3174041007,2020-10-31,773,62,711,21,20,1
DKI JAKARTA,JAKARTA SELATAN,PASAR MINGGU,PASAR MINGGU,3174041001,2020-10-01,452,32,420,0,0,0
DKI JAKARTA,JAKARTA SELATAN,PASAR MINGGU,PASAR MINGGU,3174041001,2020-10-02,463,36,427,11,4,7
DKI JAKARTA,JAKARTA SELATAN,PASAR MINGGU,PASAR MINGGU,3174041001,2020-10-03,471,42,429,8,6,2
DKI JAKARTA,JAKARTA SELATAN,PASAR MINGGU,PASAR MINGGU,3174041001,2020-10-04,476,46,430,5,4,1
DKI JAKARTA,JAKARTA SELATAN,PASAR MINGGU,PASAR MINGGU,3174041001,2020-10-05,517,84,433,41,38,3
DKI JAKARTA,JAKARTA SELATAN,PASAR MINGGU,PASAR MINGGU,3174041001,2020-10-06,519,84,435,2,0,2
DKI JAKARTA,JAKARTA SELATAN,PASAR MINGGU,PASAR MINGGU,3174041001,2020-10-07,527,89,438,8,5,3
DKI JAKARTA,JAKARTA SELATAN,PASAR MINGGU,PASAR MINGGU,3174041001,2020-10-08,543,103,440,16,14,2
DKI JAKARTA,JAKARTA SELATAN,PASAR MINGGU,PASAR MINGGU,3174041001,2020-10-09,546,106,440,3,3,0
DKI JAKARTA,JAKARTA SELATAN,PASAR MINGGU,PASAR MINGGU,3174041001,2020-10-10,548,93,455,2,-13,15
DKI JAKARTA,JAKARTA SELATAN,PASAR MINGGU,PASAR MINGGU,3174041001,2020-10-11,553,95,458,5,2,3
DKI JAKARTA,JAKARTA SELATAN,PASAR MINGGU,PASAR MINGGU,3174041001,2020-10-12,560,95,465,7,0,7
DKI JAKARTA,JAKARTA SELATAN,PASAR MINGGU,PASAR MINGGU,3174041001,2020-10-13,564,93,471,4,-2,6
DKI JAKARTA,JAKARTA SELATAN,PASAR MINGGU,PASAR MINGGU,3174041001,2020-10-14,569,89,480,5,-4,9
DKI JAKARTA,JAKARTA SELATAN,PASAR MINGGU,PASAR MINGGU,3174041001,2020-10-15,576,36,540,7,-53,60
DKI JAKARTA,JAKARTA SELATAN,PASAR MINGGU,PASAR MINGGU,3174041001,2020-10-16,581,38,543,5,2,3
DKI JAKARTA,JAKARTA SELATAN,PASAR MINGGU,PASAR MINGGU,3174041001,2020-10-17,589,45,544,8,7,1
DKI JAKARTA,JAKARTA SELATAN,PASAR MINGGU,PASAR MINGGU,3174041001,2020-10-18,590,44,546,1,-1,2
DKI JAKARTA,JAKARTA SELATAN,PASAR MINGGU,PASAR MINGGU,3174041001,2020-10-19,591,38,553,1,-6,7
DKI JAKARTA,JAKARTA SELATAN,PASAR MINGGU,PASAR MINGGU,3174041001,2020-10-20,594,38,556,3,0,3
DKI JAKARTA,JAKARTA SELATAN,PASAR MINGGU,PASAR MINGGU,3174041001,2020-10-21,599,38,561,5,0,5
DKI JAKARTA,JAKARTA SELATAN,PASAR MINGGU,PASAR MINGGU,3174041001,2020-10-22,615,46,569,16,8,8
DKI JAKARTA,JAKARTA SELATAN,PASAR MINGGU,PASAR MINGGU,3174041001,2020-10-23,619,49,570,4,3,1
DKI JAKARTA,JAKARTA SELATAN,PASAR MINGGU,PASAR MINGGU,3174041001,2020-10-24,627,45,582,8,-4,12
DKI JAKARTA,JAKARTA SELATAN,PASAR MINGGU,PASAR MINGGU,3174041001,2020-10-25,637,52,585,10,7,3
DKI JAKARTA,JAKARTA SELATAN,PASAR MINGGU,PASAR MINGGU,3174041001,2020-10-26,640,49,591,3,-3,6
DKI JAKARTA,JAKARTA SELATAN,PASAR MINGGU,PASAR MINGGU,3174041001,2020-10-27,645,52,593,5,3,2
DKI JAKARTA,JAKARTA SELATAN,PASAR MINGGU,PASAR MINGGU,3174041001,2020-10-28,648,53,595,3,1,2
DKI JAKARTA,JAKARTA SELATAN,PASAR MINGGU,PASAR MINGGU,3174041001,2020-10-29,660,54,606,12,1,11
DKI JAKARTA,JAKARTA SELATAN,PASAR MINGGU,PASAR MINGGU,3174041001,2020-10-30,668,60,608,8,6,2
DKI JAKARTA,JAKARTA SELATAN,PASAR MINGGU,PASAR MINGGU,3174041001,2020-10-31,669,61,608,1,1,0
DKI JAKARTA,JAKARTA SELATAN,PASAR MINGGU,PEJATEN BARAT,3174041006,2020-10-01,568,38,530,0,0,0
DKI JAKARTA,JAKARTA SELATAN,PASAR MINGGU,PEJATEN BARAT,3174041006,2020-10-02,593,45,548,25,7,18
DKI JAKARTA,JAKARTA SELATAN,PASAR MINGGU,PEJATEN BARAT,3174041006,2020-10-03,599,48,551,6,3,3
DKI JAKARTA,JAKARTA SELATAN,PASAR MINGGU,PEJATEN BARAT,3174041006,2020-10-04,605,53,552,6,5,1
DKI JAKARTA,JAKARTA SELATAN,PASAR MINGGU,PEJATEN BARAT,3174041006,2020-10-05,610,54,556,5,1,4
DKI JAKARTA,JAKARTA SELATAN,PASAR MINGGU,PEJATEN BARAT,3174041006,2020-10-06,615,57,558,5,3,2
DKI JAKARTA,JAKARTA SELATAN,PASAR MINGGU,PEJATEN BARAT,3174041006,2020-10-07,620,59,561,5,2,3
DKI JAKARTA,JAKARTA SELATAN,PASAR MINGGU,PEJATEN BARAT,3174041006,2020-10-08,630,64,566,10,5,5
DKI JAKARTA,JAKARTA SELATAN,PASAR MINGGU,PEJATEN BARAT,3174041006,2020-10-09,636,69,567,6,5,1
DKI JAKARTA,JAKARTA SELATAN,PASAR MINGGU,PEJATEN BARAT,3174041006,2020-10-10,644,73,571,8,4,4
DKI JAKARTA,JAKARTA SELATAN,PASAR MINGGU,PEJATEN BARAT,3174041006,2020-10-11,648,72,576,4,-1,5
DKI JAKARTA,JAKARTA SELATAN,PASAR MINGGU,PEJATEN BARAT,3174041006,2020-10-12,653,50,603,5,-22,27
DKI JAKARTA,JAKARTA SELATAN,PASAR MINGGU,PEJATEN BARAT,3174041006,2020-10-13,657,44,613,4,-6,10
DKI JAKARTA,JAKARTA SELATAN,PASAR MINGGU,PEJATEN BARAT,3174041006,2020-10-14,669,49,620,12,5,7
DKI JAKARTA,JAKARTA SELATAN,PASAR MINGGU,PEJATEN BARAT,3174041006,2020-10-15,674,51,623,5,2,3
DKI JAKARTA,JAKARTA SELATAN,PASAR MINGGU,PEJATEN BARAT,3174041006,2020-10-16,680,53,627,6,2,4
DKI JAKARTA,JAKARTA SELATAN,PASAR MINGGU,PEJATEN BARAT,3174041006,2020-10-17,684,55,629,4,2,2
DKI JAKARTA,JAKARTA SELATAN,PASAR MINGGU,PEJATEN BARAT,3174041006,2020-10-18,688,53,635,4,-2,6
DKI JAKARTA,JAKARTA SELATAN,PASAR MINGGU,PEJATEN BARAT,3174041006,2020-10-19,690,49,641,2,-4,6
DKI JAKARTA,JAKARTA SELATAN,PASAR MINGGU,PEJATEN BARAT,3174041006,2020-10-20,694,45,649,4,-4,8
DKI JAKARTA,JAKARTA SELATAN,PASAR MINGGU,PEJATEN BARAT,3174041006,2020-10-21,709,52,657,15,7,8
DKI JAKARTA,JAKARTA SELATAN,PASAR MINGGU,PEJATEN BARAT,3174041006,2020-10-22,717,55,662,8,3,5
DKI JAKARTA,JAKARTA SELATAN,PASAR MINGGU,PEJATEN BARAT,3174041006,2020-10-23,722,58,664,5,3,2
DKI JAKARTA,JAKARTA SELATAN,PASAR MINGGU,PEJATEN BARAT,3174041006,2020-10-24,730,52,678,8,-6,14
DKI JAKARTA,JAKARTA SELATAN,PASAR MINGGU,PEJATEN BARAT,3174041006,2020-10-25,733,52,681,3,0,3
DKI JAKARTA,JAKARTA SELATAN,PASAR MINGGU,PEJATEN BARAT,3174041006,2020-10-26,737,48,689,4,-4,8
DKI JAKARTA,JAKARTA SELATAN,PASAR MINGGU,PEJATEN BARAT,3174041006,2020-10-27,741,42,699,4,-6,10
DKI JAKARTA,JAKARTA SELATAN,PASAR MINGGU,PEJATEN BARAT,3174041006,2020-10-28,747,43,704,6,1,5
DKI JAKARTA,JAKARTA SELATAN,PASAR MINGGU,PEJATEN BARAT,3174041006,2020-10-29,757,45,712,10,2,8
DKI JAKARTA,JAKARTA SELATAN,PASAR MINGGU,PEJATEN BARAT,3174041006,2020-10-30,764,50,714,7,5,2
DKI JAKARTA,JAKARTA SELATAN,PASAR MINGGU,PEJATEN BARAT,3174041006,2020-10-31,769,55,714,5,5,0
DKI JAKARTA,JAKARTA SELATAN,PASAR MINGGU,PEJATEN TIMUR,3174041005,2020-10-01,523,28,495,0,0,0
DKI JAKARTA,JAKARTA SELATAN,PASAR MINGGU,PEJATEN TIMUR,3174041005,2020-10-02,535,36,499,12,8,4
DKI JAKARTA,JAKARTA SELATAN,PASAR MINGGU,PEJATEN TIMUR,3174041005,2020-10-03,544,44,500,9,8,1
DKI JAKARTA,JAKARTA SELATAN,PASAR MINGGU,PEJATEN TIMUR,3174041005,2020-10-04,555,54,501,11,10,1
DKI JAKARTA,JAKARTA SELATAN,PASAR MINGGU,PEJATEN TIMUR,3174041005,2020-10-05,558,54,504,3,0,3
DKI JAKARTA,JAKARTA SELATAN,PASAR MINGGU,PEJATEN TIMUR,3174041005,2020-10-06,560,52,508,2,-2,4
DKI JAKARTA,JAKARTA SELATAN,PASAR MINGGU,PEJATEN TIMUR,3174041005,2020-10-07,568,52,516,8,0,8
DKI JAKARTA,JAKARTA SELATAN,PASAR MINGGU,PEJATEN TIMUR,3174041005,2020-10-08,585,63,522,17,11,6
DKI JAKARTA,JAKARTA SELATAN,PASAR MINGGU,PEJATEN TIMUR,3174041005,2020-10-09,588,65,523,3,2,1
DKI JAKARTA,JAKARTA SELATAN,PASAR MINGGU,PEJATEN TIMUR,3174041005,2020-10-10,596,66,530,8,1,7
DKI JAKARTA,JAKARTA SELATAN,PASAR MINGGU,PEJATEN TIMUR,3174041005,2020-10-11,604,70,534,8,4,4
DKI JAKARTA,JAKARTA SELATAN,PASAR MINGGU,PEJATEN TIMUR,3174041005,2020-10-12,607,60,547,3,-10,13
DKI JAKARTA,JAKARTA SELATAN,PASAR MINGGU,PEJATEN TIMUR,3174041005,2020-10-13,610,52,558,3,-8,11
DKI JAKARTA,JAKARTA SELATAN,PASAR MINGGU,PEJATEN TIMUR,3174041005,2020-10-14,613,54,559,3,2,1
DKI JAKARTA,JAKARTA SELATAN,PASAR MINGGU,PEJATEN TIMUR,3174041005,2020-10-15,623,52,571,10,-2,12
DKI JAKARTA,JAKARTA SELATAN,PASAR MINGGU,PEJATEN TIMUR,3174041005,2020-10-16,629,50,579,6,-2,8
DKI JAKARTA,JAKARTA SELATAN,PASAR MINGGU,PEJATEN TIMUR,3174041005,2020-10-17,651,68,583,22,18,4
DKI JAKARTA,JAKARTA SELATAN,PASAR MINGGU,PEJATEN TIMUR,3174041005,2020-10-18,652,68,584,1,0,1
DKI JAKARTA,JAKARTA SELATAN,PASAR MINGGU,PEJATEN TIMUR,3174041005,2020-10-19,654,64,590,2,-4,6
DKI JAKARTA,JAKARTA SELATAN,PASAR MINGGU,PEJATEN TIMUR,3174041005,2020-10-20,664,55,609,10,-9,19
DKI JAKARTA,JAKARTA SELATAN,PASAR MINGGU,PEJATEN TIMUR,3174041005,2020-10-21,673,60,613,9,5,4
DKI JAKARTA,JAKARTA SELATAN,PASAR MINGGU,PEJATEN TIMUR,3174041005,2020-10-22,681,64,617,8,4,4
DKI JAKARTA,JAKARTA SELATAN,PASAR MINGGU,PEJATEN TIMUR,3174041005,2020-10-23,688,69,619,7,5,2
DKI JAKARTA,JAKARTA SELATAN,PASAR MINGGU,PEJATEN TIMUR,3174041005,2020-10-24,694,64,630,6,-5,11
DKI JAKARTA,JAKARTA SELATAN,PASAR MINGGU,PEJATEN TIMUR,3174041005,2020-10-25,706,74,632,12,10,2
DKI JAKARTA,JAKARTA SELATAN,PASAR MINGGU,PEJATEN TIMUR,3174041005,2020-10-26,709,63,646,3,-11,14
DKI JAKARTA,JAKARTA SELATAN,PASAR MINGGU,PEJATEN TIMUR,3174041005,2020-10-27,713,64,649,4,1,3
DKI JAKARTA,JAKARTA SELATAN,PASAR MINGGU,PEJATEN TIMUR,3174041005,2020-10-28,715,60,655,2,-4,6
DKI JAKARTA,JAKARTA SELATAN,PASAR MINGGU,PEJATEN TIMUR,3174041005,2020-10-29,725,52,673,10,-8,18
DKI JAKARTA,JAKARTA SELATAN,PASAR MINGGU,PEJATEN TIMUR,3174041005,2020-10-30,735,53,682,10,1,9
DKI JAKARTA,JAKARTA SELATAN,PASAR MINGGU,PEJATEN TIMUR,3174041005,2020-10-31,740,58,682,5,5,0
DKI JAKARTA,JAKARTA SELATAN,PASAR MINGGU,RAGUNAN,3174041004,2020-10-01,567,44,523,0,0,0
DKI JAKARTA,JAKARTA SELATAN,PASAR MINGGU,RAGUNAN,3174041004,2020-10-02,586,55,531,19,11,8
DKI JAKARTA,JAKARTA SELATAN,PASAR MINGGU,RAGUNAN,3174041004,2020-10-03,593,58,535,7,3,4
DKI JAKARTA,JAKARTA SELATAN,PASAR MINGGU,RAGUNAN,3174041004,2020-10-04,610,75,535,17,17,0
DKI JAKARTA,JAKARTA SELATAN,PASAR MINGGU,RAGUNAN,3174041004,2020-10-05,621,81,540,11,6,5
DKI JAKARTA,JAKARTA SELATAN,PASAR MINGGU,RAGUNAN,3174041004,2020-10-06,625,79,546,4,-2,6
DKI JAKARTA,JAKARTA SELATAN,PASAR MINGGU,RAGUNAN,3174041004,2020-10-07,631,77,554,6,-2,8
DKI JAKARTA,JAKARTA SELATAN,PASAR MINGGU,RAGUNAN,3174041004,2020-10-08,640,79,561,9,2,7
DKI JAKARTA,JAKARTA SELATAN,PASAR MINGGU,RAGUNAN,3174041004,2020-10-09,643,80,563,3,1,2
DKI JAKARTA,JAKARTA SELATAN,PASAR MINGGU,RAGUNAN,3174041004,2020-10-10,650,77,573,7,-3,10
DKI JAKARTA,JAKARTA SELATAN,PASAR MINGGU,RAGUNAN,3174041004,2020-10-11,658,81,577,8,4,4
DKI JAKARTA,JAKARTA SELATAN,PASAR MINGGU,RAGUNAN,3174041004,2020-10-12,664,71,593,6,-10,16
DKI JAKARTA,JAKARTA SELATAN,PASAR MINGGU,RAGUNAN,3174041004,2020-10-13,670,64,606,6,-7,13
DKI JAKARTA,JAKARTA SELATAN,PASAR MINGGU,RAGUNAN,3174041004,2020-10-14,679,51,628,9,-13,22
DKI JAKARTA,JAKARTA SELATAN,PASAR MINGGU,RAGUNAN,3174041004,2020-10-15,685,48,637,6,-3,9
DKI JAKARTA,JAKARTA SELATAN,PASAR MINGGU,RAGUNAN,3174041004,2020-10-16,688,42,646,3,-6,9
DKI JAKARTA,JAKARTA SELATAN,PASAR MINGGU,RAGUNAN,3174041004,2020-10-17,704,58,646,16,16,0
DKI JAKARTA,JAKARTA SELATAN,PASAR MINGGU,RAGUNAN,3174041004,2020-10-18,708,62,646,4,4,0
DKI JAKARTA,JAKARTA SELATAN,PASAR MINGGU,RAGUNAN,3174041004,2020-10-19,715,64,651,7,2,5
DKI JAKARTA,JAKARTA SELATAN,PASAR MINGGU,RAGUNAN,3174041004,2020-10-20,728,70,658,13,6,7
DKI JAKARTA,JAKARTA SELATAN,PASAR MINGGU,RAGUNAN,3174041004,2020-10-21,734,67,667,6,-3,9
DKI JAKARTA,JAKARTA SELATAN,PASAR MINGGU,RAGUNAN,3174041004,2020-10-22,744,67,677,10,0,10
DKI JAKARTA,JAKARTA SELATAN,PASAR MINGGU,RAGUNAN,3174041004,2020-10-23,748,71,677,4,4,0
DKI JAKARTA,JAKARTA SELATAN,PASAR MINGGU,RAGUNAN,3174041004,2020-10-24,761,72,689,13,1,12
DKI JAKARTA,JAKARTA SELATAN,PASAR MINGGU,RAGUNAN,3174041004,2020-10-25,765,69,696,4,-3,7
DKI JAKARTA,JAKARTA SELATAN,PASAR MINGGU,RAGUNAN,3174041004,2020-10-26,767,54,713,2,-15,17
DKI JAKARTA,JAKARTA SELATAN,PASAR MINGGU,RAGUNAN,3174041004,2020-10-27,771,52,719,4,-2,6
DKI JAKARTA,JAKARTA SELATAN,PASAR MINGGU,RAGUNAN,3174041004,2020-10-28,782,58,724,11,6,5
DKI JAKARTA,JAKARTA SELATAN,PASAR MINGGU,RAGUNAN,3174041004,2020-10-29,793,58,735,11,0,11
DKI JAKARTA,JAKARTA SELATAN,PASAR MINGGU,RAGUNAN,3174041004,2020-10-30,803,60,743,10,2,8
DKI JAKARTA,JAKARTA SELATAN,PASAR MINGGU,RAGUNAN,3174041004,2020-10-31,807,64,743,4,4,0
DKI JAKARTA,JAKARTA SELATAN,PESANGGRAHAN,BINTARO,3174101002,2020-10-01,1168,69,1099,0,0,0
DKI JAKARTA,JAKARTA SELATAN,PESANGGRAHAN,BINTARO,3174101002,2020-10-02,1203,90,1113,35,21,14
DKI JAKARTA,JAKARTA SELATAN,PESANGGRAHAN,BINTARO,3174101002,2020-10-03,1214,100,1114,11,10,1
DKI JAKARTA,JAKARTA SELATAN,PESANGGRAHAN,BINTARO,3174101002,2020-10-04,1219,102,1117,5,2,3
DKI JAKARTA,JAKARTA SELATAN,PESANGGRAHAN,BINTARO,3174101002,2020-10-05,1225,97,1128,6,-5,11
DKI JAKARTA,JAKARTA SELATAN,PESANGGRAHAN,BINTARO,3174101002,2020-10-06,1234,103,1131,9,6,3
DKI JAKARTA,JAKARTA SELATAN,PESANGGRAHAN,BINTARO,3174101002,2020-10-07,1270,126,1144,36,23,13
DKI JAKARTA,JAKARTA SELATAN,PESANGGRAHAN,BINTARO,3174101002,2020-10-08,1283,129,1154,13,3,10
DKI JAKARTA,JAKARTA SELATAN,PESANGGRAHAN,BINTARO,3174101002,2020-10-09,1291,137,1154,8,8,0
DKI JAKARTA,JAKARTA SELATAN,PESANGGRAHAN,BINTARO,3174101002,2020-10-10,1299,140,1159,8,3,5
DKI JAKARTA,JAKARTA SELATAN,PESANGGRAHAN,BINTARO,3174101002,2020-10-11,1318,154,1164,19,14,5
DKI JAKARTA,JAKARTA SELATAN,PESANGGRAHAN,BINTARO,3174101002,2020-10-12,1329,121,1208,11,-33,44
DKI JAKARTA,JAKARTA SELATAN,PESANGGRAHAN,BINTARO,3174101002,2020-10-13,1331,111,1220,2,-10,12
DKI JAKARTA,JAKARTA SELATAN,PESANGGRAHAN,BINTARO,3174101002,2020-10-14,1336,108,1228,5,-3,8
DKI JAKARTA,JAKARTA SELATAN,PESANGGRAHAN,BINTARO,3174101002,2020-10-15,1353,104,1249,17,-4,21
DKI JAKARTA,JAKARTA SELATAN,PESANGGRAHAN,BINTARO,3174101002,2020-10-16,1366,114,1252,13,10,3
DKI JAKARTA,JAKARTA SELATAN,PESANGGRAHAN,BINTARO,3174101002,2020-10-17,1401,147,1254,35,33,2
DKI JAKARTA,JAKARTA SELATAN,PESANGGRAHAN,BINTARO,3174101002,2020-10-18,1406,145,1261,5,-2,7
DKI JAKARTA,JAKARTA SELATAN,PESANGGRAHAN,BINTARO,3174101002,2020-10-19,1409,119,1290,3,-26,29
DKI JAKARTA,JAKARTA SELATAN,PESANGGRAHAN,BINTARO,3174101002,2020-10-20,1417,107,1310,8,-12,20
DKI JAKARTA,JAKARTA SELATAN,PESANGGRAHAN,BINTARO,3174101002,2020-10-21,1426,110,1316,9,3,6
DKI JAKARTA,JAKARTA SELATAN,PESANGGRAHAN,BINTARO,3174101002,2020-10-22,1435,90,1345,9,-20,29
DKI JAKARTA,JAKARTA SELATAN,PESANGGRAHAN,BINTARO,3174101002,2020-10-23,1450,100,1350,15,10,5
DKI JAKARTA,JAKARTA SELATAN,PESANGGRAHAN,BINTARO,3174101002,2020-10-24,1455,92,1363,5,-8,13
DKI JAKARTA,JAKARTA SELATAN,PESANGGRAHAN,BINTARO,3174101002,2020-10-25,1464,99,1365,9,7,2
DKI JAKARTA,JAKARTA SELATAN,PESANGGRAHAN,BINTARO,3174101002,2020-10-26,1467,92,1375,3,-7,10
DKI JAKARTA,JAKARTA SELATAN,PESANGGRAHAN,BINTARO,3174101002,2020-10-27,1477,96,1381,10,4,6
DKI JAKARTA,JAKARTA SELATAN,PESANGGRAHAN,BINTARO,3174101002,2020-10-28,1489,96,1393,12,0,12
DKI JAKARTA,JAKARTA SELATAN,PESANGGRAHAN,BINTARO,3174101002,2020-10-29,1492,63,1429,3,-33,36
DKI JAKARTA,JAKARTA SELATAN,PESANGGRAHAN,BINTARO,3174101002,2020-10-30,1501,68,1433,9,5,4
DKI JAKARTA,JAKARTA SELATAN,PESANGGRAHAN,BINTARO,3174101002,2020-10-31,1510,75,1435,9,7,2
DKI JAKARTA,JAKARTA SELATAN,PESANGGRAHAN,PESANGGRAHAN,3174101001,2020-10-01,713,83,630,0,0,0
DKI JAKARTA,JAKARTA SELATAN,PESANGGRAHAN,PESANGGRAHAN,3174101001,2020-10-02,727,66,661,14,-17,31
DKI JAKARTA,JAKARTA SELATAN,PESANGGRAHAN,PESANGGRAHAN,3174101001,2020-10-03,743,74,669,16,8,8
DKI JAKARTA,JAKARTA SELATAN,PESANGGRAHAN,PESANGGRAHAN,3174101001,2020-10-04,747,78,669,4,4,0
DKI JAKARTA,JAKARTA SELATAN,PESANGGRAHAN,PESANGGRAHAN,3174101001,2020-10-05,753,75,678,6,-3,9
DKI JAKARTA,JAKARTA SELATAN,PESANGGRAHAN,PESANGGRAHAN,3174101001,2020-10-06,758,76,682,5,1,4
DKI JAKARTA,JAKARTA SELATAN,PESANGGRAHAN,PESANGGRAHAN,3174101001,2020-10-07,778,88,690,20,12,8
DKI JAKARTA,JAKARTA SELATAN,PESANGGRAHAN,PESANGGRAHAN,3174101001,2020-10-08,788,84,704,10,-4,14
DKI JAKARTA,JAKARTA SELATAN,PESANGGRAHAN,PESANGGRAHAN,3174101001,2020-10-09,790,86,704,2,2,0
DKI JAKARTA,JAKARTA SELATAN,PESANGGRAHAN,PESANGGRAHAN,3174101001,2020-10-10,794,87,707,4,1,3
DKI JAKARTA,JAKARTA SELATAN,PESANGGRAHAN,PESANGGRAHAN,3174101001,2020-10-11,808,99,709,14,12,2
DKI JAKARTA,JAKARTA SELATAN,PESANGGRAHAN,PESANGGRAHAN,3174101001,2020-10-12,827,87,740,19,-12,31
DKI JAKARTA,JAKARTA SELATAN,PESANGGRAHAN,PESANGGRAHAN,3174101001,2020-10-13,829,80,749,2,-7,9
DKI JAKARTA,JAKARTA SELATAN,PESANGGRAHAN,PESANGGRAHAN,3174101001,2020-10-14,846,92,754,17,12,5
DKI JAKARTA,JAKARTA SELATAN,PESANGGRAHAN,PESANGGRAHAN,3174101001,2020-10-15,859,94,765,13,2,11
DKI JAKARTA,JAKARTA SELATAN,PESANGGRAHAN,PESANGGRAHAN,3174101001,2020-10-16,869,96,773,10,2,8
DKI JAKARTA,JAKARTA SELATAN,PESANGGRAHAN,PESANGGRAHAN,3174101001,2020-10-17,888,112,776,19,16,3
DKI JAKARTA,JAKARTA SELATAN,PESANGGRAHAN,PESANGGRAHAN,3174101001,2020-10-18,889,112,777,1,0,1
DKI JAKARTA,JAKARTA SELATAN,PESANGGRAHAN,PESANGGRAHAN,3174101001,2020-10-19,889,85,804,0,-27,27
DKI JAKARTA,JAKARTA SELATAN,PESANGGRAHAN,PESANGGRAHAN,3174101001,2020-10-20,902,95,807,13,10,3
DKI JAKARTA,JAKARTA SELATAN,PESANGGRAHAN,PESANGGRAHAN,3174101001,2020-10-21,918,105,813,16,10,6
DKI JAKARTA,JAKARTA SELATAN,PESANGGRAHAN,PESANGGRAHAN,3174101001,2020-10-22,920,98,822,2,-7,9
DKI JAKARTA,JAKARTA SELATAN,PESANGGRAHAN,PESANGGRAHAN,3174101001,2020-10-23,941,119,822,21,21,0
DKI JAKARTA,JAKARTA SELATAN,PESANGGRAHAN,PESANGGRAHAN,3174101001,2020-10-24,945,98,847,4,-21,25
DKI JAKARTA,JAKARTA SELATAN,PESANGGRAHAN,PESANGGRAHAN,3174101001,2020-10-25,948,100,848,3,2,1
DKI JAKARTA,JAKARTA SELATAN,PESANGGRAHAN,PESANGGRAHAN,3174101001,2020-10-26,961,98,863,13,-2,15
DKI JAKARTA,JAKARTA SELATAN,PESANGGRAHAN,PESANGGRAHAN,3174101001,2020-10-27,970,93,877,9,-5,14
DKI JAKARTA,JAKARTA SELATAN,PESANGGRAHAN,PESANGGRAHAN,3174101001,2020-10-28,970,93,877,0,0,0
DKI JAKARTA,JAKARTA SELATAN,PESANGGRAHAN,PESANGGRAHAN,3174101001,2020-10-29,971,73,898,1,-20,21
DKI JAKARTA,JAKARTA SELATAN,PESANGGRAHAN,PESANGGRAHAN,3174101001,2020-10-30,983,76,907,12,3,9
DKI JAKARTA,JAKARTA SELATAN,PESANGGRAHAN,PESANGGRAHAN,3174101001,2020-10-31,986,78,908,3,2,1
DKI JAKARTA,JAKARTA SELATAN,PESANGGRAHAN,PETUKANGAN SELATAN,3174101004,2020-10-01,726,119,607,0,0,0
DKI JAKARTA,JAKARTA SELATAN,PESANGGRAHAN,PETUKANGAN SELATAN,3174101004,2020-10-02,735,117,618,9,-2,11
DKI JAKARTA,JAKARTA SELATAN,PESANGGRAHAN,PETUKANGAN SELATAN,3174101004,2020-10-03,745,122,623,10,5,5
DKI JAKARTA,JAKARTA SELATAN,PESANGGRAHAN,PETUKANGAN SELATAN,3174101004,2020-10-04,750,124,626,5,2,3
DKI JAKARTA,JAKARTA SELATAN,PESANGGRAHAN,PETUKANGAN SELATAN,3174101004,2020-10-05,755,103,652,5,-21,26
DKI JAKARTA,JAKARTA SELATAN,PESANGGRAHAN,PETUKANGAN SELATAN,3174101004,2020-10-06,762,82,680,7,-21,28
DKI JAKARTA,JAKARTA SELATAN,PESANGGRAHAN,PETUKANGAN SELATAN,3174101004,2020-10-07,774,89,685,12,7,5
DKI JAKARTA,JAKARTA SELATAN,PESANGGRAHAN,PETUKANGAN SELATAN,3174101004,2020-10-08,786,67,719,12,-22,34
DKI JAKARTA,JAKARTA SELATAN,PESANGGRAHAN,PETUKANGAN SELATAN,3174101004,2020-10-09,791,70,721,5,3,2
DKI JAKARTA,JAKARTA SELATAN,PESANGGRAHAN,PETUKANGAN SELATAN,3174101004,2020-10-10,802,66,736,11,-4,15
DKI JAKARTA,JAKARTA SELATAN,PESANGGRAHAN,PETUKANGAN SELATAN,3174101004,2020-10-11,810,71,739,8,5,3
DKI JAKARTA,JAKARTA SELATAN,PESANGGRAHAN,PETUKANGAN SELATAN,3174101004,2020-10-12,813,66,747,3,-5,8
DKI JAKARTA,JAKARTA SELATAN,PESANGGRAHAN,PETUKANGAN SELATAN,3174101004,2020-10-13,814,58,756,1,-8,9
DKI JAKARTA,JAKARTA SELATAN,PESANGGRAHAN,PETUKANGAN SELATAN,3174101004,2020-10-14,827,57,770,13,-1,14
DKI JAKARTA,JAKARTA SELATAN,PESANGGRAHAN,PETUKANGAN SELATAN,3174101004,2020-10-15,839,65,774,12,8,4
DKI JAKARTA,JAKARTA SELATAN,PESANGGRAHAN,PETUKANGAN SELATAN,3174101004,2020-10-16,846,67,779,7,2,5
DKI JAKARTA,JAKARTA SELATAN,PESANGGRAHAN,PETUKANGAN SELATAN,3174101004,2020-10-17,895,115,780,49,48,1
DKI JAKARTA,JAKARTA SELATAN,PESANGGRAHAN,PETUKANGAN SELATAN,3174101004,2020-10-18,899,114,785,4,-1,5
DKI JAKARTA,JAKARTA SELATAN,PESANGGRAHAN,PETUKANGAN SELATAN,3174101004,2020-10-19,900,93,807,1,-21,22
DKI JAKARTA,JAKARTA SELATAN,PESANGGRAHAN,PETUKANGAN SELATAN,3174101004,2020-10-20,921,107,814,21,14,7
DKI JAKARTA,JAKARTA SELATAN,PESANGGRAHAN,PETUKANGAN SELATAN,3174101004,2020-10-21,931,109,822,10,2,8
DKI JAKARTA,JAKARTA SELATAN,PESANGGRAHAN,PETUKANGAN SELATAN,3174101004,2020-10-22,936,101,835,5,-8,13
DKI JAKARTA,JAKARTA SELATAN,PESANGGRAHAN,PETUKANGAN SELATAN,3174101004,2020-10-23,944,109,835,8,8,0
DKI JAKARTA,JAKARTA SELATAN,PESANGGRAHAN,PETUKANGAN SELATAN,3174101004,2020-10-24,946,109,837,2,0,2
DKI JAKARTA,JAKARTA SELATAN,PESANGGRAHAN,PETUKANGAN SELATAN,3174101004,2020-10-25,948,110,838,2,1,1
DKI JAKARTA,JAKARTA SELATAN,PESANGGRAHAN,PETUKANGAN SELATAN,3174101004,2020-10-26,952,101,851,4,-9,13
DKI JAKARTA,JAKARTA SELATAN,PESANGGRAHAN,PETUKANGAN SELATAN,3174101004,2020-10-27,977,119,858,25,18,7
DKI JAKARTA,JAKARTA SELATAN,PESANGGRAHAN,PETUKANGAN SELATAN,3174101004,2020-10-28,986,117,869,9,-2,11
DKI JAKARTA,JAKARTA SELATAN,PESANGGRAHAN,PETUKANGAN SELATAN,3174101004,2020-10-29,987,73,914,1,-44,45
DKI JAKARTA,JAKARTA SELATAN,PESANGGRAHAN,PETUKANGAN SELATAN,3174101004,2020-10-30,1002,80,922,15,7,8
DKI JAKARTA,JAKARTA SELATAN,PESANGGRAHAN,PETUKANGAN SELATAN,3174101004,2020-10-31,1005,83,922,3,3,0
DKI JAKARTA,JAKARTA SELATAN,PESANGGRAHAN,PETUKANGAN UTARA,3174101003,2020-10-01,1405,87,1318,0,0,0
DKI JAKARTA,JAKARTA SELATAN,PESANGGRAHAN,PETUKANGAN UTARA,3174101003,2020-10-02,1425,90,1335,20,3,17
DKI JAKARTA,JAKARTA SELATAN,PESANGGRAHAN,PETUKANGAN UTARA,3174101003,2020-10-03,1446,109,1337,21,19,2
DKI JAKARTA,JAKARTA SELATAN,PESANGGRAHAN,PETUKANGAN UTARA,3174101003,2020-10-04,1458,115,1343,12,6,6
DKI JAKARTA,JAKARTA SELATAN,PESANGGRAHAN,PETUKANGAN UTARA,3174101003,2020-10-05,1478,122,1356,20,7,13
DKI JAKARTA,JAKARTA SELATAN,PESANGGRAHAN,PETUKANGAN UTARA,3174101003,2020-10-06,1499,137,1362,21,15,6
DKI JAKARTA,JAKARTA SELATAN,PESANGGRAHAN,PETUKANGAN UTARA,3174101003,2020-10-07,1510,143,1367,11,6,5
DKI JAKARTA,JAKARTA SELATAN,PESANGGRAHAN,PETUKANGAN UTARA,3174101003,2020-10-08,1535,148,1387,25,5,20
DKI JAKARTA,JAKARTA SELATAN,PESANGGRAHAN,PETUKANGAN UTARA,3174101003,2020-10-09,1540,151,1389,5,3,2
DKI JAKARTA,JAKARTA SELATAN,PESANGGRAHAN,PETUKANGAN UTARA,3174101003,2020-10-10,1560,163,1397,20,12,8
DKI JAKARTA,JAKARTA SELATAN,PESANGGRAHAN,PETUKANGAN UTARA,3174101003,2020-10-11,1583,179,1404,23,16,7
DKI JAKARTA,JAKARTA SELATAN,PESANGGRAHAN,PETUKANGAN UTARA,3174101003,2020-10-12,1592,151,1441,9,-28,37
DKI JAKARTA,JAKARTA SELATAN,PESANGGRAHAN,PETUKANGAN UTARA,3174101003,2020-10-13,1593,125,1468,1,-26,27
DKI JAKARTA,JAKARTA SELATAN,PESANGGRAHAN,PETUKANGAN UTARA,3174101003,2020-10-14,1598,110,1488,5,-15,20
DKI JAKARTA,JAKARTA SELATAN,PESANGGRAHAN,PETUKANGAN UTARA,3174101003,2020-10-15,1613,115,1498,15,5,10
DKI JAKARTA,JAKARTA SELATAN,PESANGGRAHAN,PETUKANGAN UTARA,3174101003,2020-10-16,1624,90,1534,11,-25,36
DKI JAKARTA,JAKARTA SELATAN,PESANGGRAHAN,PETUKANGAN UTARA,3174101003,2020-10-17,1646,110,1536,22,20,2
DKI JAKARTA,JAKARTA SELATAN,PESANGGRAHAN,PETUKANGAN UTARA,3174101003,2020-10-18,1649,111,1538,3,1,2
DKI JAKARTA,JAKARTA SELATAN,PESANGGRAHAN,PETUKANGAN UTARA,3174101003,2020-10-19,1652,110,1542,3,-1,4
DKI JAKARTA,JAKARTA SELATAN,PESANGGRAHAN,PETUKANGAN UTARA,3174101003,2020-10-20,1658,96,1562,6,-14,20
DKI JAKARTA,JAKARTA SELATAN,PESANGGRAHAN,PETUKANGAN UTARA,3174101003,2020-10-21,1665,80,1585,7,-16,23
DKI JAKARTA,JAKARTA SELATAN,PESANGGRAHAN,PETUKANGAN UTARA,3174101003,2020-10-22,1670,61,1609,5,-19,24
DKI JAKARTA,JAKARTA SELATAN,PESANGGRAHAN,PETUKANGAN UTARA,3174101003,2020-10-23,1675,66,1609,5,5,0
DKI JAKARTA,JAKARTA SELATAN,PESANGGRAHAN,PETUKANGAN UTARA,3174101003,2020-10-24,1676,59,1617,1,-7,8
DKI JAKARTA,JAKARTA SELATAN,PESANGGRAHAN,PETUKANGAN UTARA,3174101003,2020-10-25,1676,56,1620,0,-3,3
DKI JAKARTA,JAKARTA SELATAN,PESANGGRAHAN,PETUKANGAN UTARA,3174101003,2020-10-26,1678,53,1625,2,-3,5
DKI JAKARTA,JAKARTA SELATAN,PESANGGRAHAN,PETUKANGAN UTARA,3174101003,2020-10-27,1690,50,1640,12,-3,15
DKI JAKARTA,JAKARTA SELATAN,PESANGGRAHAN,PETUKANGAN UTARA,3174101003,2020-10-28,1691,43,1648,1,-7,8
DKI JAKARTA,JAKARTA SELATAN,PESANGGRAHAN,PETUKANGAN UTARA,3174101003,2020-10-29,1694,36,1658,3,-7,10
DKI JAKARTA,JAKARTA SELATAN,PESANGGRAHAN,PETUKANGAN UTARA,3174101003,2020-10-30,1700,34,1666,6,-2,8
DKI JAKARTA,JAKARTA SELATAN,PESANGGRAHAN,PETUKANGAN UTARA,3174101003,2020-10-31,1702,36,1666,2,2,0
DKI JAKARTA,JAKARTA SELATAN,PESANGGRAHAN,ULUJAMI,3174101005,2020-10-01,992,47,945,0,0,0
DKI JAKARTA,JAKARTA SELATAN,PESANGGRAHAN,ULUJAMI,3174101005,2020-10-02,1001,49,952,9,2,7
DKI JAKARTA,JAKARTA SELATAN,PESANGGRAHAN,ULUJAMI,3174101005,2020-10-03,1010,56,954,9,7,2
DKI JAKARTA,JAKARTA SELATAN,PESANGGRAHAN,ULUJAMI,3174101005,2020-10-04,1015,59,956,5,3,2
DKI JAKARTA,JAKARTA SELATAN,PESANGGRAHAN,ULUJAMI,3174101005,2020-10-05,1029,60,969,14,1,13
DKI JAKARTA,JAKARTA SELATAN,PESANGGRAHAN,ULUJAMI,3174101005,2020-10-06,1040,65,975,11,5,6
DKI JAKARTA,JAKARTA SELATAN,PESANGGRAHAN,ULUJAMI,3174101005,2020-10-07,1071,94,977,31,29,2
DKI JAKARTA,JAKARTA SELATAN,PESANGGRAHAN,ULUJAMI,3174101005,2020-10-08,1089,104,985,18,10,8
DKI JAKARTA,JAKARTA SELATAN,PESANGGRAHAN,ULUJAMI,3174101005,2020-10-09,1090,105,985,1,1,0
DKI JAKARTA,JAKARTA SELATAN,PESANGGRAHAN,ULUJAMI,3174101005,2020-10-10,1095,107,988,5,2,3
DKI JAKARTA,JAKARTA SELATAN,PESANGGRAHAN,ULUJAMI,3174101005,2020-10-11,1117,122,995,22,15,7
DKI JAKARTA,JAKARTA SELATAN,PESANGGRAHAN,ULUJAMI,3174101005,2020-10-12,1119,105,1014,2,-17,19
DKI JAKARTA,JAKARTA SELATAN,PESANGGRAHAN,ULUJAMI,3174101005,2020-10-13,1128,98,1030,9,-7,16
DKI JAKARTA,JAKARTA SELATAN,PESANGGRAHAN,ULUJAMI,3174101005,2020-10-14,1142,100,1042,14,2,12
DKI JAKARTA,JAKARTA SELATAN,PESANGGRAHAN,ULUJAMI,3174101005,2020-10-15,1155,104,1051,13,4,9
DKI JAKARTA,JAKARTA SELATAN,PESANGGRAHAN,ULUJAMI,3174101005,2020-10-16,1162,92,1070,7,-12,19
DKI JAKARTA,JAKARTA SELATAN,PESANGGRAHAN,ULUJAMI,3174101005,2020-10-17,1176,104,1072,14,12,2
DKI JAKARTA,JAKARTA SELATAN,PESANGGRAHAN,ULUJAMI,3174101005,2020-10-18,1177,102,1075,1,-2,3
DKI JAKARTA,JAKARTA SELATAN,PESANGGRAHAN,ULUJAMI,3174101005,2020-10-19,1178,68,1110,1,-34,35
DKI JAKARTA,JAKARTA SELATAN,PESANGGRAHAN,ULUJAMI,3174101005,2020-10-20,1192,75,1117,14,7,7
DKI JAKARTA,JAKARTA SELATAN,PESANGGRAHAN,ULUJAMI,3174101005,2020-10-21,1206,78,1128,14,3,11
DKI JAKARTA,JAKARTA SELATAN,PESANGGRAHAN,ULUJAMI,3174101005,2020-10-22,1209,69,1140,3,-9,12
DKI JAKARTA,JAKARTA SELATAN,PESANGGRAHAN,ULUJAMI,3174101005,2020-10-23,1212,71,1141,3,2,1
DKI JAKARTA,JAKARTA SELATAN,PESANGGRAHAN,ULUJAMI,3174101005,2020-10-24,1218,67,1151,6,-4,10
DKI JAKARTA,JAKARTA SELATAN,PESANGGRAHAN,ULUJAMI,3174101005,2020-10-25,1220,68,1152,2,1,1
DKI JAKARTA,JAKARTA SELATAN,PESANGGRAHAN,ULUJAMI,3174101005,2020-10-26,1222,65,1157,2,-3,5
DKI JAKARTA,JAKARTA SELATAN,PESANGGRAHAN,ULUJAMI,3174101005,2020-10-27,1241,70,1171,19,5,14
DKI JAKARTA,JAKARTA SELATAN,PESANGGRAHAN,ULUJAMI,3174101005,2020-10-28,1241,64,1177,0,-6,6
DKI JAKARTA,JAKARTA SELATAN,PESANGGRAHAN,ULUJAMI,3174101005,2020-10-29,1246,58,1188,5,-6,11
DKI JAKARTA,JAKARTA SELATAN,PESANGGRAHAN,ULUJAMI,3174101005,2020-10-30,1252,52,1200,6,-6,12
DKI JAKARTA,JAKARTA SELATAN,PESANGGRAHAN,ULUJAMI,3174101005,2020-10-31,1253,53,1200,1,1,0
DKI JAKARTA,JAKARTA SELATAN,SETIA BUDI,GUNTUR,3174021007,2020-10-01,168,30,138,0,0,0
DKI JAKARTA,JAKARTA SELATAN,SETIA BUDI,GUNTUR,3174021007,2020-10-02,169,21,148,1,-9,10
DKI JAKARTA,JAKARTA SELATAN,SETIA BUDI,GUNTUR,3174021007,2020-10-03,175,27,148,6,6,0
DKI JAKARTA,JAKARTA SELATAN,SETIA BUDI,GUNTUR,3174021007,2020-10-04,176,28,148,1,1,0
DKI JAKARTA,JAKARTA SELATAN,SETIA BUDI,GUNTUR,3174021007,2020-10-05,176,25,151,0,-3,3
DKI JAKARTA,JAKARTA SELATAN,SETIA BUDI,GUNTUR,3174021007,2020-10-06,176,24,152,0,-1,1
DKI JAKARTA,JAKARTA SELATAN,SETIA BUDI,GUNTUR,3174021007,2020-10-07,178,17,161,2,-7,9
DKI JAKARTA,JAKARTA SELATAN,SETIA BUDI,GUNTUR,3174021007,2020-10-08,178,14,164,0,-3,3
DKI JAKARTA,JAKARTA SELATAN,SETIA BUDI,GUNTUR,3174021007,2020-10-09,178,14,164,0,0,0
DKI JAKARTA,JAKARTA SELATAN,SETIA BUDI,GUNTUR,3174021007,2020-10-10,180,12,168,2,-2,4
DKI JAKARTA,JAKARTA SELATAN,SETIA BUDI,GUNTUR,3174021007,2020-10-11,184,14,170,4,2,2
DKI JAKARTA,JAKARTA SELATAN,SETIA BUDI,GUNTUR,3174021007,2020-10-12,184,11,173,0,-3,3
DKI JAKARTA,JAKARTA SELATAN,SETIA BUDI,GUNTUR,3174021007,2020-10-13,184,11,173,0,0,0
DKI JAKARTA,JAKARTA SELATAN,SETIA BUDI,GUNTUR,3174021007,2020-10-14,187,10,177,3,-1,4
DKI JAKARTA,JAKARTA SELATAN,SETIA BUDI,GUNTUR,3174021007,2020-10-15,187,8,179,0,-2,2
DKI JAKARTA,JAKARTA SELATAN,SETIA BUDI,GUNTUR,3174021007,2020-10-16,187,8,179,0,0,0
DKI JAKARTA,JAKARTA SELATAN,SETIA BUDI,GUNTUR,3174021007,2020-10-17,187,7,180,0,-1,1
DKI JAKARTA,JAKARTA SELATAN,SETIA BUDI,GUNTUR,3174021007,2020-10-18,187,7,180,0,0,0
DKI JAKARTA,JAKARTA SELATAN,SETIA BUDI,GUNTUR,3174021007,2020-10-19,187,7,180,0,0,0
DKI JAKARTA,JAKARTA SELATAN,SETIA BUDI,GUNTUR,3174021007,2020-10-20,190,10,180,3,3,0
DKI JAKARTA,JAKARTA SELATAN,SETIA BUDI,GUNTUR,3174021007,2020-10-21,190,9,181,0,-1,1
DKI JAKARTA,JAKARTA SELATAN,SETIA BUDI,GUNTUR,3174021007,2020-10-22,197,14,183,7,5,2
DKI JAKARTA,JAKARTA SELATAN,SETIA BUDI,GUNTUR,3174021007,2020-10-23,198,14,184,1,0,1
DKI JAKARTA,JAKARTA SELATAN,SETIA BUDI,GUNTUR,3174021007,2020-10-24,199,12,187,1,-2,3
DKI JAKARTA,JAKARTA SELATAN,SETIA BUDI,GUNTUR,3174021007,2020-10-25,200,13,187,1,1,0
DKI JAKARTA,JAKARTA SELATAN,SETIA BUDI,GUNTUR,3174021007,2020-10-26,200,10,190,0,-3,3
DKI JAKARTA,JAKARTA SELATAN,SETIA BUDI,GUNTUR,3174021007,2020-10-27,204,12,192,4,2,2
DKI JAKARTA,JAKARTA SELATAN,SETIA BUDI,GUNTUR,3174021007,2020-10-28,206,13,193,2,1,1
DKI JAKARTA,JAKARTA SELATAN,SETIA BUDI,GUNTUR,3174021007,2020-10-29,206,13,193,0,0,0
DKI JAKARTA,JAKARTA SELATAN,SETIA BUDI,GUNTUR,3174021007,2020-10-30,208,12,196,2,-1,3
DKI JAKARTA,JAKARTA SELATAN,SETIA BUDI,GUNTUR,3174021007,2020-10-31,209,12,197,1,0,1
DKI JAKARTA,JAKARTA SELATAN,SETIA BUDI,KARET,3174021004,2020-10-01,338,40,298,0,0,0
DKI JAKARTA,JAKARTA SELATAN,SETIA BUDI,KARET,3174021004,2020-10-02,345,38,307,7,-2,9
DKI JAKARTA,JAKARTA SELATAN,SETIA BUDI,KARET,3174021004,2020-10-03,346,39,307,1,1,0
DKI JAKARTA,JAKARTA SELATAN,SETIA BUDI,KARET,3174021004,2020-10-04,348,41,307,2,2,0
DKI JAKARTA,JAKARTA SELATAN,SETIA BUDI,KARET,3174021004,2020-10-05,352,39,313,4,-2,6
DKI JAKARTA,JAKARTA SELATAN,SETIA BUDI,KARET,3174021004,2020-10-06,355,37,318,3,-2,5
DKI JAKARTA,JAKARTA SELATAN,SETIA BUDI,KARET,3174021004,2020-10-07,362,32,330,7,-5,12
DKI JAKARTA,JAKARTA SELATAN,SETIA BUDI,KARET,3174021004,2020-10-08,368,35,333,6,3,3
DKI JAKARTA,JAKARTA SELATAN,SETIA BUDI,KARET,3174021004,2020-10-09,371,38,333,3,3,0
DKI JAKARTA,JAKARTA SELATAN,SETIA BUDI,KARET,3174021004,2020-10-10,373,38,335,2,0,2
DKI JAKARTA,JAKARTA SELATAN,SETIA BUDI,KARET,3174021004,2020-10-11,373,38,335,0,0,0
DKI JAKARTA,JAKARTA SELATAN,SETIA BUDI,KARET,3174021004,2020-10-12,376,33,343,3,-5,8
DKI JAKARTA,JAKARTA SELATAN,SETIA BUDI,KARET,3174021004,2020-10-13,377,28,349,1,-5,6
DKI JAKARTA,JAKARTA SELATAN,SETIA BUDI,KARET,3174021004,2020-10-14,378,27,351,1,-1,2
DKI JAKARTA,JAKARTA SELATAN,SETIA BUDI,KARET,3174021004,2020-10-15,379,25,354,1,-2,3
DKI JAKARTA,JAKARTA SELATAN,SETIA BUDI,KARET,3174021004,2020-10-16,382,21,361,3,-4,7
DKI JAKARTA,JAKARTA SELATAN,SETIA BUDI,KARET,3174021004,2020-10-17,382,21,361,0,0,0
DKI JAKARTA,JAKARTA SELATAN,SETIA BUDI,KARET,3174021004,2020-10-18,384,22,362,2,1,1
DKI JAKARTA,JAKARTA SELATAN,SETIA BUDI,KARET,3174021004,2020-10-19,384,17,367,0,-5,5
DKI JAKARTA,JAKARTA SELATAN,SETIA BUDI,KARET,3174021004,2020-10-20,385,16,369,1,-1,2
DKI JAKARTA,JAKARTA SELATAN,SETIA BUDI,KARET,3174021004,2020-10-21,389,15,374,4,-1,5
DKI JAKARTA,JAKARTA SELATAN,SETIA BUDI,KARET,3174021004,2020-10-22,390,14,376,1,-1,2
DKI JAKARTA,JAKARTA SELATAN,SETIA BUDI,KARET,3174021004,2020-10-23,390,14,376,0,0,0
DKI JAKARTA,JAKARTA SELATAN,SETIA BUDI,KARET,3174021004,2020-10-24,394,12,382,4,-2,6
DKI JAKARTA,JAKARTA SELATAN,SETIA BUDI,KARET,3174021004,2020-10-25,394,11,383,0,-1,1
DKI JAKARTA,JAKARTA SELATAN,SETIA BUDI,KARET,3174021004,2020-10-26,396,11,385,2,0,2
DKI JAKARTA,JAKARTA SELATAN,SETIA BUDI,KARET,3174021004,2020-10-27,397,11,386,1,0,1
DKI JAKARTA,JAKARTA SELATAN,SETIA BUDI,KARET,3174021004,2020-10-28,398,11,387,1,0,1
DKI JAKARTA,JAKARTA SELATAN,SETIA BUDI,KARET,3174021004,2020-10-29,401,12,389,3,1,2
DKI JAKARTA,JAKARTA SELATAN,SETIA BUDI,KARET,3174021004,2020-10-30,402,13,389,1,1,0
DKI JAKARTA,JAKARTA SELATAN,SETIA BUDI,KARET,3174021004,2020-10-31,404,14,390,2,1,1
DKI JAKARTA,JAKARTA SELATAN,SETIA BUDI,KARET KUNINGAN,3174021003,2020-10-01,308,26,282,0,0,0
DKI JAKARTA,JAKARTA SELATAN,SETIA BUDI,KARET KUNINGAN,3174021003,2020-10-02,313,26,287,5,0,5
DKI JAKARTA,JAKARTA SELATAN,SETIA BUDI,KARET KUNINGAN,3174021003,2020-10-03,314,31,283,1,5,-4
DKI JAKARTA,JAKARTA SELATAN,SETIA BUDI,KARET KUNINGAN,3174021003,2020-10-04,321,32,289,7,1,6
DKI JAKARTA,JAKARTA SELATAN,SETIA BUDI,KARET KUNINGAN,3174021003,2020-10-05,323,31,292,2,-1,3
DKI JAKARTA,JAKARTA SELATAN,SETIA BUDI,KARET KUNINGAN,3174021003,2020-10-06,324,29,295,1,-2,3
DKI JAKARTA,JAKARTA SELATAN,SETIA BUDI,KARET KUNINGAN,3174021003,2020-10-07,335,32,303,11,3,8
DKI JAKARTA,JAKARTA SELATAN,SETIA BUDI,KARET KUNINGAN,3174021003,2020-10-08,354,48,306,19,16,3
DKI JAKARTA,JAKARTA SELATAN,SETIA BUDI,KARET KUNINGAN,3174021003,2020-10-09,357,51,306,3,3,0
DKI JAKARTA,JAKARTA SELATAN,SETIA BUDI,KARET KUNINGAN,3174021003,2020-10-10,359,51,308,2,0,2
DKI JAKARTA,JAKARTA SELATAN,SETIA BUDI,KARET KUNINGAN,3174021003,2020-10-11,368,58,310,9,7,2
DKI JAKARTA,JAKARTA SELATAN,SETIA BUDI,KARET KUNINGAN,3174021003,2020-10-12,369,54,315,1,-4,5
DKI JAKARTA,JAKARTA SELATAN,SETIA BUDI,KARET KUNINGAN,3174021003,2020-10-13,372,52,320,3,-2,5
DKI JAKARTA,JAKARTA SELATAN,SETIA BUDI,KARET KUNINGAN,3174021003,2020-10-14,374,50,324,2,-2,4
DKI JAKARTA,JAKARTA SELATAN,SETIA BUDI,KARET KUNINGAN,3174021003,2020-10-15,381,54,327,7,4,3
DKI JAKARTA,JAKARTA SELATAN,SETIA BUDI,KARET KUNINGAN,3174021003,2020-10-16,387,53,334,6,-1,7
DKI JAKARTA,JAKARTA SELATAN,SETIA BUDI,KARET KUNINGAN,3174021003,2020-10-17,393,57,336,6,4,2
DKI JAKARTA,JAKARTA SELATAN,SETIA BUDI,KARET KUNINGAN,3174021003,2020-10-18,394,58,336,1,1,0
DKI JAKARTA,JAKARTA SELATAN,SETIA BUDI,KARET KUNINGAN,3174021003,2020-10-19,396,54,342,2,-4,6
DKI JAKARTA,JAKARTA SELATAN,SETIA BUDI,KARET KUNINGAN,3174021003,2020-10-20,400,44,356,4,-10,14
DKI JAKARTA,JAKARTA SELATAN,SETIA BUDI,KARET KUNINGAN,3174021003,2020-10-21,405,40,365,5,-4,9
DKI JAKARTA,JAKARTA SELATAN,SETIA BUDI,KARET KUNINGAN,3174021003,2020-10-22,408,30,378,3,-10,13
DKI JAKARTA,JAKARTA SELATAN,SETIA BUDI,KARET KUNINGAN,3174021003,2020-10-23,409,31,378,1,1,0
DKI JAKARTA,JAKARTA SELATAN,SETIA BUDI,KARET KUNINGAN,3174021003,2020-10-24,411,29,382,2,-2,4
DKI JAKARTA,JAKARTA SELATAN,SETIA BUDI,KARET KUNINGAN,3174021003,2020-10-25,413,30,383,2,1,1
DKI JAKARTA,JAKARTA SELATAN,SETIA BUDI,KARET KUNINGAN,3174021003,2020-10-26,413,25,388,0,-5,5
DKI JAKARTA,JAKARTA SELATAN,SETIA BUDI,KARET KUNINGAN,3174021003,2020-10-27,431,41,390,18,16,2
DKI JAKARTA,JAKARTA SELATAN,SETIA BUDI,KARET KUNINGAN,3174021003,2020-10-28,436,40,396,5,-1,6
DKI JAKARTA,JAKARTA SELATAN,SETIA BUDI,KARET KUNINGAN,3174021003,2020-10-29,438,36,402,2,-4,6
DKI JAKARTA,JAKARTA SELATAN,SETIA BUDI,KARET KUNINGAN,3174021003,2020-10-30,441,39,402,3,3,0
DKI JAKARTA,JAKARTA SELATAN,SETIA BUDI,KARET KUNINGAN,3174021003,2020-10-31,443,40,403,2,1,1
DKI JAKARTA,JAKARTA SELATAN,SETIA BUDI,KARET SEMANGGI,3174021002,2020-10-01,74,5,69,0,0,0
DKI JAKARTA,JAKARTA SELATAN,SETIA BUDI,KARET SEMANGGI,3174021002,2020-10-02,74,5,69,0,0,0
DKI JAKARTA,JAKARTA SELATAN,SETIA BUDI,KARET SEMANGGI,3174021002,2020-10-03,73,6,67,-1,1,-2
DKI JAKARTA,JAKARTA SELATAN,SETIA BUDI,KARET SEMANGGI,3174021002,2020-10-04,75,6,69,2,0,2
DKI JAKARTA,JAKARTA SELATAN,SETIA BUDI,KARET SEMANGGI,3174021002,2020-10-05,75,5,70,0,-1,1
DKI JAKARTA,JAKARTA SELATAN,SETIA BUDI,KARET SEMANGGI,3174021002,2020-10-06,75,5,70,0,0,0
DKI JAKARTA,JAKARTA SELATAN,SETIA BUDI,KARET SEMANGGI,3174021002,2020-10-07,76,4,72,1,-1,2
DKI JAKARTA,JAKARTA SELATAN,SETIA BUDI,KARET SEMANGGI,3174021002,2020-10-08,77,4,73,1,0,1
DKI JAKARTA,JAKARTA SELATAN,SETIA BUDI,KARET SEMANGGI,3174021002,2020-10-09,77,4,73,0,0,0
DKI JAKARTA,JAKARTA SELATAN,SETIA BUDI,KARET SEMANGGI,3174021002,2020-10-10,78,5,73,1,1,0
DKI JAKARTA,JAKARTA SELATAN,SETIA BUDI,KARET SEMANGGI,3174021002,2020-10-11,80,7,73,2,2,0
DKI JAKARTA,JAKARTA SELATAN,SETIA BUDI,KARET SEMANGGI,3174021002,2020-10-12,80,7,73,0,0,0
DKI JAKARTA,JAKARTA SELATAN,SETIA BUDI,KARET SEMANGGI,3174021002,2020-10-13,80,5,75,0,-2,2
DKI JAKARTA,JAKARTA SELATAN,SETIA BUDI,KARET SEMANGGI,3174021002,2020-10-14,80,5,75,0,0,0
DKI JAKARTA,JAKARTA SELATAN,SETIA BUDI,KARET SEMANGGI,3174021002,2020-10-15,81,5,76,1,0,1
DKI JAKARTA,JAKARTA SELATAN,SETIA BUDI,KARET SEMANGGI,3174021002,2020-10-16,83,7,76,2,2,0
DKI JAKARTA,JAKARTA SELATAN,SETIA BUDI,KARET SEMANGGI,3174021002,2020-10-17,84,8,76,1,1,0
DKI JAKARTA,JAKARTA SELATAN,SETIA BUDI,KARET SEMANGGI,3174021002,2020-10-18,84,8,76,0,0,0
DKI JAKARTA,JAKARTA SELATAN,SETIA BUDI,KARET SEMANGGI,3174021002,2020-10-19,84,8,76,0,0,0
DKI JAKARTA,JAKARTA SELATAN,SETIA BUDI,KARET SEMANGGI,3174021002,2020-10-20,84,8,76,0,0,0
DKI JAKARTA,JAKARTA SELATAN,SETIA BUDI,KARET SEMANGGI,3174021002,2020-10-21,85,5,80,1,-3,4
DKI JAKARTA,JAKARTA SELATAN,SETIA BUDI,KARET SEMANGGI,3174021002,2020-10-22,86,6,80,1,1,0
DKI JAKARTA,JAKARTA SELATAN,SETIA BUDI,KARET SEMANGGI,3174021002,2020-10-23,86,6,80,0,0,0
DKI JAKARTA,JAKARTA SELATAN,SETIA BUDI,KARET SEMANGGI,3174021002,2020-10-24,87,3,84,1,-3,4
DKI JAKARTA,JAKARTA SELATAN,SETIA BUDI,KARET SEMANGGI,3174021002,2020-10-25,88,4,84,1,1,0
DKI JAKARTA,JAKARTA SELATAN,SETIA BUDI,KARET SEMANGGI,3174021002,2020-10-26,88,4,84,0,0,0
DKI JAKARTA,JAKARTA SELATAN,SETIA BUDI,KARET SEMANGGI,3174021002,2020-10-27,90,5,85,2,1,1
DKI JAKARTA,JAKARTA SELATAN,SETIA BUDI,KARET SEMANGGI,3174021002,2020-10-28,90,5,85,0,0,0
DKI JAKARTA,JAKARTA SELATAN,SETIA BUDI,KARET SEMANGGI,3174021002,2020-10-29,90,5,85,0,0,0
DKI JAKARTA,JAKARTA SELATAN,SETIA BUDI,KARET SEMANGGI,3174021002,2020-10-30,92,7,85,2,2,0
DKI JAKARTA,JAKARTA SELATAN,SETIA BUDI,KARET SEMANGGI,3174021002,2020-10-31,92,7,85,0,0,0
DKI JAKARTA,JAKARTA SELATAN,SETIA BUDI,KUNINGAN TIMUR,3174021008,2020-10-01,133,13,120,0,0,0
DKI JAKARTA,JAKARTA SELATAN,SETIA BUDI,KUNINGAN TIMUR,3174021008,2020-10-02,139,15,124,6,2,4
DKI JAKARTA,JAKARTA SELATAN,SETIA BUDI,KUNINGAN TIMUR,3174021008,2020-10-03,141,17,124,2,2,0
DKI JAKARTA,JAKARTA SELATAN,SETIA BUDI,KUNINGAN TIMUR,3174021008,2020-10-04,147,21,126,6,4,2
DKI JAKARTA,JAKARTA SELATAN,SETIA BUDI,KUNINGAN TIMUR,3174021008,2020-10-05,148,22,126,1,1,0
DKI JAKARTA,JAKARTA SELATAN,SETIA BUDI,KUNINGAN TIMUR,3174021008,2020-10-06,149,21,128,1,-1,2
DKI JAKARTA,JAKARTA SELATAN,SETIA BUDI,KUNINGAN TIMUR,3174021008,2020-10-07,150,21,129,1,0,1
DKI JAKARTA,JAKARTA SELATAN,SETIA BUDI,KUNINGAN TIMUR,3174021008,2020-10-08,153,23,130,3,2,1
DKI JAKARTA,JAKARTA SELATAN,SETIA BUDI,KUNINGAN TIMUR,3174021008,2020-10-09,156,25,131,3,2,1
DKI JAKARTA,JAKARTA SELATAN,SETIA BUDI,KUNINGAN TIMUR,3174021008,2020-10-10,157,18,139,1,-7,8
DKI JAKARTA,JAKARTA SELATAN,SETIA BUDI,KUNINGAN TIMUR,3174021008,2020-10-11,170,26,144,13,8,5
DKI JAKARTA,JAKARTA SELATAN,SETIA BUDI,KUNINGAN TIMUR,3174021008,2020-10-12,170,25,145,0,-1,1
DKI JAKARTA,JAKARTA SELATAN,SETIA BUDI,KUNINGAN TIMUR,3174021008,2020-10-13,170,21,149,0,-4,4
DKI JAKARTA,JAKARTA SELATAN,SETIA BUDI,KUNINGAN TIMUR,3174021008,2020-10-14,184,33,151,14,12,2
DKI JAKARTA,JAKARTA SELATAN,SETIA BUDI,KUNINGAN TIMUR,3174021008,2020-10-15,192,40,152,8,7,1
DKI JAKARTA,JAKARTA SELATAN,SETIA BUDI,KUNINGAN TIMUR,3174021008,2020-10-16,196,41,155,4,1,3
DKI JAKARTA,JAKARTA SELATAN,SETIA BUDI,KUNINGAN TIMUR,3174021008,2020-10-17,202,45,157,6,4,2
DKI JAKARTA,JAKARTA SELATAN,SETIA BUDI,KUNINGAN TIMUR,3174021008,2020-10-18,204,43,161,2,-2,4
DKI JAKARTA,JAKARTA SELATAN,SETIA BUDI,KUNINGAN TIMUR,3174021008,2020-10-19,204,43,161,0,0,0
DKI JAKARTA,JAKARTA SELATAN,SETIA BUDI,KUNINGAN TIMUR,3174021008,2020-10-20,208,45,163,4,2,2
DKI JAKARTA,JAKARTA SELATAN,SETIA BUDI,KUNINGAN TIMUR,3174021008,2020-10-21,209,38,171,1,-7,8
DKI JAKARTA,JAKARTA SELATAN,SETIA BUDI,KUNINGAN TIMUR,3174021008,2020-10-22,210,36,174,1,-2,3
DKI JAKARTA,JAKARTA SELATAN,SETIA BUDI,KUNINGAN TIMUR,3174021008,2020-10-23,210,36,174,0,0,0
DKI JAKARTA,JAKARTA SELATAN,SETIA BUDI,KUNINGAN TIMUR,3174021008,2020-10-24,210,34,176,0,-2,2
DKI JAKARTA,JAKARTA SELATAN,SETIA BUDI,KUNINGAN TIMUR,3174021008,2020-10-25,211,33,178,1,-1,2
DKI JAKARTA,JAKARTA SELATAN,SETIA BUDI,KUNINGAN TIMUR,3174021008,2020-10-26,217,21,196,6,-12,18
DKI JAKARTA,JAKARTA SELATAN,SETIA BUDI,KUNINGAN TIMUR,3174021008,2020-10-27,222,25,197,5,4,1
DKI JAKARTA,JAKARTA SELATAN,SETIA BUDI,KUNINGAN TIMUR,3174021008,2020-10-28,225,20,205,3,-5,8
DKI JAKARTA,JAKARTA SELATAN,SETIA BUDI,KUNINGAN TIMUR,3174021008,2020-10-29,227,12,215,2,-8,10
DKI JAKARTA,JAKARTA SELATAN,SETIA BUDI,KUNINGAN TIMUR,3174021008,2020-10-30,229,14,215,2,2,0
DKI JAKARTA,JAKARTA SELATAN,SETIA BUDI,KUNINGAN TIMUR,3174021008,2020-10-31,231,16,215,2,2,0
DKI JAKARTA,JAKARTA SELATAN,SETIA BUDI,MENTENG ATAS,3174021005,2020-10-01,1112,107,1005,0,0,0
DKI JAKARTA,JAKARTA SELATAN,SETIA BUDI,MENTENG ATAS,3174021005,2020-10-02,1145,125,1020,33,18,15
DKI JAKARTA,JAKARTA SELATAN,SETIA BUDI,MENTENG ATAS,3174021005,2020-10-03,1150,130,1020,5,5,0
DKI JAKARTA,JAKARTA SELATAN,SETIA BUDI,MENTENG ATAS,3174021005,2020-10-04,1157,135,1022,7,5,2
DKI JAKARTA,JAKARTA SELATAN,SETIA BUDI,MENTENG ATAS,3174021005,2020-10-05,1162,123,1039,5,-12,17
DKI JAKARTA,JAKARTA SELATAN,SETIA BUDI,MENTENG ATAS,3174021005,2020-10-06,1184,126,1058,22,3,19
DKI JAKARTA,JAKARTA SELATAN,SETIA BUDI,MENTENG ATAS,3174021005,2020-10-07,1198,135,1063,14,9,5
DKI JAKARTA,JAKARTA SELATAN,SETIA BUDI,MENTENG ATAS,3174021005,2020-10-08,1214,141,1073,16,6,10
DKI JAKARTA,JAKARTA SELATAN,SETIA BUDI,MENTENG ATAS,3174021005,2020-10-09,1223,149,1074,9,8,1
DKI JAKARTA,JAKARTA SELATAN,SETIA BUDI,MENTENG ATAS,3174021005,2020-10-10,1228,150,1078,5,1,4
DKI JAKARTA,JAKARTA SELATAN,SETIA BUDI,MENTENG ATAS,3174021005,2020-10-11,1246,167,1079,18,17,1
DKI JAKARTA,JAKARTA SELATAN,SETIA BUDI,MENTENG ATAS,3174021005,2020-10-12,1250,104,1146,4,-63,67
DKI JAKARTA,JAKARTA SELATAN,SETIA BUDI,MENTENG ATAS,3174021005,2020-10-13,1251,87,1164,1,-17,18
DKI JAKARTA,JAKARTA SELATAN,SETIA BUDI,MENTENG ATAS,3174021005,2020-10-14,1276,102,1174,25,15,10
DKI JAKARTA,JAKARTA SELATAN,SETIA BUDI,MENTENG ATAS,3174021005,2020-10-15,1285,105,1180,9,3,6
DKI JAKARTA,JAKARTA SELATAN,SETIA BUDI,MENTENG ATAS,3174021005,2020-10-16,1287,81,1206,2,-24,26
DKI JAKARTA,JAKARTA SELATAN,SETIA BUDI,MENTENG ATAS,3174021005,2020-10-17,1307,95,1212,20,14,6
DKI JAKARTA,JAKARTA SELATAN,SETIA BUDI,MENTENG ATAS,3174021005,2020-10-18,1310,96,1214,3,1,2
DKI JAKARTA,JAKARTA SELATAN,SETIA BUDI,MENTENG ATAS,3174021005,2020-10-19,1311,87,1224,1,-9,10
DKI JAKARTA,JAKARTA SELATAN,SETIA BUDI,MENTENG ATAS,3174021005,2020-10-20,1315,77,1238,4,-10,14
DKI JAKARTA,JAKARTA SELATAN,SETIA BUDI,MENTENG ATAS,3174021005,2020-10-21,1324,83,1241,9,6,3
DKI JAKARTA,JAKARTA SELATAN,SETIA BUDI,MENTENG ATAS,3174021005,2020-10-22,1332,83,1249,8,0,8
DKI JAKARTA,JAKARTA SELATAN,SETIA BUDI,MENTENG ATAS,3174021005,2020-10-23,1354,103,1251,22,20,2
DKI JAKARTA,JAKARTA SELATAN,SETIA BUDI,MENTENG ATAS,3174021005,2020-10-24,1361,99,1262,7,-4,11
DKI JAKARTA,JAKARTA SELATAN,SETIA BUDI,MENTENG ATAS,3174021005,2020-10-25,1365,97,1268,4,-2,6
DKI JAKARTA,JAKARTA SELATAN,SETIA BUDI,MENTENG ATAS,3174021005,2020-10-26,1368,71,1297,3,-26,29
DKI JAKARTA,JAKARTA SELATAN,SETIA BUDI,MENTENG ATAS,3174021005,2020-10-27,1376,75,1301,8,4,4
DKI JAKARTA,JAKARTA SELATAN,SETIA BUDI,MENTENG ATAS,3174021005,2020-10-28,1383,75,1308,7,0,7
DKI JAKARTA,JAKARTA SELATAN,SETIA BUDI,MENTENG ATAS,3174021005,2020-10-29,1387,69,1319,4,-6,11
DKI JAKARTA,JAKARTA SELATAN,SETIA BUDI,MENTENG ATAS,3174021005,2020-10-30,1394,72,1323,7,3,4
DKI JAKARTA,JAKARTA SELATAN,SETIA BUDI,MENTENG ATAS,3174021005,2020-10-31,1398,74,1325,4,2,2
DKI JAKARTA,JAKARTA SELATAN,SETIA BUDI,PASAR MANGGIS,3174021006,2020-10-01,828,103,725,0,0,0
DKI JAKARTA,JAKARTA SELATAN,SETIA BUDI,PASAR MANGGIS,3174021006,2020-10-02,833,100,733,5,-3,8
DKI JAKARTA,JAKARTA SELATAN,SETIA BUDI,PASAR MANGGIS,3174021006,2020-10-03,845,109,736,12,9,3
DKI JAKARTA,JAKARTA SELATAN,SETIA BUDI,PASAR MANGGIS,3174021006,2020-10-04,852,115,737,7,6,1
DKI JAKARTA,JAKARTA SELATAN,SETIA BUDI,PASAR MANGGIS,3174021006,2020-10-05,861,109,752,9,-6,15
DKI JAKARTA,JAKARTA SELATAN,SETIA BUDI,PASAR MANGGIS,3174021006,2020-10-06,867,95,772,6,-14,20
DKI JAKARTA,JAKARTA SELATAN,SETIA BUDI,PASAR MANGGIS,3174021006,2020-10-07,880,93,787,13,-2,15
DKI JAKARTA,JAKARTA SELATAN,SETIA BUDI,PASAR MANGGIS,3174021006,2020-10-08,892,79,813,12,-14,26
DKI JAKARTA,JAKARTA SELATAN,SETIA BUDI,PASAR MANGGIS,3174021006,2020-10-09,897,83,814,5,4,1
DKI JAKARTA,JAKARTA SELATAN,SETIA BUDI,PASAR MANGGIS,3174021006,2020-10-10,899,78,821,2,-5,7
DKI JAKARTA,JAKARTA SELATAN,SETIA BUDI,PASAR MANGGIS,3174021006,2020-10-11,910,88,822,11,10,1
DKI JAKARTA,JAKARTA SELATAN,SETIA BUDI,PASAR MANGGIS,3174021006,2020-10-12,913,84,829,3,-4,7
DKI JAKARTA,JAKARTA SELATAN,SETIA BUDI,PASAR MANGGIS,3174021006,2020-10-13,915,62,853,2,-22,24
DKI JAKARTA,JAKARTA SELATAN,SETIA BUDI,PASAR MANGGIS,3174021006,2020-10-14,920,57,863,5,-5,10
DKI JAKARTA,JAKARTA SELATAN,SETIA BUDI,PASAR MANGGIS,3174021006,2020-10-15,932,65,867,12,8,4
DKI JAKARTA,JAKARTA SELATAN,SETIA BUDI,PASAR MANGGIS,3174021006,2020-10-16,933,61,872,1,-4,5
DKI JAKARTA,JAKARTA SELATAN,SETIA BUDI,PASAR MANGGIS,3174021006,2020-10-17,942,68,874,9,7,2
DKI JAKARTA,JAKARTA SELATAN,SETIA BUDI,PASAR MANGGIS,3174021006,2020-10-18,942,66,876,0,-2,2
DKI JAKARTA,JAKARTA SELATAN,SETIA BUDI,PASAR MANGGIS,3174021006,2020-10-19,943,54,889,1,-12,13
DKI JAKARTA,JAKARTA SELATAN,SETIA BUDI,PASAR MANGGIS,3174021006,2020-10-20,948,49,899,5,-5,10
DKI JAKARTA,JAKARTA SELATAN,SETIA BUDI,PASAR MANGGIS,3174021006,2020-10-21,957,54,903,9,5,4
DKI JAKARTA,JAKARTA SELATAN,SETIA BUDI,PASAR MANGGIS,3174021006,2020-10-22,958,49,909,1,-5,6
DKI JAKARTA,JAKARTA SELATAN,SETIA BUDI,PASAR MANGGIS,3174021006,2020-10-23,969,60,909,11,11,0
DKI JAKARTA,JAKARTA SELATAN,SETIA BUDI,PASAR MANGGIS,3174021006,2020-10-24,970,51,919,1,-9,10
DKI JAKARTA,JAKARTA SELATAN,SETIA BUDI,PASAR MANGGIS,3174021006,2020-10-25,972,50,922,2,-1,3
DKI JAKARTA,JAKARTA SELATAN,SETIA BUDI,PASAR MANGGIS,3174021006,2020-10-26,975,45,930,3,-5,8
DKI JAKARTA,JAKARTA SELATAN,SETIA BUDI,PASAR MANGGIS,3174021006,2020-10-27,993,59,934,18,14,4
DKI JAKARTA,JAKARTA SELATAN,SETIA BUDI,PASAR MANGGIS,3174021006,2020-10-28,998,55,943,5,-4,9
DKI JAKARTA,JAKARTA SELATAN,SETIA BUDI,PASAR MANGGIS,3174021006,2020-10-29,1000,46,954,2,-9,11
DKI JAKARTA,JAKARTA SELATAN,SETIA BUDI,PASAR MANGGIS,3174021006,2020-10-30,1005,50,955,5,4,1
DKI JAKARTA,JAKARTA SELATAN,SETIA BUDI,PASAR MANGGIS,3174021006,2020-10-31,1007,52,955,2,2,0
DKI JAKARTA,JAKARTA SELATAN,SETIA BUDI,SETIA BUDI,3174021001,2020-10-01,299,43,256,0,0,0
DKI JAKARTA,JAKARTA SELATAN,SETIA BUDI,SETIA BUDI,3174021001,2020-10-02,301,37,264,2,-6,8
DKI JAKARTA,JAKARTA SELATAN,SETIA BUDI,SETIA BUDI,3174021001,2020-10-03,304,36,268,3,-1,4
DKI JAKARTA,JAKARTA SELATAN,SETIA BUDI,SETIA BUDI,3174021001,2020-10-04,304,14,290,0,-22,22
DKI JAKARTA,JAKARTA SELATAN,SETIA BUDI,SETIA BUDI,3174021001,2020-10-05,304,14,290,0,0,0
DKI JAKARTA,JAKARTA SELATAN,SETIA BUDI,SETIA BUDI,3174021001,2020-10-06,305,14,291,1,0,1
DKI JAKARTA,JAKARTA SELATAN,SETIA BUDI,SETIA BUDI,3174021001,2020-10-07,307,7,300,2,-7,9
DKI JAKARTA,JAKARTA SELATAN,SETIA BUDI,SETIA BUDI,3174021001,2020-10-08,316,16,300,9,9,0
DKI JAKARTA,JAKARTA SELATAN,SETIA BUDI,SETIA BUDI,3174021001,2020-10-09,316,16,300,0,0,0
DKI JAKARTA,JAKARTA SELATAN,SETIA BUDI,SETIA BUDI,3174021001,2020-10-10,320,19,301,4,3,1
DKI JAKARTA,JAKARTA SELATAN,SETIA BUDI,SETIA BUDI,3174021001,2020-10-11,321,19,302,1,0,1
DKI JAKARTA,JAKARTA SELATAN,SETIA BUDI,SETIA BUDI,3174021001,2020-10-12,322,18,304,1,-1,2
DKI JAKARTA,JAKARTA SELATAN,SETIA BUDI,SETIA BUDI,3174021001,2020-10-13,327,22,305,5,4,1
DKI JAKARTA,JAKARTA SELATAN,SETIA BUDI,SETIA BUDI,3174021001,2020-10-14,328,23,305,1,1,0
DKI JAKARTA,JAKARTA SELATAN,SETIA BUDI,SETIA BUDI,3174021001,2020-10-15,336,30,306,8,7,1
DKI JAKARTA,JAKARTA SELATAN,SETIA BUDI,SETIA BUDI,3174021001,2020-10-16,340,32,308,4,2,2
DKI JAKARTA,JAKARTA SELATAN,SETIA BUDI,SETIA BUDI,3174021001,2020-10-17,345,35,310,5,3,2
DKI JAKARTA,JAKARTA SELATAN,SETIA BUDI,SETIA BUDI,3174021001,2020-10-18,348,34,314,3,-1,4
DKI JAKARTA,JAKARTA SELATAN,SETIA BUDI,SETIA BUDI,3174021001,2020-10-19,351,33,318,3,-1,4
DKI JAKARTA,JAKARTA SELATAN,SETIA BUDI,SETIA BUDI,3174021001,2020-10-20,351,31,320,0,-2,2
DKI JAKARTA,JAKARTA SELATAN,SETIA BUDI,SETIA BUDI,3174021001,2020-10-21,351,29,322,0,-2,2
DKI JAKARTA,JAKARTA SELATAN,SETIA BUDI,SETIA BUDI,3174021001,2020-10-22,351,24,327,0,-5,5
DKI JAKARTA,JAKARTA SELATAN,SETIA BUDI,SETIA BUDI,3174021001,2020-10-23,353,25,328,2,1,1
DKI JAKARTA,JAKARTA SELATAN,SETIA BUDI,SETIA BUDI,3174021001,2020-10-24,354,22,332,1,-3,4
DKI JAKARTA,JAKARTA SELATAN,SETIA BUDI,SETIA BUDI,3174021001,2020-10-25,357,23,334,3,1,2
DKI JAKARTA,JAKARTA SELATAN,SETIA BUDI,SETIA BUDI,3174021001,2020-10-26,359,20,339,2,-3,5
DKI JAKARTA,JAKARTA SELATAN,SETIA BUDI,SETIA BUDI,3174021001,2020-10-27,361,20,341,2,0,2
DKI JAKARTA,JAKARTA SELATAN,SETIA BUDI,SETIA BUDI,3174021001,2020-10-28,363,12,351,2,-8,10
DKI JAKARTA,JAKARTA SELATAN,SETIA BUDI,SETIA BUDI,3174021001,2020-10-29,365,9,356,2,-3,5
DKI JAKARTA,JAKARTA SELATAN,SETIA BUDI,SETIA BUDI,3174021001,2020-10-30,368,11,357,3,2,1
DKI JAKARTA,JAKARTA SELATAN,SETIA BUDI,SETIA BUDI,3174021001,2020-10-31,370,9,361,2,-2,4
DKI JAKARTA,JAKARTA SELATAN,TEBET,BUKIT DURI,3174011005,2020-10-01,456,42,414,0,0,0
DKI JAKARTA,JAKARTA SELATAN,TEBET,BUKIT DURI,3174011005,2020-10-02,469,42,427,13,0,13
DKI JAKARTA,JAKARTA SELATAN,TEBET,BUKIT DURI,3174011005,2020-10-03,470,42,428,1,0,1
DKI JAKARTA,JAKARTA SELATAN,TEBET,BUKIT DURI,3174011005,2020-10-04,473,44,429,3,2,1
DKI JAKARTA,JAKARTA SELATAN,TEBET,BUKIT DURI,3174011005,2020-10-05,477,46,431,4,2,2
DKI JAKARTA,JAKARTA SELATAN,TEBET,BUKIT DURI,3174011005,2020-10-06,484,47,437,7,1,6
DKI JAKARTA,JAKARTA SELATAN,TEBET,BUKIT DURI,3174011005,2020-10-07,490,50,440,6,3,3
DKI JAKARTA,JAKARTA SELATAN,TEBET,BUKIT DURI,3174011005,2020-10-08,501,56,445,11,6,5
DKI JAKARTA,JAKARTA SELATAN,TEBET,BUKIT DURI,3174011005,2020-10-09,504,58,446,3,2,1
DKI JAKARTA,JAKARTA SELATAN,TEBET,BUKIT DURI,3174011005,2020-10-10,507,54,453,3,-4,7
DKI JAKARTA,JAKARTA SELATAN,TEBET,BUKIT DURI,3174011005,2020-10-11,516,61,455,9,7,2
DKI JAKARTA,JAKARTA SELATAN,TEBET,BUKIT DURI,3174011005,2020-10-12,516,46,470,0,-15,15
DKI JAKARTA,JAKARTA SELATAN,TEBET,BUKIT DURI,3174011005,2020-10-13,517,41,476,1,-5,6
DKI JAKARTA,JAKARTA SELATAN,TEBET,BUKIT DURI,3174011005,2020-10-14,519,35,484,2,-6,8
DKI JAKARTA,JAKARTA SELATAN,TEBET,BUKIT DURI,3174011005,2020-10-15,520,31,489,1,-4,5
DKI JAKARTA,JAKARTA SELATAN,TEBET,BUKIT DURI,3174011005,2020-10-16,524,27,497,4,-4,8
DKI JAKARTA,JAKARTA SELATAN,TEBET,BUKIT DURI,3174011005,2020-10-17,535,36,499,11,9,2
DKI JAKARTA,JAKARTA SELATAN,TEBET,BUKIT DURI,3174011005,2020-10-18,537,38,499,2,2,0
DKI JAKARTA,JAKARTA SELATAN,TEBET,BUKIT DURI,3174011005,2020-10-19,540,33,507,3,-5,8
DKI JAKARTA,JAKARTA SELATAN,TEBET,BUKIT DURI,3174011005,2020-10-20,543,30,513,3,-3,6
DKI JAKARTA,JAKARTA SELATAN,TEBET,BUKIT DURI,3174011005,2020-10-21,548,31,517,5,1,4
DKI JAKARTA,JAKARTA SELATAN,TEBET,BUKIT DURI,3174011005,2020-10-22,555,33,522,7,2,5
DKI JAKARTA,JAKARTA SELATAN,TEBET,BUKIT DURI,3174011005,2020-10-23,558,35,523,3,2,1
DKI JAKARTA,JAKARTA SELATAN,TEBET,BUKIT DURI,3174011005,2020-10-24,560,30,530,2,-5,7
DKI JAKARTA,JAKARTA SELATAN,TEBET,BUKIT DURI,3174011005,2020-10-25,567,33,534,7,3,4
DKI JAKARTA,JAKARTA SELATAN,TEBET,BUKIT DURI,3174011005,2020-10-26,572,32,540,5,-1,6
DKI JAKARTA,JAKARTA SELATAN,TEBET,BUKIT DURI,3174011005,2020-10-27,579,38,541,7,6,1
DKI JAKARTA,JAKARTA SELATAN,TEBET,BUKIT DURI,3174011005,2020-10-28,580,33,547,1,-5,6
DKI JAKARTA,JAKARTA SELATAN,TEBET,BUKIT DURI,3174011005,2020-10-29,581,25,556,1,-8,9
DKI JAKARTA,JAKARTA SELATAN,TEBET,BUKIT DURI,3174011005,2020-10-30,595,35,560,14,10,4
DKI JAKARTA,JAKARTA SELATAN,TEBET,BUKIT DURI,3174011005,2020-10-31,599,36,563,4,1,3
DKI JAKARTA,JAKARTA SELATAN,TEBET,KEBON BARU,3174011004,2020-10-01,546,64,482,0,0,0
DKI JAKARTA,JAKARTA SELATAN,TEBET,KEBON BARU,3174011004,2020-10-02,556,70,486,10,6,4
DKI JAKARTA,JAKARTA SELATAN,TEBET,KEBON BARU,3174011004,2020-10-03,562,68,494,6,-2,8
DKI JAKARTA,JAKARTA SELATAN,TEBET,KEBON BARU,3174011004,2020-10-04,567,72,495,5,4,1
DKI JAKARTA,JAKARTA SELATAN,TEBET,KEBON BARU,3174011004,2020-10-05,568,56,512,1,-16,17
DKI JAKARTA,JAKARTA SELATAN,TEBET,KEBON BARU,3174011004,2020-10-06,582,65,517,14,9,5
DKI JAKARTA,JAKARTA SELATAN,TEBET,KEBON BARU,3174011004,2020-10-07,588,59,529,6,-6,12
DKI JAKARTA,JAKARTA SELATAN,TEBET,KEBON BARU,3174011004,2020-10-08,614,77,537,26,18,8
DKI JAKARTA,JAKARTA SELATAN,TEBET,KEBON BARU,3174011004,2020-10-09,625,85,540,11,8,3
DKI JAKARTA,JAKARTA SELATAN,TEBET,KEBON BARU,3174011004,2020-10-10,631,83,548,6,-2,8
DKI JAKARTA,JAKARTA SELATAN,TEBET,KEBON BARU,3174011004,2020-10-11,642,92,550,11,9,2
DKI JAKARTA,JAKARTA SELATAN,TEBET,KEBON BARU,3174011004,2020-10-12,647,87,560,5,-5,10
DKI JAKARTA,JAKARTA SELATAN,TEBET,KEBON BARU,3174011004,2020-10-13,652,83,569,5,-4,9
DKI JAKARTA,JAKARTA SELATAN,TEBET,KEBON BARU,3174011004,2020-10-14,664,81,583,12,-2,14
DKI JAKARTA,JAKARTA SELATAN,TEBET,KEBON BARU,3174011004,2020-10-15,677,85,592,13,4,9
DKI JAKARTA,JAKARTA SELATAN,TEBET,KEBON BARU,3174011004,2020-10-16,681,78,603,4,-7,11
DKI JAKARTA,JAKARTA SELATAN,TEBET,KEBON BARU,3174011004,2020-10-17,688,82,606,7,4,3
DKI JAKARTA,JAKARTA SELATAN,TEBET,KEBON BARU,3174011004,2020-10-18,689,83,606,1,1,0
DKI JAKARTA,JAKARTA SELATAN,TEBET,KEBON BARU,3174011004,2020-10-19,691,72,619,2,-11,13
DKI JAKARTA,JAKARTA SELATAN,TEBET,KEBON BARU,3174011004,2020-10-20,694,52,642,3,-20,23
DKI JAKARTA,JAKARTA SELATAN,TEBET,KEBON BARU,3174011004,2020-10-21,698,50,648,4,-2,6
DKI JAKARTA,JAKARTA SELATAN,TEBET,KEBON BARU,3174011004,2020-10-22,703,42,661,5,-8,13
DKI JAKARTA,JAKARTA SELATAN,TEBET,KEBON BARU,3174011004,2020-10-23,707,46,661,4,4,0
DKI JAKARTA,JAKARTA SELATAN,TEBET,KEBON BARU,3174011004,2020-10-24,711,36,675,4,-10,14
DKI JAKARTA,JAKARTA SELATAN,TEBET,KEBON BARU,3174011004,2020-10-25,712,36,676,1,0,1
DKI JAKARTA,JAKARTA SELATAN,TEBET,KEBON BARU,3174011004,2020-10-26,715,31,684,3,-5,8
DKI JAKARTA,JAKARTA SELATAN,TEBET,KEBON BARU,3174011004,2020-10-27,717,24,693,2,-7,9
DKI JAKARTA,JAKARTA SELATAN,TEBET,KEBON BARU,3174011004,2020-10-28,717,22,695,0,-2,2
DKI JAKARTA,JAKARTA SELATAN,TEBET,KEBON BARU,3174011004,2020-10-29,721,16,705,4,-6,10
DKI JAKARTA,JAKARTA SELATAN,TEBET,KEBON BARU,3174011004,2020-10-30,733,26,707,12,10,2
DKI JAKARTA,JAKARTA SELATAN,TEBET,KEBON BARU,3174011004,2020-10-31,734,26,708,1,0,1
DKI JAKARTA,JAKARTA SELATAN,TEBET,MANGGARAI,3174011007,2020-10-01,448,45,403,0,0,0
DKI JAKARTA,JAKARTA SELATAN,TEBET,MANGGARAI,3174011007,2020-10-02,455,45,410,7,0,7
DKI JAKARTA,JAKARTA SELATAN,TEBET,MANGGARAI,3174011007,2020-10-03,460,45,415,5,0,5
DKI JAKARTA,JAKARTA SELATAN,TEBET,MANGGARAI,3174011007,2020-10-04,463,48,415,3,3,0
DKI JAKARTA,JAKARTA SELATAN,TEBET,MANGGARAI,3174011007,2020-10-05,466,41,425,3,-7,10
DKI JAKARTA,JAKARTA SELATAN,TEBET,MANGGARAI,3174011007,2020-10-06,471,36,435,5,-5,10
DKI JAKARTA,JAKARTA SELATAN,TEBET,MANGGARAI,3174011007,2020-10-07,473,35,438,2,-1,3
DKI JAKARTA,JAKARTA SELATAN,TEBET,MANGGARAI,3174011007,2020-10-08,483,39,444,10,4,6
DKI JAKARTA,JAKARTA SELATAN,TEBET,MANGGARAI,3174011007,2020-10-09,485,41,444,2,2,0
DKI JAKARTA,JAKARTA SELATAN,TEBET,MANGGARAI,3174011007,2020-10-10,489,40,449,4,-1,5
DKI JAKARTA,JAKARTA SELATAN,TEBET,MANGGARAI,3174011007,2020-10-11,493,43,450,4,3,1
DKI JAKARTA,JAKARTA SELATAN,TEBET,MANGGARAI,3174011007,2020-10-12,497,41,456,4,-2,6
DKI JAKARTA,JAKARTA SELATAN,TEBET,MANGGARAI,3174011007,2020-10-13,501,36,465,4,-5,9
DKI JAKARTA,JAKARTA SELATAN,TEBET,MANGGARAI,3174011007,2020-10-14,502,33,469,1,-3,4
DKI JAKARTA,JAKARTA SELATAN,TEBET,MANGGARAI,3174011007,2020-10-15,516,39,477,14,6,8
DKI JAKARTA,JAKARTA SELATAN,TEBET,MANGGARAI,3174011007,2020-10-16,516,38,478,0,-1,1
DKI JAKARTA,JAKARTA SELATAN,TEBET,MANGGARAI,3174011007,2020-10-17,531,50,481,15,12,3
DKI JAKARTA,JAKARTA SELATAN,TEBET,MANGGARAI,3174011007,2020-10-18,534,52,482,3,2,1
DKI JAKARTA,JAKARTA SELATAN,TEBET,MANGGARAI,3174011007,2020-10-19,537,52,485,3,0,3
DKI JAKARTA,JAKARTA SELATAN,TEBET,MANGGARAI,3174011007,2020-10-20,542,47,495,5,-5,10
DKI JAKARTA,JAKARTA SELATAN,TEBET,MANGGARAI,3174011007,2020-10-21,544,42,502,2,-5,7
DKI JAKARTA,JAKARTA SELATAN,TEBET,MANGGARAI,3174011007,2020-10-22,547,45,502,3,3,0
DKI JAKARTA,JAKARTA SELATAN,TEBET,MANGGARAI,3174011007,2020-10-23,550,47,503,3,2,1
DKI JAKARTA,JAKARTA SELATAN,TEBET,MANGGARAI,3174011007,2020-10-24,551,45,506,1,-2,3
DKI JAKARTA,JAKARTA SELATAN,TEBET,MANGGARAI,3174011007,2020-10-25,558,50,508,7,5,2
DKI JAKARTA,JAKARTA SELATAN,TEBET,MANGGARAI,3174011007,2020-10-26,564,52,512,6,2,4
DKI JAKARTA,JAKARTA SELATAN,TEBET,MANGGARAI,3174011007,2020-10-27,565,41,524,1,-11,12
DKI JAKARTA,JAKARTA SELATAN,TEBET,MANGGARAI,3174011007,2020-10-28,568,31,537,3,-10,13
DKI JAKARTA,JAKARTA SELATAN,TEBET,MANGGARAI,3174011007,2020-10-29,572,25,547,4,-6,10
DKI JAKARTA,JAKARTA SELATAN,TEBET,MANGGARAI,3174011007,2020-10-30,585,34,551,13,9,4
DKI JAKARTA,JAKARTA SELATAN,TEBET,MANGGARAI,3174011007,2020-10-31,587,34,553,2,0,2
DKI JAKARTA,JAKARTA SELATAN,TEBET,MANGGARAI SELATAN,3174011006,2020-10-01,409,24,385,0,0,0
DKI JAKARTA,JAKARTA SELATAN,TEBET,MANGGARAI SELATAN,3174011006,2020-10-02,413,25,388,4,1,3
DKI JAKARTA,JAKARTA SELATAN,TEBET,MANGGARAI SELATAN,3174011006,2020-10-03,416,26,390,3,1,2
DKI JAKARTA,JAKARTA SELATAN,TEBET,MANGGARAI SELATAN,3174011006,2020-10-04,418,25,393,2,-1,3
DKI JAKARTA,JAKARTA SELATAN,TEBET,MANGGARAI SELATAN,3174011006,2020-10-05,419,24,395,1,-1,2
DKI JAKARTA,JAKARTA SELATAN,TEBET,MANGGARAI SELATAN,3174011006,2020-10-06,425,26,399,6,2,4
DKI JAKARTA,JAKARTA SELATAN,TEBET,MANGGARAI SELATAN,3174011006,2020-10-07,429,27,402,4,1,3
DKI JAKARTA,JAKARTA SELATAN,TEBET,MANGGARAI SELATAN,3174011006,2020-10-08,440,37,403,11,10,1
DKI JAKARTA,JAKARTA SELATAN,TEBET,MANGGARAI SELATAN,3174011006,2020-10-09,444,40,404,4,3,1
DKI JAKARTA,JAKARTA SELATAN,TEBET,MANGGARAI SELATAN,3174011006,2020-10-10,444,34,410,0,-6,6
DKI JAKARTA,JAKARTA SELATAN,TEBET,MANGGARAI SELATAN,3174011006,2020-10-11,449,37,412,5,3,2
DKI JAKARTA,JAKARTA SELATAN,TEBET,MANGGARAI SELATAN,3174011006,2020-10-12,450,33,417,1,-4,5
DKI JAKARTA,JAKARTA SELATAN,TEBET,MANGGARAI SELATAN,3174011006,2020-10-13,451,34,417,1,1,0
DKI JAKARTA,JAKARTA SELATAN,TEBET,MANGGARAI SELATAN,3174011006,2020-10-14,454,30,424,3,-4,7
DKI JAKARTA,JAKARTA SELATAN,TEBET,MANGGARAI SELATAN,3174011006,2020-10-15,463,34,429,9,4,5
DKI JAKARTA,JAKARTA SELATAN,TEBET,MANGGARAI SELATAN,3174011006,2020-10-16,468,37,431,5,3,2
DKI JAKARTA,JAKARTA SELATAN,TEBET,MANGGARAI SELATAN,3174011006,2020-10-17,473,41,432,5,4,1
DKI JAKARTA,JAKARTA SELATAN,TEBET,MANGGARAI SELATAN,3174011006,2020-10-18,473,41,432,0,0,0
DKI JAKARTA,JAKARTA SELATAN,TEBET,MANGGARAI SELATAN,3174011006,2020-10-19,474,35,439,1,-6,7
DKI JAKARTA,JAKARTA SELATAN,TEBET,MANGGARAI SELATAN,3174011006,2020-10-20,475,28,447,1,-7,8
DKI JAKARTA,JAKARTA SELATAN,TEBET,MANGGARAI SELATAN,3174011006,2020-10-21,475,26,449,0,-2,2
DKI JAKARTA,JAKARTA SELATAN,TEBET,MANGGARAI SELATAN,3174011006,2020-10-22,478,28,450,3,2,1
DKI JAKARTA,JAKARTA SELATAN,TEBET,MANGGARAI SELATAN,3174011006,2020-10-23,482,31,451,4,3,1
DKI JAKARTA,JAKARTA SELATAN,TEBET,MANGGARAI SELATAN,3174011006,2020-10-24,484,28,456,2,-3,5
DKI JAKARTA,JAKARTA SELATAN,TEBET,MANGGARAI SELATAN,3174011006,2020-10-25,485,28,457,1,0,1
DKI JAKARTA,JAKARTA SELATAN,TEBET,MANGGARAI SELATAN,3174011006,2020-10-26,493,31,462,8,3,5
DKI JAKARTA,JAKARTA SELATAN,TEBET,MANGGARAI SELATAN,3174011006,2020-10-27,496,26,470,3,-5,8
DKI JAKARTA,JAKARTA SELATAN,TEBET,MANGGARAI SELATAN,3174011006,2020-10-28,496,23,473,0,-3,3
DKI JAKARTA,JAKARTA SELATAN,TEBET,MANGGARAI SELATAN,3174011006,2020-10-29,499,21,478,3,-2,5
DKI JAKARTA,JAKARTA SELATAN,TEBET,MANGGARAI SELATAN,3174011006,2020-10-30,505,26,479,6,5,1
DKI JAKARTA,JAKARTA SELATAN,TEBET,MANGGARAI SELATAN,3174011006,2020-10-31,507,28,479,2,2,0
DKI JAKARTA,JAKARTA SELATAN,TEBET,MENTENG DALAM,3174011003,2020-10-01,634,29,605,0,0,0
DKI JAKARTA,JAKARTA SELATAN,TEBET,MENTENG DALAM,3174011003,2020-10-02,646,38,608,12,9,3
DKI JAKARTA,JAKARTA SELATAN,TEBET,MENTENG DALAM,3174011003,2020-10-03,662,43,619,16,5,11
DKI JAKARTA,JAKARTA SELATAN,TEBET,MENTENG DALAM,3174011003,2020-10-04,666,44,622,4,1,3
DKI JAKARTA,JAKARTA SELATAN,TEBET,MENTENG DALAM,3174011003,2020-10-05,666,39,627,0,-5,5
DKI JAKARTA,JAKARTA SELATAN,TEBET,MENTENG DALAM,3174011003,2020-10-06,670,38,632,4,-1,5
DKI JAKARTA,JAKARTA SELATAN,TEBET,MENTENG DALAM,3174011003,2020-10-07,675,39,636,5,1,4
DKI JAKARTA,JAKARTA SELATAN,TEBET,MENTENG DALAM,3174011003,2020-10-08,677,37,640,2,-2,4
DKI JAKARTA,JAKARTA SELATAN,TEBET,MENTENG DALAM,3174011003,2020-10-09,680,40,640,3,3,0
DKI JAKARTA,JAKARTA SELATAN,TEBET,MENTENG DALAM,3174011003,2020-10-10,680,30,650,0,-10,10
DKI JAKARTA,JAKARTA SELATAN,TEBET,MENTENG DALAM,3174011003,2020-10-11,683,33,650,3,3,0
DKI JAKARTA,JAKARTA SELATAN,TEBET,MENTENG DALAM,3174011003,2020-10-12,686,28,658,3,-5,8
DKI JAKARTA,JAKARTA SELATAN,TEBET,MENTENG DALAM,3174011003,2020-10-13,688,25,663,2,-3,5
DKI JAKARTA,JAKARTA SELATAN,TEBET,MENTENG DALAM,3174011003,2020-10-14,692,25,667,4,0,4
DKI JAKARTA,JAKARTA SELATAN,TEBET,MENTENG DALAM,3174011003,2020-10-15,704,31,673,12,6,6
DKI JAKARTA,JAKARTA SELATAN,TEBET,MENTENG DALAM,3174011003,2020-10-16,706,26,680,2,-5,7
DKI JAKARTA,JAKARTA SELATAN,TEBET,MENTENG DALAM,3174011003,2020-10-17,715,34,681,9,8,1
DKI JAKARTA,JAKARTA SELATAN,TEBET,MENTENG DALAM,3174011003,2020-10-18,720,39,681,5,5,0
DKI JAKARTA,JAKARTA SELATAN,TEBET,MENTENG DALAM,3174011003,2020-10-19,723,40,683,3,1,2
DKI JAKARTA,JAKARTA SELATAN,TEBET,MENTENG DALAM,3174011003,2020-10-20,727,40,687,4,0,4
DKI JAKARTA,JAKARTA SELATAN,TEBET,MENTENG DALAM,3174011003,2020-10-21,729,40,689,2,0,2
DKI JAKARTA,JAKARTA SELATAN,TEBET,MENTENG DALAM,3174011003,2020-10-22,730,37,693,1,-3,4
DKI JAKARTA,JAKARTA SELATAN,TEBET,MENTENG DALAM,3174011003,2020-10-23,741,45,696,11,8,3
DKI JAKARTA,JAKARTA SELATAN,TEBET,MENTENG DALAM,3174011003,2020-10-24,744,38,706,3,-7,10
DKI JAKARTA,JAKARTA SELATAN,TEBET,MENTENG DALAM,3174011003,2020-10-25,746,37,709,2,-1,3
DKI JAKARTA,JAKARTA SELATAN,TEBET,MENTENG DALAM,3174011003,2020-10-26,750,34,716,4,-3,7
DKI JAKARTA,JAKARTA SELATAN,TEBET,MENTENG DALAM,3174011003,2020-10-27,754,29,725,4,-5,9
DKI JAKARTA,JAKARTA SELATAN,TEBET,MENTENG DALAM,3174011003,2020-10-28,757,29,728,3,0,3
DKI JAKARTA,JAKARTA SELATAN,TEBET,MENTENG DALAM,3174011003,2020-10-29,760,19,741,3,-10,13
DKI JAKARTA,JAKARTA SELATAN,TEBET,MENTENG DALAM,3174011003,2020-10-30,771,28,743,11,9,2
DKI JAKARTA,JAKARTA SELATAN,TEBET,MENTENG DALAM,3174011003,2020-10-31,772,25,747,1,-3,4
DKI JAKARTA,JAKARTA SELATAN,TEBET,TEBET BARAT,3174011002,2020-10-01,536,31,505,0,0,0
DKI JAKARTA,JAKARTA SELATAN,TEBET,TEBET BARAT,3174011002,2020-10-02,552,46,506,16,15,1
DKI JAKARTA,JAKARTA SELATAN,TEBET,TEBET BARAT,3174011002,2020-10-03,558,47,511,6,1,5
DKI JAKARTA,JAKARTA SELATAN,TEBET,TEBET BARAT,3174011002,2020-10-04,562,50,512,4,3,1
DKI JAKARTA,JAKARTA SELATAN,TEBET,TEBET BARAT,3174011002,2020-10-05,563,50,513,1,0,1
DKI JAKARTA,JAKARTA SELATAN,TEBET,TEBET BARAT,3174011002,2020-10-06,575,58,517,12,8,4
DKI JAKARTA,JAKARTA SELATAN,TEBET,TEBET BARAT,3174011002,2020-10-07,577,56,521,2,-2,4
DKI JAKARTA,JAKARTA SELATAN,TEBET,TEBET BARAT,3174011002,2020-10-08,581,52,529,4,-4,8
DKI JAKARTA,JAKARTA SELATAN,TEBET,TEBET BARAT,3174011002,2020-10-09,584,54,530,3,2,1
DKI JAKARTA,JAKARTA SELATAN,TEBET,TEBET BARAT,3174011002,2020-10-10,591,57,534,7,3,4
DKI JAKARTA,JAKARTA SELATAN,TEBET,TEBET BARAT,3174011002,2020-10-11,593,53,540,2,-4,6
DKI JAKARTA,JAKARTA SELATAN,TEBET,TEBET BARAT,3174011002,2020-10-12,601,46,555,8,-7,15
DKI JAKARTA,JAKARTA SELATAN,TEBET,TEBET BARAT,3174011002,2020-10-13,604,45,559,3,-1,4
DKI JAKARTA,JAKARTA SELATAN,TEBET,TEBET BARAT,3174011002,2020-10-14,606,39,567,2,-6,8
DKI JAKARTA,JAKARTA SELATAN,TEBET,TEBET BARAT,3174011002,2020-10-15,609,33,576,3,-6,9
DKI JAKARTA,JAKARTA SELATAN,TEBET,TEBET BARAT,3174011002,2020-10-16,617,30,587,8,-3,11
DKI JAKARTA,JAKARTA SELATAN,TEBET,TEBET BARAT,3174011002,2020-10-17,625,37,588,8,7,1
DKI JAKARTA,JAKARTA SELATAN,TEBET,TEBET BARAT,3174011002,2020-10-18,633,43,590,8,6,2
DKI JAKARTA,JAKARTA SELATAN,TEBET,TEBET BARAT,3174011002,2020-10-19,635,41,594,2,-2,4
DKI JAKARTA,JAKARTA SELATAN,TEBET,TEBET BARAT,3174011002,2020-10-20,640,44,596,5,3,2
DKI JAKARTA,JAKARTA SELATAN,TEBET,TEBET BARAT,3174011002,2020-10-21,643,41,602,3,-3,6
DKI JAKARTA,JAKARTA SELATAN,TEBET,TEBET BARAT,3174011002,2020-10-22,644,37,607,1,-4,5
DKI JAKARTA,JAKARTA SELATAN,TEBET,TEBET BARAT,3174011002,2020-10-23,649,41,608,5,4,1
DKI JAKARTA,JAKARTA SELATAN,TEBET,TEBET BARAT,3174011002,2020-10-24,653,35,618,4,-6,10
DKI JAKARTA,JAKARTA SELATAN,TEBET,TEBET BARAT,3174011002,2020-10-25,655,27,628,2,-8,10
DKI JAKARTA,JAKARTA SELATAN,TEBET,TEBET BARAT,3174011002,2020-10-26,663,27,636,8,0,8
DKI JAKARTA,JAKARTA SELATAN,TEBET,TEBET BARAT,3174011002,2020-10-27,670,29,641,7,2,5
DKI JAKARTA,JAKARTA SELATAN,TEBET,TEBET BARAT,3174011002,2020-10-28,672,31,641,2,2,0
DKI JAKARTA,JAKARTA SELATAN,TEBET,TEBET BARAT,3174011002,2020-10-29,673,24,649,1,-7,8
DKI JAKARTA,JAKARTA SELATAN,TEBET,TEBET BARAT,3174011002,2020-10-30,684,27,657,11,3,8
DKI JAKARTA,JAKARTA SELATAN,TEBET,TEBET BARAT,3174011002,2020-10-31,689,29,660,5,2,3
DKI JAKARTA,JAKARTA SELATAN,TEBET,TEBET TIMUR,3174011001,2020-10-01,453,48,405,0,0,0
DKI JAKARTA,JAKARTA SELATAN,TEBET,TEBET TIMUR,3174011001,2020-10-02,455,35,420,2,-13,15
DKI JAKARTA,JAKARTA SELATAN,TEBET,TEBET TIMUR,3174011001,2020-10-03,465,41,424,10,6,4
DKI JAKARTA,JAKARTA SELATAN,TEBET,TEBET TIMUR,3174011001,2020-10-04,468,44,424,3,3,0
DKI JAKARTA,JAKARTA SELATAN,TEBET,TEBET TIMUR,3174011001,2020-10-05,471,43,428,3,-1,4
DKI JAKARTA,JAKARTA SELATAN,TEBET,TEBET TIMUR,3174011001,2020-10-06,483,52,431,12,9,3
DKI JAKARTA,JAKARTA SELATAN,TEBET,TEBET TIMUR,3174011001,2020-10-07,496,55,441,13,3,10
DKI JAKARTA,JAKARTA SELATAN,TEBET,TEBET TIMUR,3174011001,2020-10-08,498,56,442,2,1,1
DKI JAKARTA,JAKARTA SELATAN,TEBET,TEBET TIMUR,3174011001,2020-10-09,506,62,444,8,6,2
DKI JAKARTA,JAKARTA SELATAN,TEBET,TEBET TIMUR,3174011001,2020-10-10,511,64,447,5,2,3
DKI JAKARTA,JAKARTA SELATAN,TEBET,TEBET TIMUR,3174011001,2020-10-11,513,64,449,2,0,2
DKI JAKARTA,JAKARTA SELATAN,TEBET,TEBET TIMUR,3174011001,2020-10-12,514,53,461,1,-11,12
DKI JAKARTA,JAKARTA SELATAN,TEBET,TEBET TIMUR,3174011001,2020-10-13,518,51,467,4,-2,6
DKI JAKARTA,JAKARTA SELATAN,TEBET,TEBET TIMUR,3174011001,2020-10-14,519,39,480,1,-12,13
DKI JAKARTA,JAKARTA SELATAN,TEBET,TEBET TIMUR,3174011001,2020-10-15,520,27,493,1,-12,13
DKI JAKARTA,JAKARTA SELATAN,TEBET,TEBET TIMUR,3174011001,2020-10-16,523,21,502,3,-6,9
DKI JAKARTA,JAKARTA SELATAN,TEBET,TEBET TIMUR,3174011001,2020-10-17,525,21,504,2,0,2
DKI JAKARTA,JAKARTA SELATAN,TEBET,TEBET TIMUR,3174011001,2020-10-18,527,22,505,2,1,1
DKI JAKARTA,JAKARTA SELATAN,TEBET,TEBET TIMUR,3174011001,2020-10-19,531,22,509,4,0,4
DKI JAKARTA,JAKARTA SELATAN,TEBET,TEBET TIMUR,3174011001,2020-10-20,532,21,511,1,-1,2
DKI JAKARTA,JAKARTA SELATAN,TEBET,TEBET TIMUR,3174011001,2020-10-21,532,17,515,0,-4,4
DKI JAKARTA,JAKARTA SELATAN,TEBET,TEBET TIMUR,3174011001,2020-10-22,532,16,516,0,-1,1
DKI JAKARTA,JAKARTA SELATAN,TEBET,TEBET TIMUR,3174011001,2020-10-23,545,29,516,13,13,0
DKI JAKARTA,JAKARTA SELATAN,TEBET,TEBET TIMUR,3174011001,2020-10-24,545,22,523,0,-7,7
DKI JAKARTA,JAKARTA SELATAN,TEBET,TEBET TIMUR,3174011001,2020-10-25,552,24,528,7,2,5
DKI JAKARTA,JAKARTA SELATAN,TEBET,TEBET TIMUR,3174011001,2020-10-26,562,31,531,10,7,3
DKI JAKARTA,JAKARTA SELATAN,TEBET,TEBET TIMUR,3174011001,2020-10-27,567,34,533,5,3,2
DKI JAKARTA,JAKARTA SELATAN,TEBET,TEBET TIMUR,3174011001,2020-10-28,569,33,536,2,-1,3
DKI JAKARTA,JAKARTA SELATAN,TEBET,TEBET TIMUR,3174011001,2020-10-29,569,31,538,0,-2,2
DKI JAKARTA,JAKARTA SELATAN,TEBET,TEBET TIMUR,3174011001,2020-10-30,582,40,542,13,9,4
DKI JAKARTA,JAKARTA SELATAN,TEBET,TEBET TIMUR,3174011001,2020-10-31,584,40,544,2,0,2
DKI JAKARTA,JAKARTA TIMUR,CAKUNG,CAKUNG BARAT,3175061007,2020-10-01,572,68,504,0,0,0
DKI JAKARTA,JAKARTA TIMUR,CAKUNG,CAKUNG BARAT,3175061007,2020-10-02,579,70,509,7,2,5
DKI JAKARTA,JAKARTA TIMUR,CAKUNG,CAKUNG BARAT,3175061007,2020-10-03,594,84,510,15,14,1
DKI JAKARTA,JAKARTA TIMUR,CAKUNG,CAKUNG BARAT,3175061007,2020-10-04,603,93,510,9,9,0
DKI JAKARTA,JAKARTA TIMUR,CAKUNG,CAKUNG BARAT,3175061007,2020-10-05,610,78,532,7,-15,22
DKI JAKARTA,JAKARTA TIMUR,CAKUNG,CAKUNG BARAT,3175061007,2020-10-06,612,75,537,2,-3,5
DKI JAKARTA,JAKARTA TIMUR,CAKUNG,CAKUNG BARAT,3175061007,2020-10-07,616,74,542,4,-1,5
DKI JAKARTA,JAKARTA TIMUR,CAKUNG,CAKUNG BARAT,3175061007,2020-10-08,622,75,547,6,1,5
DKI JAKARTA,JAKARTA TIMUR,CAKUNG,CAKUNG BARAT,3175061007,2020-10-09,622,75,547,0,0,0
DKI JAKARTA,JAKARTA TIMUR,CAKUNG,CAKUNG BARAT,3175061007,2020-10-10,623,61,562,1,-14,15
DKI JAKARTA,JAKARTA TIMUR,CAKUNG,CAKUNG BARAT,3175061007,2020-10-11,624,61,563,1,0,1
DKI JAKARTA,JAKARTA TIMUR,CAKUNG,CAKUNG BARAT,3175061007,2020-10-12,625,52,573,1,-9,10
DKI JAKARTA,JAKARTA TIMUR,CAKUNG,CAKUNG BARAT,3175061007,2020-10-13,641,42,599,16,-10,26
DKI JAKARTA,JAKARTA TIMUR,CAKUNG,CAKUNG BARAT,3175061007,2020-10-14,641,25,616,0,-17,17
DKI JAKARTA,JAKARTA TIMUR,CAKUNG,CAKUNG BARAT,3175061007,2020-10-15,645,25,620,4,0,4
DKI JAKARTA,JAKARTA TIMUR,CAKUNG,CAKUNG BARAT,3175061007,2020-10-16,652,28,624,7,3,4
DKI JAKARTA,JAKARTA TIMUR,CAKUNG,CAKUNG BARAT,3175061007,2020-10-17,661,35,626,9,7,2
DKI JAKARTA,JAKARTA TIMUR,CAKUNG,CAKUNG BARAT,3175061007,2020-10-18,663,37,626,2,2,0
DKI JAKARTA,JAKARTA TIMUR,CAKUNG,CAKUNG BARAT,3175061007,2020-10-19,669,36,633,6,-1,7
DKI JAKARTA,JAKARTA TIMUR,CAKUNG,CAKUNG BARAT,3175061007,2020-10-20,673,36,637,4,0,4
DKI JAKARTA,JAKARTA TIMUR,CAKUNG,CAKUNG BARAT,3175061007,2020-10-21,680,41,639,7,5,2
DKI JAKARTA,JAKARTA TIMUR,CAKUNG,CAKUNG BARAT,3175061007,2020-10-22,681,41,640,1,0,1
DKI JAKARTA,JAKARTA TIMUR,CAKUNG,CAKUNG BARAT,3175061007,2020-10-23,684,44,640,3,3,0
DKI JAKARTA,JAKARTA TIMUR,CAKUNG,CAKUNG BARAT,3175061007,2020-10-24,687,43,644,3,-1,4
DKI JAKARTA,JAKARTA TIMUR,CAKUNG,CAKUNG BARAT,3175061007,2020-10-25,692,46,646,5,3,2
DKI JAKARTA,JAKARTA TIMUR,CAKUNG,CAKUNG BARAT,3175061007,2020-10-26,694,47,647,2,1,1
DKI JAKARTA,JAKARTA TIMUR,CAKUNG,CAKUNG BARAT,3175061007,2020-10-27,705,51,654,11,4,7
DKI JAKARTA,JAKARTA TIMUR,CAKUNG,CAKUNG BARAT,3175061007,2020-10-28,715,56,659,10,5,5
DKI JAKARTA,JAKARTA TIMUR,CAKUNG,CAKUNG BARAT,3175061007,2020-10-29,717,52,665,2,-4,6
DKI JAKARTA,JAKARTA TIMUR,CAKUNG,CAKUNG BARAT,3175061007,2020-10-30,721,47,674,4,-5,9
DKI JAKARTA,JAKARTA TIMUR,CAKUNG,CAKUNG BARAT,3175061007,2020-10-31,733,56,677,12,9,3
DKI JAKARTA,JAKARTA TIMUR,CAKUNG,CAKUNG TIMUR,3175061004,2020-10-01,625,79,546,0,0,0
DKI JAKARTA,JAKARTA TIMUR,CAKUNG,CAKUNG TIMUR,3175061004,2020-10-02,640,85,555,15,6,9
DKI JAKARTA,JAKARTA TIMUR,CAKUNG,CAKUNG TIMUR,3175061004,2020-10-03,647,89,558,7,4,3
DKI JAKARTA,JAKARTA TIMUR,CAKUNG,CAKUNG TIMUR,3175061004,2020-10-04,652,93,559,5,4,1
DKI JAKARTA,JAKARTA TIMUR,CAKUNG,CAKUNG TIMUR,3175061004,2020-10-05,655,81,574,3,-12,15
DKI JAKARTA,JAKARTA TIMUR,CAKUNG,CAKUNG TIMUR,3175061004,2020-10-06,669,86,583,14,5,9
DKI JAKARTA,JAKARTA TIMUR,CAKUNG,CAKUNG TIMUR,3175061004,2020-10-07,683,97,586,14,11,3
DKI JAKARTA,JAKARTA TIMUR,CAKUNG,CAKUNG TIMUR,3175061004,2020-10-08,701,109,592,18,12,6
DKI JAKARTA,JAKARTA TIMUR,CAKUNG,CAKUNG TIMUR,3175061004,2020-10-09,710,118,592,9,9,0
DKI JAKARTA,JAKARTA TIMUR,CAKUNG,CAKUNG TIMUR,3175061004,2020-10-10,715,111,604,5,-7,12
DKI JAKARTA,JAKARTA TIMUR,CAKUNG,CAKUNG TIMUR,3175061004,2020-10-11,721,115,606,6,4,2
DKI JAKARTA,JAKARTA TIMUR,CAKUNG,CAKUNG TIMUR,3175061004,2020-10-12,724,92,632,3,-23,26
DKI JAKARTA,JAKARTA TIMUR,CAKUNG,CAKUNG TIMUR,3175061004,2020-10-13,731,84,647,7,-8,15
DKI JAKARTA,JAKARTA TIMUR,CAKUNG,CAKUNG TIMUR,3175061004,2020-10-14,744,89,655,13,5,8
DKI JAKARTA,JAKARTA TIMUR,CAKUNG,CAKUNG TIMUR,3175061004,2020-10-15,758,95,663,14,6,8
DKI JAKARTA,JAKARTA TIMUR,CAKUNG,CAKUNG TIMUR,3175061004,2020-10-16,762,74,688,4,-21,25
DKI JAKARTA,JAKARTA TIMUR,CAKUNG,CAKUNG TIMUR,3175061004,2020-10-17,769,78,691,7,4,3
DKI JAKARTA,JAKARTA TIMUR,CAKUNG,CAKUNG TIMUR,3175061004,2020-10-18,775,84,691,6,6,0
DKI JAKARTA,JAKARTA TIMUR,CAKUNG,CAKUNG TIMUR,3175061004,2020-10-19,781,84,697,6,0,6
DKI JAKARTA,JAKARTA TIMUR,CAKUNG,CAKUNG TIMUR,3175061004,2020-10-20,786,73,713,5,-11,16
DKI JAKARTA,JAKARTA TIMUR,CAKUNG,CAKUNG TIMUR,3175061004,2020-10-21,793,66,727,7,-7,14
DKI JAKARTA,JAKARTA TIMUR,CAKUNG,CAKUNG TIMUR,3175061004,2020-10-22,796,64,732,3,-2,5
DKI JAKARTA,JAKARTA TIMUR,CAKUNG,CAKUNG TIMUR,3175061004,2020-10-23,800,67,733,4,3,1
DKI JAKARTA,JAKARTA TIMUR,CAKUNG,CAKUNG TIMUR,3175061004,2020-10-24,803,63,740,3,-4,7
DKI JAKARTA,JAKARTA TIMUR,CAKUNG,CAKUNG TIMUR,3175061004,2020-10-25,804,64,740,1,1,0
DKI JAKARTA,JAKARTA TIMUR,CAKUNG,CAKUNG TIMUR,3175061004,2020-10-26,805,43,762,1,-21,22
DKI JAKARTA,JAKARTA TIMUR,CAKUNG,CAKUNG TIMUR,3175061004,2020-10-27,822,55,767,17,12,5
DKI JAKARTA,JAKARTA TIMUR,CAKUNG,CAKUNG TIMUR,3175061004,2020-10-28,828,56,772,6,1,5
DKI JAKARTA,JAKARTA TIMUR,CAKUNG,CAKUNG TIMUR,3175061004,2020-10-29,840,61,779,12,5,7
DKI JAKARTA,JAKARTA TIMUR,CAKUNG,CAKUNG TIMUR,3175061004,2020-10-30,845,57,788,5,-4,9
DKI JAKARTA,JAKARTA TIMUR,CAKUNG,CAKUNG TIMUR,3175061004,2020-10-31,849,61,788,4,4,0
DKI JAKARTA,JAKARTA TIMUR,CAKUNG,JATINEGARA,3175061001,2020-10-01,1070,154,916,0,0,0
DKI JAKARTA,JAKARTA TIMUR,CAKUNG,JATINEGARA,3175061001,2020-10-02,1084,156,928,14,2,12
DKI JAKARTA,JAKARTA TIMUR,CAKUNG,JATINEGARA,3175061001,2020-10-03,1088,159,929,4,3,1
DKI JAKARTA,JAKARTA TIMUR,CAKUNG,JATINEGARA,3175061001,2020-10-04,1099,165,934,11,6,5
DKI JAKARTA,JAKARTA TIMUR,CAKUNG,JATINEGARA,3175061001,2020-10-05,1110,152,958,11,-13,24
DKI JAKARTA,JAKARTA TIMUR,CAKUNG,JATINEGARA,3175061001,2020-10-06,1143,167,976,33,15,18
DKI JAKARTA,JAKARTA TIMUR,CAKUNG,JATINEGARA,3175061001,2020-10-07,1194,196,998,51,29,22
DKI JAKARTA,JAKARTA TIMUR,CAKUNG,JATINEGARA,3175061001,2020-10-08,1243,227,1016,49,31,18
DKI JAKARTA,JAKARTA TIMUR,CAKUNG,JATINEGARA,3175061001,2020-10-09,1248,232,1016,5,5,0
DKI JAKARTA,JAKARTA TIMUR,CAKUNG,JATINEGARA,3175061001,2020-10-10,1259,223,1036,11,-9,20
DKI JAKARTA,JAKARTA TIMUR,CAKUNG,JATINEGARA,3175061001,2020-10-11,1291,253,1038,32,30,2
DKI JAKARTA,JAKARTA TIMUR,CAKUNG,JATINEGARA,3175061001,2020-10-12,1298,238,1060,7,-15,22
DKI JAKARTA,JAKARTA TIMUR,CAKUNG,JATINEGARA,3175061001,2020-10-13,1311,208,1103,13,-30,43
DKI JAKARTA,JAKARTA TIMUR,CAKUNG,JATINEGARA,3175061001,2020-10-14,1341,225,1116,30,17,13
DKI JAKARTA,JAKARTA TIMUR,CAKUNG,JATINEGARA,3175061001,2020-10-15,1373,234,1139,32,9,23
DKI JAKARTA,JAKARTA TIMUR,CAKUNG,JATINEGARA,3175061001,2020-10-16,1402,243,1159,29,9,20
DKI JAKARTA,JAKARTA TIMUR,CAKUNG,JATINEGARA,3175061001,2020-10-17,1420,260,1160,18,17,1
DKI JAKARTA,JAKARTA TIMUR,CAKUNG,JATINEGARA,3175061001,2020-10-18,1429,269,1160,9,9,0
DKI JAKARTA,JAKARTA TIMUR,CAKUNG,JATINEGARA,3175061001,2020-10-19,1436,221,1215,7,-48,55
DKI JAKARTA,JAKARTA TIMUR,CAKUNG,JATINEGARA,3175061001,2020-10-20,1447,213,1234,11,-8,19
DKI JAKARTA,JAKARTA TIMUR,CAKUNG,JATINEGARA,3175061001,2020-10-21,1470,197,1273,23,-16,39
DKI JAKARTA,JAKARTA TIMUR,CAKUNG,JATINEGARA,3175061001,2020-10-22,1495,204,1291,25,7,18
DKI JAKARTA,JAKARTA TIMUR,CAKUNG,JATINEGARA,3175061001,2020-10-23,1507,215,1292,12,11,1
DKI JAKARTA,JAKARTA TIMUR,CAKUNG,JATINEGARA,3175061001,2020-10-24,1517,186,1331,10,-29,39
DKI JAKARTA,JAKARTA TIMUR,CAKUNG,JATINEGARA,3175061001,2020-10-25,1521,189,1332,4,3,1
DKI JAKARTA,JAKARTA TIMUR,CAKUNG,JATINEGARA,3175061001,2020-10-26,1523,149,1374,2,-40,42
DKI JAKARTA,JAKARTA TIMUR,CAKUNG,JATINEGARA,3175061001,2020-10-27,1536,131,1405,13,-18,31
DKI JAKARTA,JAKARTA TIMUR,CAKUNG,JATINEGARA,3175061001,2020-10-28,1546,115,1431,10,-16,26
DKI JAKARTA,JAKARTA TIMUR,CAKUNG,JATINEGARA,3175061001,2020-10-29,1559,106,1453,13,-9,22
DKI JAKARTA,JAKARTA TIMUR,CAKUNG,JATINEGARA,3175061001,2020-10-30,1567,107,1460,8,1,7
DKI JAKARTA,JAKARTA TIMUR,CAKUNG,JATINEGARA,3175061001,2020-10-31,1577,116,1461,10,9,1
DKI JAKARTA,JAKARTA TIMUR,CAKUNG,PENGGILINGAN,3175061003,2020-10-01,1336,193,1143,0,0,0
DKI JAKARTA,JAKARTA TIMUR,CAKUNG,PENGGILINGAN,3175061003,2020-10-02,1353,169,1184,17,-24,41
DKI JAKARTA,JAKARTA TIMUR,CAKUNG,PENGGILINGAN,3175061003,2020-10-03,1370,183,1187,17,14,3
DKI JAKARTA,JAKARTA TIMUR,CAKUNG,PENGGILINGAN,3175061003,2020-10-04,1382,189,1193,12,6,6
DKI JAKARTA,JAKARTA TIMUR,CAKUNG,PENGGILINGAN,3175061003,2020-10-05,1393,168,1225,11,-21,32
DKI JAKARTA,JAKARTA TIMUR,CAKUNG,PENGGILINGAN,3175061003,2020-10-06,1411,167,1244,18,-1,19
DKI JAKARTA,JAKARTA TIMUR,CAKUNG,PENGGILINGAN,3175061003,2020-10-07,1446,179,1267,35,12,23
DKI JAKARTA,JAKARTA TIMUR,CAKUNG,PENGGILINGAN,3175061003,2020-10-08,1497,198,1299,51,19,32
DKI JAKARTA,JAKARTA TIMUR,CAKUNG,PENGGILINGAN,3175061003,2020-10-09,1505,205,1300,8,7,1
DKI JAKARTA,JAKARTA TIMUR,CAKUNG,PENGGILINGAN,3175061003,2020-10-10,1516,189,1327,11,-16,27
DKI JAKARTA,JAKARTA TIMUR,CAKUNG,PENGGILINGAN,3175061003,2020-10-11,1540,208,1332,24,19,5
DKI JAKARTA,JAKARTA TIMUR,CAKUNG,PENGGILINGAN,3175061003,2020-10-12,1554,198,1356,14,-10,24
DKI JAKARTA,JAKARTA TIMUR,CAKUNG,PENGGILINGAN,3175061003,2020-10-13,1562,176,1386,8,-22,30
DKI JAKARTA,JAKARTA TIMUR,CAKUNG,PENGGILINGAN,3175061003,2020-10-14,1607,206,1401,45,30,15
DKI JAKARTA,JAKARTA TIMUR,CAKUNG,PENGGILINGAN,3175061003,2020-10-15,1649,227,1422,42,21,21
DKI JAKARTA,JAKARTA TIMUR,CAKUNG,PENGGILINGAN,3175061003,2020-10-16,1664,230,1434,15,3,12
DKI JAKARTA,JAKARTA TIMUR,CAKUNG,PENGGILINGAN,3175061003,2020-10-17,1750,313,1437,86,83,3
DKI JAKARTA,JAKARTA TIMUR,CAKUNG,PENGGILINGAN,3175061003,2020-10-18,1755,317,1438,5,4,1
DKI JAKARTA,JAKARTA TIMUR,CAKUNG,PENGGILINGAN,3175061003,2020-10-19,1780,305,1475,25,-12,37
DKI JAKARTA,JAKARTA TIMUR,CAKUNG,PENGGILINGAN,3175061003,2020-10-20,1790,287,1503,10,-18,28
DKI JAKARTA,JAKARTA TIMUR,CAKUNG,PENGGILINGAN,3175061003,2020-10-21,1833,297,1536,43,10,33
DKI JAKARTA,JAKARTA TIMUR,CAKUNG,PENGGILINGAN,3175061003,2020-10-22,1855,295,1560,22,-2,24
DKI JAKARTA,JAKARTA TIMUR,CAKUNG,PENGGILINGAN,3175061003,2020-10-23,1868,307,1561,13,12,1
DKI JAKARTA,JAKARTA TIMUR,CAKUNG,PENGGILINGAN,3175061003,2020-10-24,1873,292,1581,5,-15,20
DKI JAKARTA,JAKARTA TIMUR,CAKUNG,PENGGILINGAN,3175061003,2020-10-25,1893,309,1584,20,17,3
DKI JAKARTA,JAKARTA TIMUR,CAKUNG,PENGGILINGAN,3175061003,2020-10-26,1901,251,1650,8,-58,66
DKI JAKARTA,JAKARTA TIMUR,CAKUNG,PENGGILINGAN,3175061003,2020-10-27,1909,239,1670,8,-12,20
DKI JAKARTA,JAKARTA TIMUR,CAKUNG,PENGGILINGAN,3175061003,2020-10-28,1918,233,1685,9,-6,15
DKI JAKARTA,JAKARTA TIMUR,CAKUNG,PENGGILINGAN,3175061003,2020-10-29,1942,149,1793,24,-84,108
DKI JAKARTA,JAKARTA TIMUR,CAKUNG,PENGGILINGAN,3175061003,2020-10-30,1957,152,1805,15,3,12
DKI JAKARTA,JAKARTA TIMUR,CAKUNG,PENGGILINGAN,3175061003,2020-10-31,1960,151,1809,3,-1,4
DKI JAKARTA,JAKARTA TIMUR,CAKUNG,PULO GEBANG,3175061005,2020-10-01,1131,119,1012,0,0,0
DKI JAKARTA,JAKARTA TIMUR,CAKUNG,PULO GEBANG,3175061005,2020-10-02,1142,114,1028,11,-5,16
DKI JAKARTA,JAKARTA TIMUR,CAKUNG,PULO GEBANG,3175061005,2020-10-03,1157,121,1036,15,7,8
DKI JAKARTA,JAKARTA TIMUR,CAKUNG,PULO GEBANG,3175061005,2020-10-04,1168,125,1043,11,4,7
DKI JAKARTA,JAKARTA TIMUR,CAKUNG,PULO GEBANG,3175061005,2020-10-05,1173,111,1062,5,-14,19
DKI JAKARTA,JAKARTA TIMUR,CAKUNG,PULO GEBANG,3175061005,2020-10-06,1195,117,1078,22,6,16
DKI JAKARTA,JAKARTA TIMUR,CAKUNG,PULO GEBANG,3175061005,2020-10-07,1215,119,1096,20,2,18
DKI JAKARTA,JAKARTA TIMUR,CAKUNG,PULO GEBANG,3175061005,2020-10-08,1240,133,1107,25,14,11
DKI JAKARTA,JAKARTA TIMUR,CAKUNG,PULO GEBANG,3175061005,2020-10-09,1249,142,1107,9,9,0
DKI JAKARTA,JAKARTA TIMUR,CAKUNG,PULO GEBANG,3175061005,2020-10-10,1255,123,1132,6,-19,25
DKI JAKARTA,JAKARTA TIMUR,CAKUNG,PULO GEBANG,3175061005,2020-10-11,1272,138,1134,17,15,2
DKI JAKARTA,JAKARTA TIMUR,CAKUNG,PULO GEBANG,3175061005,2020-10-12,1282,134,1148,10,-4,14
DKI JAKARTA,JAKARTA TIMUR,CAKUNG,PULO GEBANG,3175061005,2020-10-13,1288,124,1164,6,-10,16
DKI JAKARTA,JAKARTA TIMUR,CAKUNG,PULO GEBANG,3175061005,2020-10-14,1315,134,1181,27,10,17
DKI JAKARTA,JAKARTA TIMUR,CAKUNG,PULO GEBANG,3175061005,2020-10-15,1336,132,1204,21,-2,23
DKI JAKARTA,JAKARTA TIMUR,CAKUNG,PULO GEBANG,3175061005,2020-10-16,1343,127,1216,7,-5,12
DKI JAKARTA,JAKARTA TIMUR,CAKUNG,PULO GEBANG,3175061005,2020-10-17,1360,142,1218,17,15,2
DKI JAKARTA,JAKARTA TIMUR,CAKUNG,PULO GEBANG,3175061005,2020-10-18,1376,156,1220,16,14,2
DKI JAKARTA,JAKARTA TIMUR,CAKUNG,PULO GEBANG,3175061005,2020-10-19,1384,147,1237,8,-9,17
DKI JAKARTA,JAKARTA TIMUR,CAKUNG,PULO GEBANG,3175061005,2020-10-20,1398,136,1262,14,-11,25
DKI JAKARTA,JAKARTA TIMUR,CAKUNG,PULO GEBANG,3175061005,2020-10-21,1416,137,1279,18,1,17
DKI JAKARTA,JAKARTA TIMUR,CAKUNG,PULO GEBANG,3175061005,2020-10-22,1425,123,1302,9,-14,23
DKI JAKARTA,JAKARTA TIMUR,CAKUNG,PULO GEBANG,3175061005,2020-10-23,1431,129,1302,6,6,0
DKI JAKARTA,JAKARTA TIMUR,CAKUNG,PULO GEBANG,3175061005,2020-10-24,1436,127,1309,5,-2,7
DKI JAKARTA,JAKARTA TIMUR,CAKUNG,PULO GEBANG,3175061005,2020-10-25,1446,134,1312,10,7,3
DKI JAKARTA,JAKARTA TIMUR,CAKUNG,PULO GEBANG,3175061005,2020-10-26,1448,99,1349,2,-35,37
DKI JAKARTA,JAKARTA TIMUR,CAKUNG,PULO GEBANG,3175061005,2020-10-27,1464,107,1357,16,8,8
DKI JAKARTA,JAKARTA TIMUR,CAKUNG,PULO GEBANG,3175061005,2020-10-28,1466,93,1373,2,-14,16
DKI JAKARTA,JAKARTA TIMUR,CAKUNG,PULO GEBANG,3175061005,2020-10-29,1474,79,1396,8,-14,23
DKI JAKARTA,JAKARTA TIMUR,CAKUNG,PULO GEBANG,3175061005,2020-10-30,1489,77,1413,15,-2,17
DKI JAKARTA,JAKARTA TIMUR,CAKUNG,PULO GEBANG,3175061005,2020-10-31,1503,88,1416,14,11,3
DKI JAKARTA,JAKARTA TIMUR,CAKUNG,RAWA TERATE,3175061002,2020-10-01,288,44,244,0,0,0
DKI JAKARTA,JAKARTA TIMUR,CAKUNG,RAWA TERATE,3175061002,2020-10-02,295,48,247,7,4,3
DKI JAKARTA,JAKARTA TIMUR,CAKUNG,RAWA TERATE,3175061002,2020-10-03,299,51,248,4,3,1
DKI JAKARTA,JAKARTA TIMUR,CAKUNG,RAWA TERATE,3175061002,2020-10-04,303,55,248,4,4,0
DKI JAKARTA,JAKARTA TIMUR,CAKUNG,RAWA TERATE,3175061002,2020-10-05,305,48,257,2,-7,9
DKI JAKARTA,JAKARTA TIMUR,CAKUNG,RAWA TERATE,3175061002,2020-10-06,309,51,258,4,3,1
DKI JAKARTA,JAKARTA TIMUR,CAKUNG,RAWA TERATE,3175061002,2020-10-07,314,54,260,5,3,2
DKI JAKARTA,JAKARTA TIMUR,CAKUNG,RAWA TERATE,3175061002,2020-10-08,329,54,275,15,0,15
DKI JAKARTA,JAKARTA TIMUR,CAKUNG,RAWA TERATE,3175061002,2020-10-09,331,56,275,2,2,0
DKI JAKARTA,JAKARTA TIMUR,CAKUNG,RAWA TERATE,3175061002,2020-10-10,335,59,276,4,3,1
DKI JAKARTA,JAKARTA TIMUR,CAKUNG,RAWA TERATE,3175061002,2020-10-11,349,72,277,14,13,1
DKI JAKARTA,JAKARTA TIMUR,CAKUNG,RAWA TERATE,3175061002,2020-10-12,350,66,284,1,-6,7
DKI JAKARTA,JAKARTA TIMUR,CAKUNG,RAWA TERATE,3175061002,2020-10-13,351,51,300,1,-15,16
DKI JAKARTA,JAKARTA TIMUR,CAKUNG,RAWA TERATE,3175061002,2020-10-14,355,43,312,4,-8,12
DKI JAKARTA,JAKARTA TIMUR,CAKUNG,RAWA TERATE,3175061002,2020-10-15,361,48,313,6,5,1
DKI JAKARTA,JAKARTA TIMUR,CAKUNG,RAWA TERATE,3175061002,2020-10-16,362,48,314,1,0,1
DKI JAKARTA,JAKARTA TIMUR,CAKUNG,RAWA TERATE,3175061002,2020-10-17,365,51,314,3,3,0
DKI JAKARTA,JAKARTA TIMUR,CAKUNG,RAWA TERATE,3175061002,2020-10-18,366,52,314,1,1,0
DKI JAKARTA,JAKARTA TIMUR,CAKUNG,RAWA TERATE,3175061002,2020-10-19,367,46,321,1,-6,7
DKI JAKARTA,JAKARTA TIMUR,CAKUNG,RAWA TERATE,3175061002,2020-10-20,372,37,335,5,-9,14
DKI JAKARTA,JAKARTA TIMUR,CAKUNG,RAWA TERATE,3175061002,2020-10-21,376,38,338,4,1,3
DKI JAKARTA,JAKARTA TIMUR,CAKUNG,RAWA TERATE,3175061002,2020-10-22,383,31,352,7,-7,14
DKI JAKARTA,JAKARTA TIMUR,CAKUNG,RAWA TERATE,3175061002,2020-10-23,383,31,352,0,0,0
DKI JAKARTA,JAKARTA TIMUR,CAKUNG,RAWA TERATE,3175061002,2020-10-24,386,31,355,3,0,3
DKI JAKARTA,JAKARTA TIMUR,CAKUNG,RAWA TERATE,3175061002,2020-10-25,388,33,355,2,2,0
DKI JAKARTA,JAKARTA TIMUR,CAKUNG,RAWA TERATE,3175061002,2020-10-26,390,29,361,2,-4,6
DKI JAKARTA,JAKARTA TIMUR,CAKUNG,RAWA TERATE,3175061002,2020-10-27,411,48,363,21,19,2
DKI JAKARTA,JAKARTA TIMUR,CAKUNG,RAWA TERATE,3175061002,2020-10-28,412,45,367,1,-3,4
DKI JAKARTA,JAKARTA TIMUR,CAKUNG,RAWA TERATE,3175061002,2020-10-29,415,42,373,3,-3,6
DKI JAKARTA,JAKARTA TIMUR,CAKUNG,RAWA TERATE,3175061002,2020-10-30,417,41,376,2,-1,3
DKI JAKARTA,JAKARTA TIMUR,CAKUNG,RAWA TERATE,3175061002,2020-10-31,419,41,378,2,0,2
DKI JAKARTA,JAKARTA TIMUR,CAKUNG,UJUNG MENTENG,3175061006,2020-10-01,371,53,318,0,0,0
DKI JAKARTA,JAKARTA TIMUR,CAKUNG,UJUNG MENTENG,3175061006,2020-10-02,376,51,325,5,-2,7
DKI JAKARTA,JAKARTA TIMUR,CAKUNG,UJUNG MENTENG,3175061006,2020-10-03,383,57,326,7,6,1
DKI JAKARTA,JAKARTA TIMUR,CAKUNG,UJUNG MENTENG,3175061006,2020-10-04,387,59,328,4,2,2
DKI JAKARTA,JAKARTA TIMUR,CAKUNG,UJUNG MENTENG,3175061006,2020-10-05,388,39,349,1,-20,21
DKI JAKARTA,JAKARTA TIMUR,CAKUNG,UJUNG MENTENG,3175061006,2020-10-06,391,39,352,3,0,3
DKI JAKARTA,JAKARTA TIMUR,CAKUNG,UJUNG MENTENG,3175061006,2020-10-07,398,40,358,7,1,6
DKI JAKARTA,JAKARTA TIMUR,CAKUNG,UJUNG MENTENG,3175061006,2020-10-08,409,49,360,11,9,2
DKI JAKARTA,JAKARTA TIMUR,CAKUNG,UJUNG MENTENG,3175061006,2020-10-09,412,52,360,3,3,0
DKI JAKARTA,JAKARTA TIMUR,CAKUNG,UJUNG MENTENG,3175061006,2020-10-10,416,51,365,4,-1,5
DKI JAKARTA,JAKARTA TIMUR,CAKUNG,UJUNG MENTENG,3175061006,2020-10-11,427,61,366,11,10,1
DKI JAKARTA,JAKARTA TIMUR,CAKUNG,UJUNG MENTENG,3175061006,2020-10-12,430,54,376,3,-7,10
DKI JAKARTA,JAKARTA TIMUR,CAKUNG,UJUNG MENTENG,3175061006,2020-10-13,430,44,386,0,-10,10
DKI JAKARTA,JAKARTA TIMUR,CAKUNG,UJUNG MENTENG,3175061006,2020-10-14,432,38,394,2,-6,8
DKI JAKARTA,JAKARTA TIMUR,CAKUNG,UJUNG MENTENG,3175061006,2020-10-15,436,37,399,4,-1,5
DKI JAKARTA,JAKARTA TIMUR,CAKUNG,UJUNG MENTENG,3175061006,2020-10-16,438,32,406,2,-5,7
DKI JAKARTA,JAKARTA TIMUR,CAKUNG,UJUNG MENTENG,3175061006,2020-10-17,447,39,408,9,7,2
DKI JAKARTA,JAKARTA TIMUR,CAKUNG,UJUNG MENTENG,3175061006,2020-10-18,451,40,411,4,1,3
DKI JAKARTA,JAKARTA TIMUR,CAKUNG,UJUNG MENTENG,3175061006,2020-10-19,456,43,413,5,3,2
DKI JAKARTA,JAKARTA TIMUR,CAKUNG,UJUNG MENTENG,3175061006,2020-10-20,461,38,423,5,-5,10
DKI JAKARTA,JAKARTA TIMUR,CAKUNG,UJUNG MENTENG,3175061006,2020-10-21,464,37,427,3,-1,4
DKI JAKARTA,JAKARTA TIMUR,CAKUNG,UJUNG MENTENG,3175061006,2020-10-22,466,30,436,2,-7,9
DKI JAKARTA,JAKARTA TIMUR,CAKUNG,UJUNG MENTENG,3175061006,2020-10-23,469,33,436,3,3,0
DKI JAKARTA,JAKARTA TIMUR,CAKUNG,UJUNG MENTENG,3175061006,2020-10-24,471,33,438,2,0,2
DKI JAKARTA,JAKARTA TIMUR,CAKUNG,UJUNG MENTENG,3175061006,2020-10-25,471,32,439,0,-1,1
DKI JAKARTA,JAKARTA TIMUR,CAKUNG,UJUNG MENTENG,3175061006,2020-10-26,473,31,442,2,-1,3
DKI JAKARTA,JAKARTA TIMUR,CAKUNG,UJUNG MENTENG,3175061006,2020-10-27,480,36,444,7,5,2
DKI JAKARTA,JAKARTA TIMUR,CAKUNG,UJUNG MENTENG,3175061006,2020-10-28,485,36,449,5,0,5
DKI JAKARTA,JAKARTA TIMUR,CAKUNG,UJUNG MENTENG,3175061006,2020-10-29,491,28,464,6,-8,15
DKI JAKARTA,JAKARTA TIMUR,CAKUNG,UJUNG MENTENG,3175061006,2020-10-30,495,30,466,4,2,2
DKI JAKARTA,JAKARTA TIMUR,CAKUNG,UJUNG MENTENG,3175061006,2020-10-31,500,32,469,5,2,3
DKI JAKARTA,JAKARTA TIMUR,CIPAYUNG,BAMBU APUS,3175101006,2020-10-01,434,54,380,0,0,0
DKI JAKARTA,JAKARTA TIMUR,CIPAYUNG,BAMBU APUS,3175101006,2020-10-02,446,49,397,12,-5,17
DKI JAKARTA,JAKARTA TIMUR,CIPAYUNG,BAMBU APUS,3175101006,2020-10-03,457,51,406,11,2,9
DKI JAKARTA,JAKARTA TIMUR,CIPAYUNG,BAMBU APUS,3175101006,2020-10-04,460,52,408,3,1,2
DKI JAKARTA,JAKARTA TIMUR,CIPAYUNG,BAMBU APUS,3175101006,2020-10-05,470,57,413,10,5,5
DKI JAKARTA,JAKARTA TIMUR,CIPAYUNG,BAMBU APUS,3175101006,2020-10-06,470,56,414,0,-1,1
DKI JAKARTA,JAKARTA TIMUR,CIPAYUNG,BAMBU APUS,3175101006,2020-10-07,475,57,418,5,1,4
DKI JAKARTA,JAKARTA TIMUR,CIPAYUNG,BAMBU APUS,3175101006,2020-10-08,497,60,437,22,3,19
DKI JAKARTA,JAKARTA TIMUR,CIPAYUNG,BAMBU APUS,3175101006,2020-10-09,499,61,438,2,1,1
DKI JAKARTA,JAKARTA TIMUR,CIPAYUNG,BAMBU APUS,3175101006,2020-10-10,504,61,443,5,0,5
DKI JAKARTA,JAKARTA TIMUR,CIPAYUNG,BAMBU APUS,3175101006,2020-10-11,528,61,467,24,0,24
DKI JAKARTA,JAKARTA TIMUR,CIPAYUNG,BAMBU APUS,3175101006,2020-10-12,531,57,474,3,-4,7
DKI JAKARTA,JAKARTA TIMUR,CIPAYUNG,BAMBU APUS,3175101006,2020-10-13,545,52,493,14,-5,19
DKI JAKARTA,JAKARTA TIMUR,CIPAYUNG,BAMBU APUS,3175101006,2020-10-14,550,34,516,5,-18,23
DKI JAKARTA,JAKARTA TIMUR,CIPAYUNG,BAMBU APUS,3175101006,2020-10-15,561,38,523,11,4,7
DKI JAKARTA,JAKARTA TIMUR,CIPAYUNG,BAMBU APUS,3175101006,2020-10-16,568,42,526,7,4,3
DKI JAKARTA,JAKARTA TIMUR,CIPAYUNG,BAMBU APUS,3175101006,2020-10-17,581,54,527,13,12,1
DKI JAKARTA,JAKARTA TIMUR,CIPAYUNG,BAMBU APUS,3175101006,2020-10-18,582,53,529,1,-1,2
DKI JAKARTA,JAKARTA TIMUR,CIPAYUNG,BAMBU APUS,3175101006,2020-10-19,583,44,539,1,-9,10
DKI JAKARTA,JAKARTA TIMUR,CIPAYUNG,BAMBU APUS,3175101006,2020-10-20,584,44,540,1,0,1
DKI JAKARTA,JAKARTA TIMUR,CIPAYUNG,BAMBU APUS,3175101006,2020-10-21,585,41,544,1,-3,4
DKI JAKARTA,JAKARTA TIMUR,CIPAYUNG,BAMBU APUS,3175101006,2020-10-22,586,36,550,1,-5,6
DKI JAKARTA,JAKARTA TIMUR,CIPAYUNG,BAMBU APUS,3175101006,2020-10-23,595,40,555,9,4,5
DKI JAKARTA,JAKARTA TIMUR,CIPAYUNG,BAMBU APUS,3175101006,2020-10-24,605,40,565,10,0,10
DKI JAKARTA,JAKARTA TIMUR,CIPAYUNG,BAMBU APUS,3175101006,2020-10-25,609,44,565,4,4,0
DKI JAKARTA,JAKARTA TIMUR,CIPAYUNG,BAMBU APUS,3175101006,2020-10-26,614,43,571,5,-1,6
DKI JAKARTA,JAKARTA TIMUR,CIPAYUNG,BAMBU APUS,3175101006,2020-10-27,617,38,579,3,-5,8
DKI JAKARTA,JAKARTA TIMUR,CIPAYUNG,BAMBU APUS,3175101006,2020-10-28,621,37,584,4,-1,5
DKI JAKARTA,JAKARTA TIMUR,CIPAYUNG,BAMBU APUS,3175101006,2020-10-29,622,28,594,1,-9,10
DKI JAKARTA,JAKARTA TIMUR,CIPAYUNG,BAMBU APUS,3175101006,2020-10-30,625,31,594,3,3,0
DKI JAKARTA,JAKARTA TIMUR,CIPAYUNG,BAMBU APUS,3175101006,2020-10-31,636,40,596,11,9,2
DKI JAKARTA,JAKARTA TIMUR,CIPAYUNG,CEGER,3175101008,2020-10-01,259,51,208,0,0,0
DKI JAKARTA,JAKARTA TIMUR,CIPAYUNG,CEGER,3175101008,2020-10-02,275,62,213,16,11,5
DKI JAKARTA,JAKARTA TIMUR,CIPAYUNG,CEGER,3175101008,2020-10-03,281,64,217,6,2,4
DKI JAKARTA,JAKARTA TIMUR,CIPAYUNG,CEGER,3175101008,2020-10-04,283,65,218,2,1,1
DKI JAKARTA,JAKARTA TIMUR,CIPAYUNG,CEGER,3175101008,2020-10-05,290,55,235,7,-10,17
DKI JAKARTA,JAKARTA TIMUR,CIPAYUNG,CEGER,3175101008,2020-10-06,292,52,240,2,-3,5
DKI JAKARTA,JAKARTA TIMUR,CIPAYUNG,CEGER,3175101008,2020-10-07,296,54,242,4,2,2
DKI JAKARTA,JAKARTA TIMUR,CIPAYUNG,CEGER,3175101008,2020-10-08,336,75,261,40,21,19
DKI JAKARTA,JAKARTA TIMUR,CIPAYUNG,CEGER,3175101008,2020-10-09,337,76,261,1,1,0
DKI JAKARTA,JAKARTA TIMUR,CIPAYUNG,CEGER,3175101008,2020-10-10,339,66,273,2,-10,12
DKI JAKARTA,JAKARTA TIMUR,CIPAYUNG,CEGER,3175101008,2020-10-11,346,66,280,7,0,7
DKI JAKARTA,JAKARTA TIMUR,CIPAYUNG,CEGER,3175101008,2020-10-12,347,65,282,1,-1,2
DKI JAKARTA,JAKARTA TIMUR,CIPAYUNG,CEGER,3175101008,2020-10-13,350,39,311,3,-26,29
DKI JAKARTA,JAKARTA TIMUR,CIPAYUNG,CEGER,3175101008,2020-10-14,384,49,335,34,10,24
DKI JAKARTA,JAKARTA TIMUR,CIPAYUNG,CEGER,3175101008,2020-10-15,388,47,341,4,-2,6
DKI JAKARTA,JAKARTA TIMUR,CIPAYUNG,CEGER,3175101008,2020-10-16,392,43,349,4,-4,8
DKI JAKARTA,JAKARTA TIMUR,CIPAYUNG,CEGER,3175101008,2020-10-17,394,42,352,2,-1,3
DKI JAKARTA,JAKARTA TIMUR,CIPAYUNG,CEGER,3175101008,2020-10-18,395,42,353,1,0,1
DKI JAKARTA,JAKARTA TIMUR,CIPAYUNG,CEGER,3175101008,2020-10-19,398,32,366,3,-10,13
DKI JAKARTA,JAKARTA TIMUR,CIPAYUNG,CEGER,3175101008,2020-10-20,402,33,369,4,1,3
DKI JAKARTA,JAKARTA TIMUR,CIPAYUNG,CEGER,3175101008,2020-10-21,404,34,370,2,1,1
DKI JAKARTA,JAKARTA TIMUR,CIPAYUNG,CEGER,3175101008,2020-10-22,405,32,373,1,-2,3
DKI JAKARTA,JAKARTA TIMUR,CIPAYUNG,CEGER,3175101008,2020-10-23,405,32,373,0,0,0
DKI JAKARTA,JAKARTA TIMUR,CIPAYUNG,CEGER,3175101008,2020-10-24,406,27,379,1,-5,6
DKI JAKARTA,JAKARTA TIMUR,CIPAYUNG,CEGER,3175101008,2020-10-25,408,28,380,2,1,1
DKI JAKARTA,JAKARTA TIMUR,CIPAYUNG,CEGER,3175101008,2020-10-26,412,30,382,4,2,2
DKI JAKARTA,JAKARTA TIMUR,CIPAYUNG,CEGER,3175101008,2020-10-27,412,27,385,0,-3,3
DKI JAKARTA,JAKARTA TIMUR,CIPAYUNG,CEGER,3175101008,2020-10-28,414,27,387,2,0,2
DKI JAKARTA,JAKARTA TIMUR,CIPAYUNG,CEGER,3175101008,2020-10-29,416,27,389,2,0,2
DKI JAKARTA,JAKARTA TIMUR,CIPAYUNG,CEGER,3175101008,2020-10-30,420,25,395,4,-2,6
DKI JAKARTA,JAKARTA TIMUR,CIPAYUNG,CEGER,3175101008,2020-10-31,429,33,396,9,8,1
DKI JAKARTA,JAKARTA TIMUR,CIPAYUNG,CILANGKAP,3175101002,2020-10-01,433,44,389,0,0,0
DKI JAKARTA,JAKARTA TIMUR,CIPAYUNG,CILANGKAP,3175101002,2020-10-02,447,47,400,14,3,11
DKI JAKARTA,JAKARTA TIMUR,CIPAYUNG,CILANGKAP,3175101002,2020-10-03,450,52,398,3,5,-2
DKI JAKARTA,JAKARTA TIMUR,CIPAYUNG,CILANGKAP,3175101002,2020-10-04,458,58,400,8,6,2
DKI JAKARTA,JAKARTA TIMUR,CIPAYUNG,CILANGKAP,3175101002,2020-10-05,476,68,408,18,10,8
DKI JAKARTA,JAKARTA TIMUR,CIPAYUNG,CILANGKAP,3175101002,2020-10-06,487,67,420,11,-1,12
DKI JAKARTA,JAKARTA TIMUR,CIPAYUNG,CILANGKAP,3175101002,2020-10-07,493,59,434,6,-8,14
DKI JAKARTA,JAKARTA TIMUR,CIPAYUNG,CILANGKAP,3175101002,2020-10-08,513,68,445,20,9,11
DKI JAKARTA,JAKARTA TIMUR,CIPAYUNG,CILANGKAP,3175101002,2020-10-09,519,73,446,6,5,1
DKI JAKARTA,JAKARTA TIMUR,CIPAYUNG,CILANGKAP,3175101002,2020-10-10,531,73,458,12,0,12
DKI JAKARTA,JAKARTA TIMUR,CIPAYUNG,CILANGKAP,3175101002,2020-10-11,538,74,464,7,1,6
DKI JAKARTA,JAKARTA TIMUR,CIPAYUNG,CILANGKAP,3175101002,2020-10-12,546,66,480,8,-8,16
DKI JAKARTA,JAKARTA TIMUR,CIPAYUNG,CILANGKAP,3175101002,2020-10-13,555,71,484,9,5,4
DKI JAKARTA,JAKARTA TIMUR,CIPAYUNG,CILANGKAP,3175101002,2020-10-14,558,63,495,3,-8,11
DKI JAKARTA,JAKARTA TIMUR,CIPAYUNG,CILANGKAP,3175101002,2020-10-15,564,62,502,6,-1,7
DKI JAKARTA,JAKARTA TIMUR,CIPAYUNG,CILANGKAP,3175101002,2020-10-16,569,50,519,5,-12,17
DKI JAKARTA,JAKARTA TIMUR,CIPAYUNG,CILANGKAP,3175101002,2020-10-17,575,55,520,6,5,1
DKI JAKARTA,JAKARTA TIMUR,CIPAYUNG,CILANGKAP,3175101002,2020-10-18,578,58,520,3,3,0
DKI JAKARTA,JAKARTA TIMUR,CIPAYUNG,CILANGKAP,3175101002,2020-10-19,579,52,527,1,-6,7
DKI JAKARTA,JAKARTA TIMUR,CIPAYUNG,CILANGKAP,3175101002,2020-10-20,591,49,542,12,-3,15
DKI JAKARTA,JAKARTA TIMUR,CIPAYUNG,CILANGKAP,3175101002,2020-10-21,597,36,561,6,-13,19
DKI JAKARTA,JAKARTA TIMUR,CIPAYUNG,CILANGKAP,3175101002,2020-10-22,598,33,565,1,-3,4
DKI JAKARTA,JAKARTA TIMUR,CIPAYUNG,CILANGKAP,3175101002,2020-10-23,602,35,567,4,2,2
DKI JAKARTA,JAKARTA TIMUR,CIPAYUNG,CILANGKAP,3175101002,2020-10-24,604,25,579,2,-10,12
DKI JAKARTA,JAKARTA TIMUR,CIPAYUNG,CILANGKAP,3175101002,2020-10-25,610,28,582,6,3,3
DKI JAKARTA,JAKARTA TIMUR,CIPAYUNG,CILANGKAP,3175101002,2020-10-26,613,27,586,3,-1,4
DKI JAKARTA,JAKARTA TIMUR,CIPAYUNG,CILANGKAP,3175101002,2020-10-27,615,22,593,2,-5,7
DKI JAKARTA,JAKARTA TIMUR,CIPAYUNG,CILANGKAP,3175101002,2020-10-28,617,20,597,2,-2,4
DKI JAKARTA,JAKARTA TIMUR,CIPAYUNG,CILANGKAP,3175101002,2020-10-29,619,14,605,2,-6,8
DKI JAKARTA,JAKARTA TIMUR,CIPAYUNG,CILANGKAP,3175101002,2020-10-30,626,18,608,7,4,3
DKI JAKARTA,JAKARTA TIMUR,CIPAYUNG,CILANGKAP,3175101002,2020-10-31,628,20,608,2,2,0
DKI JAKARTA,JAKARTA TIMUR,CIPAYUNG,CIPAYUNG,3175101001,2020-10-01,463,79,384,0,0,0
DKI JAKARTA,JAKARTA TIMUR,CIPAYUNG,CIPAYUNG,3175101001,2020-10-02,490,90,400,27,11,16
DKI JAKARTA,JAKARTA TIMUR,CIPAYUNG,CIPAYUNG,3175101001,2020-10-03,497,98,399,7,8,-1
DKI JAKARTA,JAKARTA TIMUR,CIPAYUNG,CIPAYUNG,3175101001,2020-10-04,506,100,406,9,2,7
DKI JAKARTA,JAKARTA TIMUR,CIPAYUNG,CIPAYUNG,3175101001,2020-10-05,520,102,418,14,2,12
DKI JAKARTA,JAKARTA TIMUR,CIPAYUNG,CIPAYUNG,3175101001,2020-10-06,520,99,421,0,-3,3
DKI JAKARTA,JAKARTA TIMUR,CIPAYUNG,CIPAYUNG,3175101001,2020-10-07,525,92,433,5,-7,12
DKI JAKARTA,JAKARTA TIMUR,CIPAYUNG,CIPAYUNG,3175101001,2020-10-08,541,96,445,16,4,12
DKI JAKARTA,JAKARTA TIMUR,CIPAYUNG,CIPAYUNG,3175101001,2020-10-09,544,99,445,3,3,0
DKI JAKARTA,JAKARTA TIMUR,CIPAYUNG,CIPAYUNG,3175101001,2020-10-10,548,81,467,4,-18,22
DKI JAKARTA,JAKARTA TIMUR,CIPAYUNG,CIPAYUNG,3175101001,2020-10-11,551,81,470,3,0,3
DKI JAKARTA,JAKARTA TIMUR,CIPAYUNG,CIPAYUNG,3175101001,2020-10-12,560,69,491,9,-12,21
DKI JAKARTA,JAKARTA TIMUR,CIPAYUNG,CIPAYUNG,3175101001,2020-10-13,569,62,507,9,-7,16
DKI JAKARTA,JAKARTA TIMUR,CIPAYUNG,CIPAYUNG,3175101001,2020-10-14,576,58,518,7,-4,11
DKI JAKARTA,JAKARTA TIMUR,CIPAYUNG,CIPAYUNG,3175101001,2020-10-15,588,49,539,12,-9,21
DKI JAKARTA,JAKARTA TIMUR,CIPAYUNG,CIPAYUNG,3175101001,2020-10-16,605,60,545,17,11,6
DKI JAKARTA,JAKARTA TIMUR,CIPAYUNG,CIPAYUNG,3175101001,2020-10-17,613,66,547,8,6,2
DKI JAKARTA,JAKARTA TIMUR,CIPAYUNG,CIPAYUNG,3175101001,2020-10-18,630,80,550,17,14,3
DKI JAKARTA,JAKARTA TIMUR,CIPAYUNG,CIPAYUNG,3175101001,2020-10-19,640,84,556,10,4,6
DKI JAKARTA,JAKARTA TIMUR,CIPAYUNG,CIPAYUNG,3175101001,2020-10-20,642,77,565,2,-7,9
DKI JAKARTA,JAKARTA TIMUR,CIPAYUNG,CIPAYUNG,3175101001,2020-10-21,644,76,568,2,-1,3
DKI JAKARTA,JAKARTA TIMUR,CIPAYUNG,CIPAYUNG,3175101001,2020-10-22,644,65,579,0,-11,11
DKI JAKARTA,JAKARTA TIMUR,CIPAYUNG,CIPAYUNG,3175101001,2020-10-23,647,67,580,3,2,1
DKI JAKARTA,JAKARTA TIMUR,CIPAYUNG,CIPAYUNG,3175101001,2020-10-24,656,60,596,9,-7,16
DKI JAKARTA,JAKARTA TIMUR,CIPAYUNG,CIPAYUNG,3175101001,2020-10-25,661,56,605,5,-4,9
DKI JAKARTA,JAKARTA TIMUR,CIPAYUNG,CIPAYUNG,3175101001,2020-10-26,666,56,610,5,0,5
DKI JAKARTA,JAKARTA TIMUR,CIPAYUNG,CIPAYUNG,3175101001,2020-10-27,669,50,619,3,-6,9
DKI JAKARTA,JAKARTA TIMUR,CIPAYUNG,CIPAYUNG,3175101001,2020-10-28,672,45,627,3,-5,8
DKI JAKARTA,JAKARTA TIMUR,CIPAYUNG,CIPAYUNG,3175101001,2020-10-29,676,28,648,4,-17,21
DKI JAKARTA,JAKARTA TIMUR,CIPAYUNG,CIPAYUNG,3175101001,2020-10-30,681,28,653,5,0,5
DKI JAKARTA,JAKARTA TIMUR,CIPAYUNG,CIPAYUNG,3175101001,2020-10-31,694,38,656,13,10,3
DKI JAKARTA,JAKARTA TIMUR,CIPAYUNG,LUBANG BUAYA,3175101007,2020-10-01,618,58,560,0,0,0
DKI JAKARTA,JAKARTA TIMUR,CIPAYUNG,LUBANG BUAYA,3175101007,2020-10-02,630,62,568,12,4,8
DKI JAKARTA,JAKARTA TIMUR,CIPAYUNG,LUBANG BUAYA,3175101007,2020-10-03,634,64,570,4,2,2
DKI JAKARTA,JAKARTA TIMUR,CIPAYUNG,LUBANG BUAYA,3175101007,2020-10-04,641,69,572,7,5,2
DKI JAKARTA,JAKARTA TIMUR,CIPAYUNG,LUBANG BUAYA,3175101007,2020-10-05,644,67,577,3,-2,5
DKI JAKARTA,JAKARTA TIMUR,CIPAYUNG,LUBANG BUAYA,3175101007,2020-10-06,646,62,584,2,-5,7
DKI JAKARTA,JAKARTA TIMUR,CIPAYUNG,LUBANG BUAYA,3175101007,2020-10-07,667,73,594,21,11,10
DKI JAKARTA,JAKARTA TIMUR,CIPAYUNG,LUBANG BUAYA,3175101007,2020-10-08,683,72,611,16,-1,17
DKI JAKARTA,JAKARTA TIMUR,CIPAYUNG,LUBANG BUAYA,3175101007,2020-10-09,689,77,612,6,5,1
DKI JAKARTA,JAKARTA TIMUR,CIPAYUNG,LUBANG BUAYA,3175101007,2020-10-10,697,74,623,8,-3,11
DKI JAKARTA,JAKARTA TIMUR,CIPAYUNG,LUBANG BUAYA,3175101007,2020-10-11,704,78,626,7,4,3
DKI JAKARTA,JAKARTA TIMUR,CIPAYUNG,LUBANG BUAYA,3175101007,2020-10-12,706,71,635,2,-7,9
DKI JAKARTA,JAKARTA TIMUR,CIPAYUNG,LUBANG BUAYA,3175101007,2020-10-13,709,61,648,3,-10,13
DKI JAKARTA,JAKARTA TIMUR,CIPAYUNG,LUBANG BUAYA,3175101007,2020-10-14,717,58,659,8,-3,11
DKI JAKARTA,JAKARTA TIMUR,CIPAYUNG,LUBANG BUAYA,3175101007,2020-10-15,740,76,664,23,18,5
DKI JAKARTA,JAKARTA TIMUR,CIPAYUNG,LUBANG BUAYA,3175101007,2020-10-16,753,82,671,13,6,7
DKI JAKARTA,JAKARTA TIMUR,CIPAYUNG,LUBANG BUAYA,3175101007,2020-10-17,776,91,685,23,9,14
DKI JAKARTA,JAKARTA TIMUR,CIPAYUNG,LUBANG BUAYA,3175101007,2020-10-18,784,95,689,8,4,4
DKI JAKARTA,JAKARTA TIMUR,CIPAYUNG,LUBANG BUAYA,3175101007,2020-10-19,786,88,698,2,-7,9
DKI JAKARTA,JAKARTA TIMUR,CIPAYUNG,LUBANG BUAYA,3175101007,2020-10-20,794,88,706,8,0,8
DKI JAKARTA,JAKARTA TIMUR,CIPAYUNG,LUBANG BUAYA,3175101007,2020-10-21,797,83,714,3,-5,8
DKI JAKARTA,JAKARTA TIMUR,CIPAYUNG,LUBANG BUAYA,3175101007,2020-10-22,801,76,725,4,-7,11
DKI JAKARTA,JAKARTA TIMUR,CIPAYUNG,LUBANG BUAYA,3175101007,2020-10-23,804,79,725,3,3,0
DKI JAKARTA,JAKARTA TIMUR,CIPAYUNG,LUBANG BUAYA,3175101007,2020-10-24,811,79,732,7,0,7
DKI JAKARTA,JAKARTA TIMUR,CIPAYUNG,LUBANG BUAYA,3175101007,2020-10-25,812,77,735,1,-2,3
DKI JAKARTA,JAKARTA TIMUR,CIPAYUNG,LUBANG BUAYA,3175101007,2020-10-26,816,62,754,4,-15,19
DKI JAKARTA,JAKARTA TIMUR,CIPAYUNG,LUBANG BUAYA,3175101007,2020-10-27,821,56,765,5,-6,11
DKI JAKARTA,JAKARTA TIMUR,CIPAYUNG,LUBANG BUAYA,3175101007,2020-10-28,822,51,771,1,-5,6
DKI JAKARTA,JAKARTA TIMUR,CIPAYUNG,LUBANG BUAYA,3175101007,2020-10-29,828,37,791,6,-14,20
DKI JAKARTA,JAKARTA TIMUR,CIPAYUNG,LUBANG BUAYA,3175101007,2020-10-30,843,42,801,15,5,10
DKI JAKARTA,JAKARTA TIMUR,CIPAYUNG,LUBANG BUAYA,3175101007,2020-10-31,845,44,801,2,2,0
DKI JAKARTA,JAKARTA TIMUR,CIPAYUNG,MUNJUL,3175101004,2020-10-01,256,28,228,0,0,0
DKI JAKARTA,JAKARTA TIMUR,CIPAYUNG,MUNJUL,3175101004,2020-10-02,271,30,241,15,2,13
DKI JAKARTA,JAKARTA TIMUR,CIPAYUNG,MUNJUL,3175101004,2020-10-03,272,30,242,1,0,1
DKI JAKARTA,JAKARTA TIMUR,CIPAYUNG,MUNJUL,3175101004,2020-10-04,273,30,243,1,0,1
DKI JAKARTA,JAKARTA TIMUR,CIPAYUNG,MUNJUL,3175101004,2020-10-05,273,29,244,0,-1,1
DKI JAKARTA,JAKARTA TIMUR,CIPAYUNG,MUNJUL,3175101004,2020-10-06,274,25,249,1,-4,5
DKI JAKARTA,JAKARTA TIMUR,CIPAYUNG,MUNJUL,3175101004,2020-10-07,280,29,251,6,4,2
DKI JAKARTA,JAKARTA TIMUR,CIPAYUNG,MUNJUL,3175101004,2020-10-08,306,41,265,26,12,14
DKI JAKARTA,JAKARTA TIMUR,CIPAYUNG,MUNJUL,3175101004,2020-10-09,308,43,265,2,2,0
DKI JAKARTA,JAKARTA TIMUR,CIPAYUNG,MUNJUL,3175101004,2020-10-10,310,41,269,2,-2,4
DKI JAKARTA,JAKARTA TIMUR,CIPAYUNG,MUNJUL,3175101004,2020-10-11,313,43,270,3,2,1
DKI JAKARTA,JAKARTA TIMUR,CIPAYUNG,MUNJUL,3175101004,2020-10-12,327,55,272,14,12,2
DKI JAKARTA,JAKARTA TIMUR,CIPAYUNG,MUNJUL,3175101004,2020-10-13,328,44,284,1,-11,12
DKI JAKARTA,JAKARTA TIMUR,CIPAYUNG,MUNJUL,3175101004,2020-10-14,330,40,290,2,-4,6
DKI JAKARTA,JAKARTA TIMUR,CIPAYUNG,MUNJUL,3175101004,2020-10-15,334,44,290,4,4,0
DKI JAKARTA,JAKARTA TIMUR,CIPAYUNG,MUNJUL,3175101004,2020-10-16,337,42,295,3,-2,5
DKI JAKARTA,JAKARTA TIMUR,CIPAYUNG,MUNJUL,3175101004,2020-10-17,344,45,299,7,3,4
DKI JAKARTA,JAKARTA TIMUR,CIPAYUNG,MUNJUL,3175101004,2020-10-18,347,48,299,3,3,0
DKI JAKARTA,JAKARTA TIMUR,CIPAYUNG,MUNJUL,3175101004,2020-10-19,347,39,308,0,-9,9
DKI JAKARTA,JAKARTA TIMUR,CIPAYUNG,MUNJUL,3175101004,2020-10-20,348,36,312,1,-3,4
DKI JAKARTA,JAKARTA TIMUR,CIPAYUNG,MUNJUL,3175101004,2020-10-21,349,34,315,1,-2,3
DKI JAKARTA,JAKARTA TIMUR,CIPAYUNG,MUNJUL,3175101004,2020-10-22,350,20,330,1,-14,15
DKI JAKARTA,JAKARTA TIMUR,CIPAYUNG,MUNJUL,3175101004,2020-10-23,351,21,330,1,1,0
DKI JAKARTA,JAKARTA TIMUR,CIPAYUNG,MUNJUL,3175101004,2020-10-24,353,18,335,2,-3,5
DKI JAKARTA,JAKARTA TIMUR,CIPAYUNG,MUNJUL,3175101004,2020-10-25,354,18,336,1,0,1
DKI JAKARTA,JAKARTA TIMUR,CIPAYUNG,MUNJUL,3175101004,2020-10-26,359,21,338,5,3,2
DKI JAKARTA,JAKARTA TIMUR,CIPAYUNG,MUNJUL,3175101004,2020-10-27,361,17,344,2,-4,6
DKI JAKARTA,JAKARTA TIMUR,CIPAYUNG,MUNJUL,3175101004,2020-10-28,361,16,345,0,-1,1
DKI JAKARTA,JAKARTA TIMUR,CIPAYUNG,MUNJUL,3175101004,2020-10-29,364,15,349,3,-1,4
DKI JAKARTA,JAKARTA TIMUR,CIPAYUNG,MUNJUL,3175101004,2020-10-30,371,19,352,7,4,3
DKI JAKARTA,JAKARTA TIMUR,CIPAYUNG,MUNJUL,3175101004,2020-10-31,371,18,353,0,-1,1
DKI JAKARTA,JAKARTA TIMUR,CIPAYUNG,PONDOK RANGGON,3175101003,2020-10-01,272,46,226,0,0,0
DKI JAKARTA,JAKARTA TIMUR,CIPAYUNG,PONDOK RANGGON,3175101003,2020-10-02,282,51,231,10,5,5
DKI JAKARTA,JAKARTA TIMUR,CIPAYUNG,PONDOK RANGGON,3175101003,2020-10-03,293,58,235,11,7,4
DKI JAKARTA,JAKARTA TIMUR,CIPAYUNG,PONDOK RANGGON,3175101003,2020-10-04,295,60,235,2,2,0
DKI JAKARTA,JAKARTA TIMUR,CIPAYUNG,PONDOK RANGGON,3175101003,2020-10-05,307,70,237,12,10,2
DKI JAKARTA,JAKARTA TIMUR,CIPAYUNG,PONDOK RANGGON,3175101003,2020-10-06,309,65,244,2,-5,7
DKI JAKARTA,JAKARTA TIMUR,CIPAYUNG,PONDOK RANGGON,3175101003,2020-10-07,316,56,260,7,-9,16
DKI JAKARTA,JAKARTA TIMUR,CIPAYUNG,PONDOK RANGGON,3175101003,2020-10-08,334,53,281,18,-3,21
DKI JAKARTA,JAKARTA TIMUR,CIPAYUNG,PONDOK RANGGON,3175101003,2020-10-09,336,53,283,2,0,2
DKI JAKARTA,JAKARTA TIMUR,CIPAYUNG,PONDOK RANGGON,3175101003,2020-10-10,341,54,287,5,1,4
DKI JAKARTA,JAKARTA TIMUR,CIPAYUNG,PONDOK RANGGON,3175101003,2020-10-11,351,58,293,10,4,6
DKI JAKARTA,JAKARTA TIMUR,CIPAYUNG,PONDOK RANGGON,3175101003,2020-10-12,355,54,301,4,-4,8
DKI JAKARTA,JAKARTA TIMUR,CIPAYUNG,PONDOK RANGGON,3175101003,2020-10-13,361,51,310,6,-3,9
DKI JAKARTA,JAKARTA TIMUR,CIPAYUNG,PONDOK RANGGON,3175101003,2020-10-14,372,51,321,11,0,11
DKI JAKARTA,JAKARTA TIMUR,CIPAYUNG,PONDOK RANGGON,3175101003,2020-10-15,405,62,343,33,11,22
DKI JAKARTA,JAKARTA TIMUR,CIPAYUNG,PONDOK RANGGON,3175101003,2020-10-16,409,52,357,4,-10,14
DKI JAKARTA,JAKARTA TIMUR,CIPAYUNG,PONDOK RANGGON,3175101003,2020-10-17,420,59,361,11,7,4
DKI JAKARTA,JAKARTA TIMUR,CIPAYUNG,PONDOK RANGGON,3175101003,2020-10-18,427,66,361,7,7,0
DKI JAKARTA,JAKARTA TIMUR,CIPAYUNG,PONDOK RANGGON,3175101003,2020-10-19,427,53,374,0,-13,13
DKI JAKARTA,JAKARTA TIMUR,CIPAYUNG,PONDOK RANGGON,3175101003,2020-10-20,434,52,382,7,-1,8
DKI JAKARTA,JAKARTA TIMUR,CIPAYUNG,PONDOK RANGGON,3175101003,2020-10-21,436,52,384,2,0,2
DKI JAKARTA,JAKARTA TIMUR,CIPAYUNG,PONDOK RANGGON,3175101003,2020-10-22,439,50,389,3,-2,5
DKI JAKARTA,JAKARTA TIMUR,CIPAYUNG,PONDOK RANGGON,3175101003,2020-10-23,443,53,390,4,3,1
DKI JAKARTA,JAKARTA TIMUR,CIPAYUNG,PONDOK RANGGON,3175101003,2020-10-24,448,44,404,5,-9,14
DKI JAKARTA,JAKARTA TIMUR,CIPAYUNG,PONDOK RANGGON,3175101003,2020-10-25,450,46,404,2,2,0
DKI JAKARTA,JAKARTA TIMUR,CIPAYUNG,PONDOK RANGGON,3175101003,2020-10-26,450,40,410,0,-6,6
DKI JAKARTA,JAKARTA TIMUR,CIPAYUNG,PONDOK RANGGON,3175101003,2020-10-27,452,38,414,2,-2,4
DKI JAKARTA,JAKARTA TIMUR,CIPAYUNG,PONDOK RANGGON,3175101003,2020-10-28,454,32,422,2,-6,8
DKI JAKARTA,JAKARTA TIMUR,CIPAYUNG,PONDOK RANGGON,3175101003,2020-10-29,456,25,431,2,-7,9
DKI JAKARTA,JAKARTA TIMUR,CIPAYUNG,PONDOK RANGGON,3175101003,2020-10-30,459,28,431,3,3,0
DKI JAKARTA,JAKARTA TIMUR,CIPAYUNG,PONDOK RANGGON,3175101003,2020-10-31,474,43,431,15,15,0
DKI JAKARTA,JAKARTA TIMUR,CIPAYUNG,SETU,3175101005,2020-10-01,263,36,227,0,0,0
DKI JAKARTA,JAKARTA TIMUR,CIPAYUNG,SETU,3175101005,2020-10-02,278,42,236,15,6,9
DKI JAKARTA,JAKARTA TIMUR,CIPAYUNG,SETU,3175101005,2020-10-03,281,45,236,3,3,0
DKI JAKARTA,JAKARTA TIMUR,CIPAYUNG,SETU,3175101005,2020-10-04,284,46,238,3,1,2
DKI JAKARTA,JAKARTA TIMUR,CIPAYUNG,SETU,3175101005,2020-10-05,287,46,241,3,0,3
DKI JAKARTA,JAKARTA TIMUR,CIPAYUNG,SETU,3175101005,2020-10-06,287,39,248,0,-7,7
DKI JAKARTA,JAKARTA TIMUR,CIPAYUNG,SETU,3175101005,2020-10-07,315,42,273,28,3,25
DKI JAKARTA,JAKARTA TIMUR,CIPAYUNG,SETU,3175101005,2020-10-08,356,63,293,41,21,20
DKI JAKARTA,JAKARTA TIMUR,CIPAYUNG,SETU,3175101005,2020-10-09,357,64,293,1,1,0
DKI JAKARTA,JAKARTA TIMUR,CIPAYUNG,SETU,3175101005,2020-10-10,359,52,307,2,-12,14
DKI JAKARTA,JAKARTA TIMUR,CIPAYUNG,SETU,3175101005,2020-10-11,363,56,307,4,4,0
DKI JAKARTA,JAKARTA TIMUR,CIPAYUNG,SETU,3175101005,2020-10-12,365,34,331,2,-22,24
DKI JAKARTA,JAKARTA TIMUR,CIPAYUNG,SETU,3175101005,2020-10-13,370,35,335,5,1,4
DKI JAKARTA,JAKARTA TIMUR,CIPAYUNG,SETU,3175101005,2020-10-14,389,38,351,19,3,16
DKI JAKARTA,JAKARTA TIMUR,CIPAYUNG,SETU,3175101005,2020-10-15,402,44,358,13,6,7
DKI JAKARTA,JAKARTA TIMUR,CIPAYUNG,SETU,3175101005,2020-10-16,407,42,365,5,-2,7
DKI JAKARTA,JAKARTA TIMUR,CIPAYUNG,SETU,3175101005,2020-10-17,410,45,365,3,3,0
DKI JAKARTA,JAKARTA TIMUR,CIPAYUNG,SETU,3175101005,2020-10-18,417,52,365,7,7,0
DKI JAKARTA,JAKARTA TIMUR,CIPAYUNG,SETU,3175101005,2020-10-19,421,46,375,4,-6,10
DKI JAKARTA,JAKARTA TIMUR,CIPAYUNG,SETU,3175101005,2020-10-20,426,48,378,5,2,3
DKI JAKARTA,JAKARTA TIMUR,CIPAYUNG,SETU,3175101005,2020-10-21,435,54,381,9,6,3
DKI JAKARTA,JAKARTA TIMUR,CIPAYUNG,SETU,3175101005,2020-10-22,438,47,391,3,-7,10
DKI JAKARTA,JAKARTA TIMUR,CIPAYUNG,SETU,3175101005,2020-10-23,438,47,391,0,0,0
DKI JAKARTA,JAKARTA TIMUR,CIPAYUNG,SETU,3175101005,2020-10-24,440,42,398,2,-5,7
DKI JAKARTA,JAKARTA TIMUR,CIPAYUNG,SETU,3175101005,2020-10-25,441,43,398,1,1,0
DKI JAKARTA,JAKARTA TIMUR,CIPAYUNG,SETU,3175101005,2020-10-26,446,36,410,5,-7,12
DKI JAKARTA,JAKARTA TIMUR,CIPAYUNG,SETU,3175101005,2020-10-27,446,31,415,0,-5,5
DKI JAKARTA,JAKARTA TIMUR,CIPAYUNG,SETU,3175101005,2020-10-28,447,23,424,1,-8,9
DKI JAKARTA,JAKARTA TIMUR,CIPAYUNG,SETU,3175101005,2020-10-29,447,18,429,0,-5,5
DKI JAKARTA,JAKARTA TIMUR,CIPAYUNG,SETU,3175101005,2020-10-30,457,22,435,10,4,6
DKI JAKARTA,JAKARTA TIMUR,CIPAYUNG,SETU,3175101005,2020-10-31,461,26,435,4,4,0
DKI JAKARTA,JAKARTA TIMUR,CIRACAS,CIBUBUR,3175091002,2020-10-01,1613,47,1566,0,0,0
DKI JAKARTA,JAKARTA TIMUR,CIRACAS,CIBUBUR,3175091002,2020-10-02,1624,47,1577,11,0,11
DKI JAKARTA,JAKARTA TIMUR,CIRACAS,CIBUBUR,3175091002,2020-10-03,1633,52,1581,9,5,4
DKI JAKARTA,JAKARTA TIMUR,CIRACAS,CIBUBUR,3175091002,2020-10-04,1634,53,1581,1,1,0
DKI JAKARTA,JAKARTA TIMUR,CIRACAS,CIBUBUR,3175091002,2020-10-05,1636,53,1583,2,0,2
DKI JAKARTA,JAKARTA TIMUR,CIRACAS,CIBUBUR,3175091002,2020-10-06,1653,53,1600,17,0,17
DKI JAKARTA,JAKARTA TIMUR,CIRACAS,CIBUBUR,3175091002,2020-10-07,1664,58,1606,11,5,6
DKI JAKARTA,JAKARTA TIMUR,CIRACAS,CIBUBUR,3175091002,2020-10-08,1689,64,1625,25,6,19
DKI JAKARTA,JAKARTA TIMUR,CIRACAS,CIBUBUR,3175091002,2020-10-09,1691,66,1625,2,2,0
DKI JAKARTA,JAKARTA TIMUR,CIRACAS,CIBUBUR,3175091002,2020-10-10,1702,71,1631,11,5,6
DKI JAKARTA,JAKARTA TIMUR,CIRACAS,CIBUBUR,3175091002,2020-10-11,1718,77,1641,16,6,10
DKI JAKARTA,JAKARTA TIMUR,CIRACAS,CIBUBUR,3175091002,2020-10-12,1723,66,1657,5,-11,16
DKI JAKARTA,JAKARTA TIMUR,CIRACAS,CIBUBUR,3175091002,2020-10-13,1728,62,1666,5,-4,9
DKI JAKARTA,JAKARTA TIMUR,CIRACAS,CIBUBUR,3175091002,2020-10-14,1744,56,1688,16,-6,22
DKI JAKARTA,JAKARTA TIMUR,CIRACAS,CIBUBUR,3175091002,2020-10-15,1757,57,1700,13,1,12
DKI JAKARTA,JAKARTA TIMUR,CIRACAS,CIBUBUR,3175091002,2020-10-16,1766,64,1702,9,7,2
DKI JAKARTA,JAKARTA TIMUR,CIRACAS,CIBUBUR,3175091002,2020-10-17,1791,78,1713,25,14,11
DKI JAKARTA,JAKARTA TIMUR,CIRACAS,CIBUBUR,3175091002,2020-10-18,1794,80,1714,3,2,1
DKI JAKARTA,JAKARTA TIMUR,CIRACAS,CIBUBUR,3175091002,2020-10-19,1798,76,1722,4,-4,8
DKI JAKARTA,JAKARTA TIMUR,CIRACAS,CIBUBUR,3175091002,2020-10-20,1811,80,1731,13,4,9
DKI JAKARTA,JAKARTA TIMUR,CIRACAS,CIBUBUR,3175091002,2020-10-21,1818,79,1739,7,-1,8
DKI JAKARTA,JAKARTA TIMUR,CIRACAS,CIBUBUR,3175091002,2020-10-22,1832,63,1769,14,-16,30
DKI JAKARTA,JAKARTA TIMUR,CIRACAS,CIBUBUR,3175091002,2020-10-23,1842,72,1770,10,9,1
DKI JAKARTA,JAKARTA TIMUR,CIRACAS,CIBUBUR,3175091002,2020-10-24,1853,56,1797,11,-16,27
DKI JAKARTA,JAKARTA TIMUR,CIRACAS,CIBUBUR,3175091002,2020-10-25,1863,59,1804,10,3,7
DKI JAKARTA,JAKARTA TIMUR,CIRACAS,CIBUBUR,3175091002,2020-10-26,1869,59,1810,6,0,6
DKI JAKARTA,JAKARTA TIMUR,CIRACAS,CIBUBUR,3175091002,2020-10-27,1870,57,1813,1,-2,3
DKI JAKARTA,JAKARTA TIMUR,CIRACAS,CIBUBUR,3175091002,2020-10-28,1873,55,1818,3,-2,5
DKI JAKARTA,JAKARTA TIMUR,CIRACAS,CIBUBUR,3175091002,2020-10-29,1884,46,1838,11,-9,20
DKI JAKARTA,JAKARTA TIMUR,CIRACAS,CIBUBUR,3175091002,2020-10-30,1891,43,1848,7,-3,10
DKI JAKARTA,JAKARTA TIMUR,CIRACAS,CIBUBUR,3175091002,2020-10-31,1894,46,1848,3,3,0
DKI JAKARTA,JAKARTA TIMUR,CIRACAS,CIRACAS,3175091001,2020-10-01,1309,50,1259,0,0,0
DKI JAKARTA,JAKARTA TIMUR,CIRACAS,CIRACAS,3175091001,2020-10-02,1321,55,1266,12,5,7
DKI JAKARTA,JAKARTA TIMUR,CIRACAS,CIRACAS,3175091001,2020-10-03,1332,60,1272,11,5,6
DKI JAKARTA,JAKARTA TIMUR,CIRACAS,CIRACAS,3175091001,2020-10-04,1337,63,1274,5,3,2
DKI JAKARTA,JAKARTA TIMUR,CIRACAS,CIRACAS,3175091001,2020-10-05,1340,59,1281,3,-4,7
DKI JAKARTA,JAKARTA TIMUR,CIRACAS,CIRACAS,3175091001,2020-10-06,1357,62,1295,17,3,14
DKI JAKARTA,JAKARTA TIMUR,CIRACAS,CIRACAS,3175091001,2020-10-07,1372,63,1309,15,1,14
DKI JAKARTA,JAKARTA TIMUR,CIRACAS,CIRACAS,3175091001,2020-10-08,1406,68,1338,34,5,29
DKI JAKARTA,JAKARTA TIMUR,CIRACAS,CIRACAS,3175091001,2020-10-09,1412,74,1338,6,6,0
DKI JAKARTA,JAKARTA TIMUR,CIRACAS,CIRACAS,3175091001,2020-10-10,1422,77,1345,10,3,7
DKI JAKARTA,JAKARTA TIMUR,CIRACAS,CIRACAS,3175091001,2020-10-11,1448,88,1360,26,11,15
DKI JAKARTA,JAKARTA TIMUR,CIRACAS,CIRACAS,3175091001,2020-10-12,1453,80,1373,5,-8,13
DKI JAKARTA,JAKARTA TIMUR,CIRACAS,CIRACAS,3175091001,2020-10-13,1456,71,1385,3,-9,12
DKI JAKARTA,JAKARTA TIMUR,CIRACAS,CIRACAS,3175091001,2020-10-14,1476,65,1411,20,-6,26
DKI JAKARTA,JAKARTA TIMUR,CIRACAS,CIRACAS,3175091001,2020-10-15,1495,67,1428,19,2,17
DKI JAKARTA,JAKARTA TIMUR,CIRACAS,CIRACAS,3175091001,2020-10-16,1506,69,1437,11,2,9
DKI JAKARTA,JAKARTA TIMUR,CIRACAS,CIRACAS,3175091001,2020-10-17,1543,101,1442,37,32,5
DKI JAKARTA,JAKARTA TIMUR,CIRACAS,CIRACAS,3175091001,2020-10-18,1550,106,1444,7,5,2
DKI JAKARTA,JAKARTA TIMUR,CIRACAS,CIRACAS,3175091001,2020-10-19,1553,105,1448,3,-1,4
DKI JAKARTA,JAKARTA TIMUR,CIRACAS,CIRACAS,3175091001,2020-10-20,1560,107,1453,7,2,5
DKI JAKARTA,JAKARTA TIMUR,CIRACAS,CIRACAS,3175091001,2020-10-21,1572,100,1472,12,-7,19
DKI JAKARTA,JAKARTA TIMUR,CIRACAS,CIRACAS,3175091001,2020-10-22,1580,88,1492,8,-12,20
DKI JAKARTA,JAKARTA TIMUR,CIRACAS,CIRACAS,3175091001,2020-10-23,1594,99,1495,14,11,3
DKI JAKARTA,JAKARTA TIMUR,CIRACAS,CIRACAS,3175091001,2020-10-24,1603,85,1518,9,-14,23
DKI JAKARTA,JAKARTA TIMUR,CIRACAS,CIRACAS,3175091001,2020-10-25,1609,83,1526,6,-2,8
DKI JAKARTA,JAKARTA TIMUR,CIRACAS,CIRACAS,3175091001,2020-10-26,1611,79,1532,2,-4,6
DKI JAKARTA,JAKARTA TIMUR,CIRACAS,CIRACAS,3175091001,2020-10-27,1620,74,1546,9,-5,14
DKI JAKARTA,JAKARTA TIMUR,CIRACAS,CIRACAS,3175091001,2020-10-28,1622,69,1553,2,-5,7
DKI JAKARTA,JAKARTA TIMUR,CIRACAS,CIRACAS,3175091001,2020-10-29,1629,36,1593,7,-33,40
DKI JAKARTA,JAKARTA TIMUR,CIRACAS,CIRACAS,3175091001,2020-10-30,1637,39,1598,8,3,5
DKI JAKARTA,JAKARTA TIMUR,CIRACAS,CIRACAS,3175091001,2020-10-31,1639,39,1600,2,0,2
DKI JAKARTA,JAKARTA TIMUR,CIRACAS,KELAPA DUA WETAN,3175091003,2020-10-01,907,59,848,0,0,0
DKI JAKARTA,JAKARTA TIMUR,CIRACAS,KELAPA DUA WETAN,3175091003,2020-10-02,917,63,854,10,4,6
DKI JAKARTA,JAKARTA TIMUR,CIRACAS,KELAPA DUA WETAN,3175091003,2020-10-03,928,71,857,11,8,3
DKI JAKARTA,JAKARTA TIMUR,CIRACAS,KELAPA DUA WETAN,3175091003,2020-10-04,932,74,858,4,3,1
DKI JAKARTA,JAKARTA TIMUR,CIRACAS,KELAPA DUA WETAN,3175091003,2020-10-05,933,67,866,1,-7,8
DKI JAKARTA,JAKARTA TIMUR,CIRACAS,KELAPA DUA WETAN,3175091003,2020-10-06,937,67,870,4,0,4
DKI JAKARTA,JAKARTA TIMUR,CIRACAS,KELAPA DUA WETAN,3175091003,2020-10-07,966,68,898,29,1,28
DKI JAKARTA,JAKARTA TIMUR,CIRACAS,KELAPA DUA WETAN,3175091003,2020-10-08,995,78,917,29,10,19
DKI JAKARTA,JAKARTA TIMUR,CIRACAS,KELAPA DUA WETAN,3175091003,2020-10-09,997,80,917,2,2,0
DKI JAKARTA,JAKARTA TIMUR,CIRACAS,KELAPA DUA WETAN,3175091003,2020-10-10,1001,78,923,4,-2,6
DKI JAKARTA,JAKARTA TIMUR,CIRACAS,KELAPA DUA WETAN,3175091003,2020-10-11,1014,70,944,13,-8,21
DKI JAKARTA,JAKARTA TIMUR,CIRACAS,KELAPA DUA WETAN,3175091003,2020-10-12,1029,66,963,15,-4,19
DKI JAKARTA,JAKARTA TIMUR,CIRACAS,KELAPA DUA WETAN,3175091003,2020-10-13,1029,55,974,0,-11,11
DKI JAKARTA,JAKARTA TIMUR,CIRACAS,KELAPA DUA WETAN,3175091003,2020-10-14,1059,54,1005,30,-1,31
DKI JAKARTA,JAKARTA TIMUR,CIRACAS,KELAPA DUA WETAN,3175091003,2020-10-15,1067,49,1018,8,-5,13
DKI JAKARTA,JAKARTA TIMUR,CIRACAS,KELAPA DUA WETAN,3175091003,2020-10-16,1074,53,1021,7,4,3
DKI JAKARTA,JAKARTA TIMUR,CIRACAS,KELAPA DUA WETAN,3175091003,2020-10-17,1086,62,1024,12,9,3
DKI JAKARTA,JAKARTA TIMUR,CIRACAS,KELAPA DUA WETAN,3175091003,2020-10-18,1088,63,1025,2,1,1
DKI JAKARTA,JAKARTA TIMUR,CIRACAS,KELAPA DUA WETAN,3175091003,2020-10-19,1090,54,1036,2,-9,11
DKI JAKARTA,JAKARTA TIMUR,CIRACAS,KELAPA DUA WETAN,3175091003,2020-10-20,1095,54,1041,5,0,5
DKI JAKARTA,JAKARTA TIMUR,CIRACAS,KELAPA DUA WETAN,3175091003,2020-10-21,1098,49,1049,3,-5,8
DKI JAKARTA,JAKARTA TIMUR,CIRACAS,KELAPA DUA WETAN,3175091003,2020-10-22,1107,46,1061,9,-3,12
DKI JAKARTA,JAKARTA TIMUR,CIRACAS,KELAPA DUA WETAN,3175091003,2020-10-23,1116,54,1062,9,8,1
DKI JAKARTA,JAKARTA TIMUR,CIRACAS,KELAPA DUA WETAN,3175091003,2020-10-24,1148,41,1107,32,-13,45
DKI JAKARTA,JAKARTA TIMUR,CIRACAS,KELAPA DUA WETAN,3175091003,2020-10-25,1150,42,1108,2,1,1
DKI JAKARTA,JAKARTA TIMUR,CIRACAS,KELAPA DUA WETAN,3175091003,2020-10-26,1155,38,1117,5,-4,9
DKI JAKARTA,JAKARTA TIMUR,CIRACAS,KELAPA DUA WETAN,3175091003,2020-10-27,1161,38,1123,6,0,6
DKI JAKARTA,JAKARTA TIMUR,CIRACAS,KELAPA DUA WETAN,3175091003,2020-10-28,1164,34,1130,3,-4,7
DKI JAKARTA,JAKARTA TIMUR,CIRACAS,KELAPA DUA WETAN,3175091003,2020-10-29,1166,26,1141,2,-8,11
DKI JAKARTA,JAKARTA TIMUR,CIRACAS,KELAPA DUA WETAN,3175091003,2020-10-30,1174,30,1145,8,4,4
DKI JAKARTA,JAKARTA TIMUR,CIRACAS,KELAPA DUA WETAN,3175091003,2020-10-31,1175,30,1146,1,0,1
DKI JAKARTA,JAKARTA TIMUR,CIRACAS,RAMBUTAN,3175091005,2020-10-01,634,25,609,0,0,0
DKI JAKARTA,JAKARTA TIMUR,CIRACAS,RAMBUTAN,3175091005,2020-10-02,641,31,610,7,6,1
DKI JAKARTA,JAKARTA TIMUR,CIRACAS,RAMBUTAN,3175091005,2020-10-03,645,35,610,4,4,0
DKI JAKARTA,JAKARTA TIMUR,CIRACAS,RAMBUTAN,3175091005,2020-10-04,649,38,611,4,3,1
DKI JAKARTA,JAKARTA TIMUR,CIRACAS,RAMBUTAN,3175091005,2020-10-05,650,36,614,1,-2,3
DKI JAKARTA,JAKARTA TIMUR,CIRACAS,RAMBUTAN,3175091005,2020-10-06,650,33,617,0,-3,3
DKI JAKARTA,JAKARTA TIMUR,CIRACAS,RAMBUTAN,3175091005,2020-10-07,655,36,619,5,3,2
DKI JAKARTA,JAKARTA TIMUR,CIRACAS,RAMBUTAN,3175091005,2020-10-08,663,35,628,8,-1,9
DKI JAKARTA,JAKARTA TIMUR,CIRACAS,RAMBUTAN,3175091005,2020-10-09,668,40,628,5,5,0
DKI JAKARTA,JAKARTA TIMUR,CIRACAS,RAMBUTAN,3175091005,2020-10-10,670,38,632,2,-2,4
DKI JAKARTA,JAKARTA TIMUR,CIRACAS,RAMBUTAN,3175091005,2020-10-11,677,41,636,7,3,4
DKI JAKARTA,JAKARTA TIMUR,CIRACAS,RAMBUTAN,3175091005,2020-10-12,680,38,642,3,-3,6
DKI JAKARTA,JAKARTA TIMUR,CIRACAS,RAMBUTAN,3175091005,2020-10-13,682,31,651,2,-7,9
DKI JAKARTA,JAKARTA TIMUR,CIRACAS,RAMBUTAN,3175091005,2020-10-14,687,30,657,5,-1,6
DKI JAKARTA,JAKARTA TIMUR,CIRACAS,RAMBUTAN,3175091005,2020-10-15,696,28,668,9,-2,11
DKI JAKARTA,JAKARTA TIMUR,CIRACAS,RAMBUTAN,3175091005,2020-10-16,702,32,670,6,4,2
DKI JAKARTA,JAKARTA TIMUR,CIRACAS,RAMBUTAN,3175091005,2020-10-17,708,35,673,6,3,3
DKI JAKARTA,JAKARTA TIMUR,CIRACAS,RAMBUTAN,3175091005,2020-10-18,709,36,673,1,1,0
DKI JAKARTA,JAKARTA TIMUR,CIRACAS,RAMBUTAN,3175091005,2020-10-19,710,35,675,1,-1,2
DKI JAKARTA,JAKARTA TIMUR,CIRACAS,RAMBUTAN,3175091005,2020-10-20,716,32,684,6,-3,9
DKI JAKARTA,JAKARTA TIMUR,CIRACAS,RAMBUTAN,3175091005,2020-10-21,723,31,692,7,-1,8
DKI JAKARTA,JAKARTA TIMUR,CIRACAS,RAMBUTAN,3175091005,2020-10-22,733,33,700,10,2,8
DKI JAKARTA,JAKARTA TIMUR,CIRACAS,RAMBUTAN,3175091005,2020-10-23,739,39,700,6,6,0
DKI JAKARTA,JAKARTA TIMUR,CIRACAS,RAMBUTAN,3175091005,2020-10-24,741,32,709,2,-7,9
DKI JAKARTA,JAKARTA TIMUR,CIRACAS,RAMBUTAN,3175091005,2020-10-25,746,32,714,5,0,5
DKI JAKARTA,JAKARTA TIMUR,CIRACAS,RAMBUTAN,3175091005,2020-10-26,748,30,718,2,-2,4
DKI JAKARTA,JAKARTA TIMUR,CIRACAS,RAMBUTAN,3175091005,2020-10-27,752,25,727,4,-5,9
DKI JAKARTA,JAKARTA TIMUR,CIRACAS,RAMBUTAN,3175091005,2020-10-28,756,26,730,4,1,3
DKI JAKARTA,JAKARTA TIMUR,CIRACAS,RAMBUTAN,3175091005,2020-10-29,760,23,737,4,-3,7
DKI JAKARTA,JAKARTA TIMUR,CIRACAS,RAMBUTAN,3175091005,2020-10-30,763,23,740,3,0,3
DKI JAKARTA,JAKARTA TIMUR,CIRACAS,RAMBUTAN,3175091005,2020-10-31,766,25,741,3,2,1
DKI JAKARTA,JAKARTA TIMUR,CIRACAS,SUSUKAN,3175091004,2020-10-01,1023,29,994,0,0,0
DKI JAKARTA,JAKARTA TIMUR,CIRACAS,SUSUKAN,3175091004,2020-10-02,1037,35,1002,14,6,8
DKI JAKARTA,JAKARTA TIMUR,CIRACAS,SUSUKAN,3175091004,2020-10-03,1040,40,1000,3,5,-2
DKI JAKARTA,JAKARTA TIMUR,CIRACAS,SUSUKAN,3175091004,2020-10-04,1047,40,1007,7,0,7
DKI JAKARTA,JAKARTA TIMUR,CIRACAS,SUSUKAN,3175091004,2020-10-05,1047,38,1009,0,-2,2
DKI JAKARTA,JAKARTA TIMUR,CIRACAS,SUSUKAN,3175091004,2020-10-06,1073,35,1038,26,-3,29
DKI JAKARTA,JAKARTA TIMUR,CIRACAS,SUSUKAN,3175091004,2020-10-07,1086,37,1049,13,2,11
DKI JAKARTA,JAKARTA TIMUR,CIRACAS,SUSUKAN,3175091004,2020-10-08,1093,38,1055,7,1,6
DKI JAKARTA,JAKARTA TIMUR,CIRACAS,SUSUKAN,3175091004,2020-10-09,1100,42,1058,7,4,3
DKI JAKARTA,JAKARTA TIMUR,CIRACAS,SUSUKAN,3175091004,2020-10-10,1104,43,1061,4,1,3
DKI JAKARTA,JAKARTA TIMUR,CIRACAS,SUSUKAN,3175091004,2020-10-11,1201,46,1155,97,3,94
DKI JAKARTA,JAKARTA TIMUR,CIRACAS,SUSUKAN,3175091004,2020-10-12,1203,42,1161,2,-4,6
DKI JAKARTA,JAKARTA TIMUR,CIRACAS,SUSUKAN,3175091004,2020-10-13,1205,36,1169,2,-6,8
DKI JAKARTA,JAKARTA TIMUR,CIRACAS,SUSUKAN,3175091004,2020-10-14,1229,34,1195,24,-2,26
DKI JAKARTA,JAKARTA TIMUR,CIRACAS,SUSUKAN,3175091004,2020-10-15,1232,34,1198,3,0,3
DKI JAKARTA,JAKARTA TIMUR,CIRACAS,SUSUKAN,3175091004,2020-10-16,1233,32,1201,1,-2,3
DKI JAKARTA,JAKARTA TIMUR,CIRACAS,SUSUKAN,3175091004,2020-10-17,1245,41,1204,12,9,3
DKI JAKARTA,JAKARTA TIMUR,CIRACAS,SUSUKAN,3175091004,2020-10-18,1247,43,1204,2,2,0
DKI JAKARTA,JAKARTA TIMUR,CIRACAS,SUSUKAN,3175091004,2020-10-19,1251,42,1209,4,-1,5
DKI JAKARTA,JAKARTA TIMUR,CIRACAS,SUSUKAN,3175091004,2020-10-20,1263,49,1214,12,7,5
DKI JAKARTA,JAKARTA TIMUR,CIRACAS,SUSUKAN,3175091004,2020-10-21,1274,49,1225,11,0,11
DKI JAKARTA,JAKARTA TIMUR,CIRACAS,SUSUKAN,3175091004,2020-10-22,1294,43,1251,20,-6,26
DKI JAKARTA,JAKARTA TIMUR,CIRACAS,SUSUKAN,3175091004,2020-10-23,1306,55,1251,12,12,0
DKI JAKARTA,JAKARTA TIMUR,CIRACAS,SUSUKAN,3175091004,2020-10-24,1325,43,1282,19,-12,31
DKI JAKARTA,JAKARTA TIMUR,CIRACAS,SUSUKAN,3175091004,2020-10-25,1328,44,1284,3,1,2
DKI JAKARTA,JAKARTA TIMUR,CIRACAS,SUSUKAN,3175091004,2020-10-26,1334,39,1295,6,-5,11
DKI JAKARTA,JAKARTA TIMUR,CIRACAS,SUSUKAN,3175091004,2020-10-27,1338,38,1300,4,-1,5
DKI JAKARTA,JAKARTA TIMUR,CIRACAS,SUSUKAN,3175091004,2020-10-28,1340,39,1301,2,1,1
DKI JAKARTA,JAKARTA TIMUR,CIRACAS,SUSUKAN,3175091004,2020-10-29,1344,33,1311,4,-6,10
DKI JAKARTA,JAKARTA TIMUR,CIRACAS,SUSUKAN,3175091004,2020-10-30,1350,38,1312,6,5,1
DKI JAKARTA,JAKARTA TIMUR,CIRACAS,SUSUKAN,3175091004,2020-10-31,1351,39,1312,1,1,0
DKI JAKARTA,JAKARTA TIMUR,DUREN SAWIT,DUREN SAWIT,3175071001,2020-10-01,845,76,769,0,0,0
DKI JAKARTA,JAKARTA TIMUR,DUREN SAWIT,DUREN SAWIT,3175071001,2020-10-02,870,89,781,25,13,12
DKI JAKARTA,JAKARTA TIMUR,DUREN SAWIT,DUREN SAWIT,3175071001,2020-10-03,882,99,783,12,10,2
DKI JAKARTA,JAKARTA TIMUR,DUREN SAWIT,DUREN SAWIT,3175071001,2020-10-04,894,104,790,12,5,7
DKI JAKARTA,JAKARTA TIMUR,DUREN SAWIT,DUREN SAWIT,3175071001,2020-10-05,897,93,804,3,-11,14
DKI JAKARTA,JAKARTA TIMUR,DUREN SAWIT,DUREN SAWIT,3175071001,2020-10-06,901,83,818,4,-10,14
DKI JAKARTA,JAKARTA TIMUR,DUREN SAWIT,DUREN SAWIT,3175071001,2020-10-07,916,87,829,15,4,11
DKI JAKARTA,JAKARTA TIMUR,DUREN SAWIT,DUREN SAWIT,3175071001,2020-10-08,936,95,841,20,8,12
DKI JAKARTA,JAKARTA TIMUR,DUREN SAWIT,DUREN SAWIT,3175071001,2020-10-09,945,103,842,9,8,1
DKI JAKARTA,JAKARTA TIMUR,DUREN SAWIT,DUREN SAWIT,3175071001,2020-10-10,954,100,854,9,-3,12
DKI JAKARTA,JAKARTA TIMUR,DUREN SAWIT,DUREN SAWIT,3175071001,2020-10-11,963,103,860,9,3,6
DKI JAKARTA,JAKARTA TIMUR,DUREN SAWIT,DUREN SAWIT,3175071001,2020-10-12,977,97,880,14,-6,20
DKI JAKARTA,JAKARTA TIMUR,DUREN SAWIT,DUREN SAWIT,3175071001,2020-10-13,981,89,892,4,-8,12
DKI JAKARTA,JAKARTA TIMUR,DUREN SAWIT,DUREN SAWIT,3175071001,2020-10-14,983,81,902,2,-8,10
DKI JAKARTA,JAKARTA TIMUR,DUREN SAWIT,DUREN SAWIT,3175071001,2020-10-15,1004,84,920,21,3,18
DKI JAKARTA,JAKARTA TIMUR,DUREN SAWIT,DUREN SAWIT,3175071001,2020-10-16,1018,86,932,14,2,12
DKI JAKARTA,JAKARTA TIMUR,DUREN SAWIT,DUREN SAWIT,3175071001,2020-10-17,1041,101,940,23,15,8
DKI JAKARTA,JAKARTA TIMUR,DUREN SAWIT,DUREN SAWIT,3175071001,2020-10-18,1070,128,942,29,27,2
DKI JAKARTA,JAKARTA TIMUR,DUREN SAWIT,DUREN SAWIT,3175071001,2020-10-19,1075,112,963,5,-16,21
DKI JAKARTA,JAKARTA TIMUR,DUREN SAWIT,DUREN SAWIT,3175071001,2020-10-20,1079,109,970,4,-3,7
DKI JAKARTA,JAKARTA TIMUR,DUREN SAWIT,DUREN SAWIT,3175071001,2020-10-21,1100,105,995,21,-4,25
DKI JAKARTA,JAKARTA TIMUR,DUREN SAWIT,DUREN SAWIT,3175071001,2020-10-22,1102,93,1009,2,-12,14
DKI JAKARTA,JAKARTA TIMUR,DUREN SAWIT,DUREN SAWIT,3175071001,2020-10-23,1108,98,1010,6,5,1
DKI JAKARTA,JAKARTA TIMUR,DUREN SAWIT,DUREN SAWIT,3175071001,2020-10-24,1112,84,1028,4,-14,18
DKI JAKARTA,JAKARTA TIMUR,DUREN SAWIT,DUREN SAWIT,3175071001,2020-10-25,1122,89,1033,10,5,5
DKI JAKARTA,JAKARTA TIMUR,DUREN SAWIT,DUREN SAWIT,3175071001,2020-10-26,1137,85,1052,15,-4,19
DKI JAKARTA,JAKARTA TIMUR,DUREN SAWIT,DUREN SAWIT,3175071001,2020-10-27,1143,78,1065,6,-7,13
DKI JAKARTA,JAKARTA TIMUR,DUREN SAWIT,DUREN SAWIT,3175071001,2020-10-28,1145,67,1078,2,-11,13
DKI JAKARTA,JAKARTA TIMUR,DUREN SAWIT,DUREN SAWIT,3175071001,2020-10-29,1155,52,1103,10,-15,25
DKI JAKARTA,JAKARTA TIMUR,DUREN SAWIT,DUREN SAWIT,3175071001,2020-10-30,1176,58,1118,21,6,15
DKI JAKARTA,JAKARTA TIMUR,DUREN SAWIT,DUREN SAWIT,3175071001,2020-10-31,1186,62,1124,10,4,6
DKI JAKARTA,JAKARTA TIMUR,DUREN SAWIT,KLENDER,3175071003,2020-10-01,783,68,715,0,0,0
DKI JAKARTA,JAKARTA TIMUR,DUREN SAWIT,KLENDER,3175071003,2020-10-02,806,73,733,23,5,18
DKI JAKARTA,JAKARTA TIMUR,DUREN SAWIT,KLENDER,3175071003,2020-10-03,820,85,735,14,12,2
DKI JAKARTA,JAKARTA TIMUR,DUREN SAWIT,KLENDER,3175071003,2020-10-04,831,95,736,11,10,1
DKI JAKARTA,JAKARTA TIMUR,DUREN SAWIT,KLENDER,3175071003,2020-10-05,832,85,747,1,-10,11
DKI JAKARTA,JAKARTA TIMUR,DUREN SAWIT,KLENDER,3175071003,2020-10-06,838,84,754,6,-1,7
DKI JAKARTA,JAKARTA TIMUR,DUREN SAWIT,KLENDER,3175071003,2020-10-07,856,87,769,18,3,15
DKI JAKARTA,JAKARTA TIMUR,DUREN SAWIT,KLENDER,3175071003,2020-10-08,867,85,782,11,-2,13
DKI JAKARTA,JAKARTA TIMUR,DUREN SAWIT,KLENDER,3175071003,2020-10-09,877,95,782,10,10,0
DKI JAKARTA,JAKARTA TIMUR,DUREN SAWIT,KLENDER,3175071003,2020-10-10,896,104,792,19,9,10
DKI JAKARTA,JAKARTA TIMUR,DUREN SAWIT,KLENDER,3175071003,2020-10-11,912,102,810,16,-2,18
DKI JAKARTA,JAKARTA TIMUR,DUREN SAWIT,KLENDER,3175071003,2020-10-12,924,97,827,12,-5,17
DKI JAKARTA,JAKARTA TIMUR,DUREN SAWIT,KLENDER,3175071003,2020-10-13,931,89,842,7,-8,15
DKI JAKARTA,JAKARTA TIMUR,DUREN SAWIT,KLENDER,3175071003,2020-10-14,937,75,862,6,-14,20
DKI JAKARTA,JAKARTA TIMUR,DUREN SAWIT,KLENDER,3175071003,2020-10-15,955,78,877,18,3,15
DKI JAKARTA,JAKARTA TIMUR,DUREN SAWIT,KLENDER,3175071003,2020-10-16,964,76,888,9,-2,11
DKI JAKARTA,JAKARTA TIMUR,DUREN SAWIT,KLENDER,3175071003,2020-10-17,991,96,895,27,20,7
DKI JAKARTA,JAKARTA TIMUR,DUREN SAWIT,KLENDER,3175071003,2020-10-18,1018,121,897,27,25,2
DKI JAKARTA,JAKARTA TIMUR,DUREN SAWIT,KLENDER,3175071003,2020-10-19,1018,115,903,0,-6,6
DKI JAKARTA,JAKARTA TIMUR,DUREN SAWIT,KLENDER,3175071003,2020-10-20,1021,107,914,3,-8,11
DKI JAKARTA,JAKARTA TIMUR,DUREN SAWIT,KLENDER,3175071003,2020-10-21,1051,106,945,30,-1,31
DKI JAKARTA,JAKARTA TIMUR,DUREN SAWIT,KLENDER,3175071003,2020-10-22,1054,92,962,3,-14,17
DKI JAKARTA,JAKARTA TIMUR,DUREN SAWIT,KLENDER,3175071003,2020-10-23,1067,105,962,13,13,0
DKI JAKARTA,JAKARTA TIMUR,DUREN SAWIT,KLENDER,3175071003,2020-10-24,1071,83,988,4,-22,26
DKI JAKARTA,JAKARTA TIMUR,DUREN SAWIT,KLENDER,3175071003,2020-10-25,1076,85,991,5,2,3
DKI JAKARTA,JAKARTA TIMUR,DUREN SAWIT,KLENDER,3175071003,2020-10-26,1085,83,1002,9,-2,11
DKI JAKARTA,JAKARTA TIMUR,DUREN SAWIT,KLENDER,3175071003,2020-10-27,1089,76,1013,4,-7,11
DKI JAKARTA,JAKARTA TIMUR,DUREN SAWIT,KLENDER,3175071003,2020-10-28,1092,65,1027,3,-11,14
DKI JAKARTA,JAKARTA TIMUR,DUREN SAWIT,KLENDER,3175071003,2020-10-29,1099,47,1052,7,-18,25
DKI JAKARTA,JAKARTA TIMUR,DUREN SAWIT,KLENDER,3175071003,2020-10-30,1116,46,1070,17,-1,18
DKI JAKARTA,JAKARTA TIMUR,DUREN SAWIT,KLENDER,3175071003,2020-10-31,1134,59,1075,18,13,5
DKI JAKARTA,JAKARTA TIMUR,DUREN SAWIT,MALAKA JAYA,3175071006,2020-10-01,482,32,450,0,0,0
DKI JAKARTA,JAKARTA TIMUR,DUREN SAWIT,MALAKA JAYA,3175071006,2020-10-02,492,41,451,10,9,1
DKI JAKARTA,JAKARTA TIMUR,DUREN SAWIT,MALAKA JAYA,3175071006,2020-10-03,496,42,454,4,1,3
DKI JAKARTA,JAKARTA TIMUR,DUREN SAWIT,MALAKA JAYA,3175071006,2020-10-04,499,44,455,3,2,1
DKI JAKARTA,JAKARTA TIMUR,DUREN SAWIT,MALAKA JAYA,3175071006,2020-10-05,501,41,460,2,-3,5
DKI JAKARTA,JAKARTA TIMUR,DUREN SAWIT,MALAKA JAYA,3175071006,2020-10-06,503,36,467,2,-5,7
DKI JAKARTA,JAKARTA TIMUR,DUREN SAWIT,MALAKA JAYA,3175071006,2020-10-07,510,40,470,7,4,3
DKI JAKARTA,JAKARTA TIMUR,DUREN SAWIT,MALAKA JAYA,3175071006,2020-10-08,521,44,477,11,4,7
DKI JAKARTA,JAKARTA TIMUR,DUREN SAWIT,MALAKA JAYA,3175071006,2020-10-09,527,49,478,6,5,1
DKI JAKARTA,JAKARTA TIMUR,DUREN SAWIT,MALAKA JAYA,3175071006,2020-10-10,530,46,484,3,-3,6
DKI JAKARTA,JAKARTA TIMUR,DUREN SAWIT,MALAKA JAYA,3175071006,2020-10-11,533,46,487,3,0,3
DKI JAKARTA,JAKARTA TIMUR,DUREN SAWIT,MALAKA JAYA,3175071006,2020-10-12,536,43,493,3,-3,6
DKI JAKARTA,JAKARTA TIMUR,DUREN SAWIT,MALAKA JAYA,3175071006,2020-10-13,542,41,501,6,-2,8
DKI JAKARTA,JAKARTA TIMUR,DUREN SAWIT,MALAKA JAYA,3175071006,2020-10-14,552,40,512,10,-1,11
DKI JAKARTA,JAKARTA TIMUR,DUREN SAWIT,MALAKA JAYA,3175071006,2020-10-15,562,44,518,10,4,6
DKI JAKARTA,JAKARTA TIMUR,DUREN SAWIT,MALAKA JAYA,3175071006,2020-10-16,574,42,532,12,-2,14
DKI JAKARTA,JAKARTA TIMUR,DUREN SAWIT,MALAKA JAYA,3175071006,2020-10-17,581,48,533,7,6,1
DKI JAKARTA,JAKARTA TIMUR,DUREN SAWIT,MALAKA JAYA,3175071006,2020-10-18,594,60,534,13,12,1
DKI JAKARTA,JAKARTA TIMUR,DUREN SAWIT,MALAKA JAYA,3175071006,2020-10-19,597,54,543,3,-6,9
DKI JAKARTA,JAKARTA TIMUR,DUREN SAWIT,MALAKA JAYA,3175071006,2020-10-20,608,54,554,11,0,11
DKI JAKARTA,JAKARTA TIMUR,DUREN SAWIT,MALAKA JAYA,3175071006,2020-10-21,617,54,563,9,0,9
DKI JAKARTA,JAKARTA TIMUR,DUREN SAWIT,MALAKA JAYA,3175071006,2020-10-22,624,48,576,7,-6,13
DKI JAKARTA,JAKARTA TIMUR,DUREN SAWIT,MALAKA JAYA,3175071006,2020-10-23,624,48,576,0,0,0
DKI JAKARTA,JAKARTA TIMUR,DUREN SAWIT,MALAKA JAYA,3175071006,2020-10-24,629,44,585,5,-4,9
DKI JAKARTA,JAKARTA TIMUR,DUREN SAWIT,MALAKA JAYA,3175071006,2020-10-25,631,45,586,2,1,1
DKI JAKARTA,JAKARTA TIMUR,DUREN SAWIT,MALAKA JAYA,3175071006,2020-10-26,640,44,596,9,-1,10
DKI JAKARTA,JAKARTA TIMUR,DUREN SAWIT,MALAKA JAYA,3175071006,2020-10-27,645,41,604,5,-3,8
DKI JAKARTA,JAKARTA TIMUR,DUREN SAWIT,MALAKA JAYA,3175071006,2020-10-28,648,34,614,3,-7,10
DKI JAKARTA,JAKARTA TIMUR,DUREN SAWIT,MALAKA JAYA,3175071006,2020-10-29,658,25,633,10,-9,19
DKI JAKARTA,JAKARTA TIMUR,DUREN SAWIT,MALAKA JAYA,3175071006,2020-10-30,675,34,641,17,9,8
DKI JAKARTA,JAKARTA TIMUR,DUREN SAWIT,MALAKA JAYA,3175071006,2020-10-31,680,32,648,5,-2,7
DKI JAKARTA,JAKARTA TIMUR,DUREN SAWIT,MALAKA SARI,3175071005,2020-10-01,399,39,360,0,0,0
DKI JAKARTA,JAKARTA TIMUR,DUREN SAWIT,MALAKA SARI,3175071005,2020-10-02,407,41,366,8,2,6
DKI JAKARTA,JAKARTA TIMUR,DUREN SAWIT,MALAKA SARI,3175071005,2020-10-03,411,44,367,4,3,1
DKI JAKARTA,JAKARTA TIMUR,DUREN SAWIT,MALAKA SARI,3175071005,2020-10-04,419,50,369,8,6,2
DKI JAKARTA,JAKARTA TIMUR,DUREN SAWIT,MALAKA SARI,3175071005,2020-10-05,419,44,375,0,-6,6
DKI JAKARTA,JAKARTA TIMUR,DUREN SAWIT,MALAKA SARI,3175071005,2020-10-06,423,44,379,4,0,4
DKI JAKARTA,JAKARTA TIMUR,DUREN SAWIT,MALAKA SARI,3175071005,2020-10-07,437,46,391,14,2,12
DKI JAKARTA,JAKARTA TIMUR,DUREN SAWIT,MALAKA SARI,3175071005,2020-10-08,453,52,401,16,6,10
DKI JAKARTA,JAKARTA TIMUR,DUREN SAWIT,MALAKA SARI,3175071005,2020-10-09,461,57,404,8,5,3
DKI JAKARTA,JAKARTA TIMUR,DUREN SAWIT,MALAKA SARI,3175071005,2020-10-10,480,71,409,19,14,5
DKI JAKARTA,JAKARTA TIMUR,DUREN SAWIT,MALAKA SARI,3175071005,2020-10-11,481,71,410,1,0,1
DKI JAKARTA,JAKARTA TIMUR,DUREN SAWIT,MALAKA SARI,3175071005,2020-10-12,489,71,418,8,0,8
DKI JAKARTA,JAKARTA TIMUR,DUREN SAWIT,MALAKA SARI,3175071005,2020-10-13,495,68,427,6,-3,9
DKI JAKARTA,JAKARTA TIMUR,DUREN SAWIT,MALAKA SARI,3175071005,2020-10-14,495,62,433,0,-6,6
DKI JAKARTA,JAKARTA TIMUR,DUREN SAWIT,MALAKA SARI,3175071005,2020-10-15,512,69,443,17,7,10
DKI JAKARTA,JAKARTA TIMUR,DUREN SAWIT,MALAKA SARI,3175071005,2020-10-16,520,65,455,8,-4,12
DKI JAKARTA,JAKARTA TIMUR,DUREN SAWIT,MALAKA SARI,3175071005,2020-10-17,528,69,459,8,4,4
DKI JAKARTA,JAKARTA TIMUR,DUREN SAWIT,MALAKA SARI,3175071005,2020-10-18,539,79,460,11,10,1
DKI JAKARTA,JAKARTA TIMUR,DUREN SAWIT,MALAKA SARI,3175071005,2020-10-19,540,70,470,1,-9,10
DKI JAKARTA,JAKARTA TIMUR,DUREN SAWIT,MALAKA SARI,3175071005,2020-10-20,544,62,482,4,-8,12
DKI JAKARTA,JAKARTA TIMUR,DUREN SAWIT,MALAKA SARI,3175071005,2020-10-21,548,55,493,4,-7,11
DKI JAKARTA,JAKARTA TIMUR,DUREN SAWIT,MALAKA SARI,3175071005,2020-10-22,549,42,507,1,-13,14
DKI JAKARTA,JAKARTA TIMUR,DUREN SAWIT,MALAKA SARI,3175071005,2020-10-23,559,50,509,10,8,2
DKI JAKARTA,JAKARTA TIMUR,DUREN SAWIT,MALAKA SARI,3175071005,2020-10-24,561,41,520,2,-9,11
DKI JAKARTA,JAKARTA TIMUR,DUREN SAWIT,MALAKA SARI,3175071005,2020-10-25,563,41,522,2,0,2
DKI JAKARTA,JAKARTA TIMUR,DUREN SAWIT,MALAKA SARI,3175071005,2020-10-26,568,29,539,5,-12,17
DKI JAKARTA,JAKARTA TIMUR,DUREN SAWIT,MALAKA SARI,3175071005,2020-10-27,573,24,549,5,-5,10
DKI JAKARTA,JAKARTA TIMUR,DUREN SAWIT,MALAKA SARI,3175071005,2020-10-28,576,23,553,3,-1,4
DKI JAKARTA,JAKARTA TIMUR,DUREN SAWIT,MALAKA SARI,3175071005,2020-10-29,589,17,572,13,-6,19
DKI JAKARTA,JAKARTA TIMUR,DUREN SAWIT,MALAKA SARI,3175071005,2020-10-30,596,21,575,7,4,3
DKI JAKARTA,JAKARTA TIMUR,DUREN SAWIT,MALAKA SARI,3175071005,2020-10-31,601,23,578,5,2,3
DKI JAKARTA,JAKARTA TIMUR,DUREN SAWIT,PONDOK BAMBU,3175071002,2020-10-01,846,87,759,0,0,0
DKI JAKARTA,JAKARTA TIMUR,DUREN SAWIT,PONDOK BAMBU,3175071002,2020-10-02,873,98,775,27,11,16
DKI JAKARTA,JAKARTA TIMUR,DUREN SAWIT,PONDOK BAMBU,3175071002,2020-10-03,890,112,778,17,14,3
DKI JAKARTA,JAKARTA TIMUR,DUREN SAWIT,PONDOK BAMBU,3175071002,2020-10-04,901,120,781,11,8,3
DKI JAKARTA,JAKARTA TIMUR,DUREN SAWIT,PONDOK BAMBU,3175071002,2020-10-05,905,118,787,4,-2,6
DKI JAKARTA,JAKARTA TIMUR,DUREN SAWIT,PONDOK BAMBU,3175071002,2020-10-06,910,105,805,5,-13,18
DKI JAKARTA,JAKARTA TIMUR,DUREN SAWIT,PONDOK BAMBU,3175071002,2020-10-07,930,106,824,20,1,19
DKI JAKARTA,JAKARTA TIMUR,DUREN SAWIT,PONDOK BAMBU,3175071002,2020-10-08,947,112,835,17,6,11
DKI JAKARTA,JAKARTA TIMUR,DUREN SAWIT,PONDOK BAMBU,3175071002,2020-10-09,956,115,841,9,3,6
DKI JAKARTA,JAKARTA TIMUR,DUREN SAWIT,PONDOK BAMBU,3175071002,2020-10-10,976,117,859,20,2,18
DKI JAKARTA,JAKARTA TIMUR,DUREN SAWIT,PONDOK BAMBU,3175071002,2020-10-11,980,119,861,4,2,2
DKI JAKARTA,JAKARTA TIMUR,DUREN SAWIT,PONDOK BAMBU,3175071002,2020-10-12,994,119,875,14,0,14
DKI JAKARTA,JAKARTA TIMUR,DUREN SAWIT,PONDOK BAMBU,3175071002,2020-10-13,1001,111,890,7,-8,15
DKI JAKARTA,JAKARTA TIMUR,DUREN SAWIT,PONDOK BAMBU,3175071002,2020-10-14,1011,87,924,10,-24,34
DKI JAKARTA,JAKARTA TIMUR,DUREN SAWIT,PONDOK BAMBU,3175071002,2020-10-15,1026,81,945,15,-6,21
DKI JAKARTA,JAKARTA TIMUR,DUREN SAWIT,PONDOK BAMBU,3175071002,2020-10-16,1049,79,970,23,-2,25
DKI JAKARTA,JAKARTA TIMUR,DUREN SAWIT,PONDOK BAMBU,3175071002,2020-10-17,1076,102,974,27,23,4
DKI JAKARTA,JAKARTA TIMUR,DUREN SAWIT,PONDOK BAMBU,3175071002,2020-10-18,1101,126,975,25,24,1
DKI JAKARTA,JAKARTA TIMUR,DUREN SAWIT,PONDOK BAMBU,3175071002,2020-10-19,1104,118,986,3,-8,11
DKI JAKARTA,JAKARTA TIMUR,DUREN SAWIT,PONDOK BAMBU,3175071002,2020-10-20,1106,110,996,2,-8,10
DKI JAKARTA,JAKARTA TIMUR,DUREN SAWIT,PONDOK BAMBU,3175071002,2020-10-21,1117,109,1008,11,-1,12
DKI JAKARTA,JAKARTA TIMUR,DUREN SAWIT,PONDOK BAMBU,3175071002,2020-10-22,1126,96,1030,9,-13,22
DKI JAKARTA,JAKARTA TIMUR,DUREN SAWIT,PONDOK BAMBU,3175071002,2020-10-23,1139,105,1034,13,9,4
DKI JAKARTA,JAKARTA TIMUR,DUREN SAWIT,PONDOK BAMBU,3175071002,2020-10-24,1143,83,1060,4,-22,26
DKI JAKARTA,JAKARTA TIMUR,DUREN SAWIT,PONDOK BAMBU,3175071002,2020-10-25,1159,95,1064,16,12,4
DKI JAKARTA,JAKARTA TIMUR,DUREN SAWIT,PONDOK BAMBU,3175071002,2020-10-26,1169,88,1081,10,-7,17
DKI JAKARTA,JAKARTA TIMUR,DUREN SAWIT,PONDOK BAMBU,3175071002,2020-10-27,1173,84,1089,4,-4,8
DKI JAKARTA,JAKARTA TIMUR,DUREN SAWIT,PONDOK BAMBU,3175071002,2020-10-28,1174,74,1100,1,-10,11
DKI JAKARTA,JAKARTA TIMUR,DUREN SAWIT,PONDOK BAMBU,3175071002,2020-10-29,1192,66,1127,18,-8,27
DKI JAKARTA,JAKARTA TIMUR,DUREN SAWIT,PONDOK BAMBU,3175071002,2020-10-30,1231,75,1157,39,9,30
DKI JAKARTA,JAKARTA TIMUR,DUREN SAWIT,PONDOK BAMBU,3175071002,2020-10-31,1238,77,1162,7,2,5
DKI JAKARTA,JAKARTA TIMUR,DUREN SAWIT,PONDOK KELAPA,3175071004,2020-10-01,947,88,859,0,0,0
DKI JAKARTA,JAKARTA TIMUR,DUREN SAWIT,PONDOK KELAPA,3175071004,2020-10-02,983,112,871,36,24,12
DKI JAKARTA,JAKARTA TIMUR,DUREN SAWIT,PONDOK KELAPA,3175071004,2020-10-03,991,119,872,8,7,1
DKI JAKARTA,JAKARTA TIMUR,DUREN SAWIT,PONDOK KELAPA,3175071004,2020-10-04,1009,131,878,18,12,6
DKI JAKARTA,JAKARTA TIMUR,DUREN SAWIT,PONDOK KELAPA,3175071004,2020-10-05,1013,115,898,4,-16,20
DKI JAKARTA,JAKARTA TIMUR,DUREN SAWIT,PONDOK KELAPA,3175071004,2020-10-06,1019,105,914,6,-10,16
DKI JAKARTA,JAKARTA TIMUR,DUREN SAWIT,PONDOK KELAPA,3175071004,2020-10-07,1031,99,932,12,-6,18
DKI JAKARTA,JAKARTA TIMUR,DUREN SAWIT,PONDOK KELAPA,3175071004,2020-10-08,1052,102,950,21,3,18
DKI JAKARTA,JAKARTA TIMUR,DUREN SAWIT,PONDOK KELAPA,3175071004,2020-10-09,1063,113,950,11,11,0
DKI JAKARTA,JAKARTA TIMUR,DUREN SAWIT,PONDOK KELAPA,3175071004,2020-10-10,1074,109,965,11,-4,15
DKI JAKARTA,JAKARTA TIMUR,DUREN SAWIT,PONDOK KELAPA,3175071004,2020-10-11,1082,112,970,8,3,5
DKI JAKARTA,JAKARTA TIMUR,DUREN SAWIT,PONDOK KELAPA,3175071004,2020-10-12,1091,99,992,9,-13,22
DKI JAKARTA,JAKARTA TIMUR,DUREN SAWIT,PONDOK KELAPA,3175071004,2020-10-13,1098,87,1011,7,-12,19
DKI JAKARTA,JAKARTA TIMUR,DUREN SAWIT,PONDOK KELAPA,3175071004,2020-10-14,1100,78,1022,2,-9,11
DKI JAKARTA,JAKARTA TIMUR,DUREN SAWIT,PONDOK KELAPA,3175071004,2020-10-15,1121,88,1033,21,10,11
DKI JAKARTA,JAKARTA TIMUR,DUREN SAWIT,PONDOK KELAPA,3175071004,2020-10-16,1130,82,1048,9,-6,15
DKI JAKARTA,JAKARTA TIMUR,DUREN SAWIT,PONDOK KELAPA,3175071004,2020-10-17,1152,98,1054,22,16,6
DKI JAKARTA,JAKARTA TIMUR,DUREN SAWIT,PONDOK KELAPA,3175071004,2020-10-18,1177,121,1056,25,23,2
DKI JAKARTA,JAKARTA TIMUR,DUREN SAWIT,PONDOK KELAPA,3175071004,2020-10-19,1180,110,1070,3,-11,14
DKI JAKARTA,JAKARTA TIMUR,DUREN SAWIT,PONDOK KELAPA,3175071004,2020-10-20,1196,109,1087,16,-1,17
DKI JAKARTA,JAKARTA TIMUR,DUREN SAWIT,PONDOK KELAPA,3175071004,2020-10-21,1204,104,1100,8,-5,13
DKI JAKARTA,JAKARTA TIMUR,DUREN SAWIT,PONDOK KELAPA,3175071004,2020-10-22,1204,86,1118,0,-18,18
DKI JAKARTA,JAKARTA TIMUR,DUREN SAWIT,PONDOK KELAPA,3175071004,2020-10-23,1227,106,1121,23,20,3
DKI JAKARTA,JAKARTA TIMUR,DUREN SAWIT,PONDOK KELAPA,3175071004,2020-10-24,1231,83,1148,4,-23,27
DKI JAKARTA,JAKARTA TIMUR,DUREN SAWIT,PONDOK KELAPA,3175071004,2020-10-25,1247,94,1153,16,11,5
DKI JAKARTA,JAKARTA TIMUR,DUREN SAWIT,PONDOK KELAPA,3175071004,2020-10-26,1263,99,1164,16,5,11
DKI JAKARTA,JAKARTA TIMUR,DUREN SAWIT,PONDOK KELAPA,3175071004,2020-10-27,1272,90,1182,9,-9,18
DKI JAKARTA,JAKARTA TIMUR,DUREN SAWIT,PONDOK KELAPA,3175071004,2020-10-28,1273,78,1195,1,-12,13
DKI JAKARTA,JAKARTA TIMUR,DUREN SAWIT,PONDOK KELAPA,3175071004,2020-10-29,1293,55,1239,20,-23,44
DKI JAKARTA,JAKARTA TIMUR,DUREN SAWIT,PONDOK KELAPA,3175071004,2020-10-30,1326,80,1247,33,25,8
DKI JAKARTA,JAKARTA TIMUR,DUREN SAWIT,PONDOK KELAPA,3175071004,2020-10-31,1333,81,1253,7,1,6
DKI JAKARTA,JAKARTA TIMUR,DUREN SAWIT,PONDOK KOPI,3175071007,2020-10-01,343,19,324,0,0,0
DKI JAKARTA,JAKARTA TIMUR,DUREN SAWIT,PONDOK KOPI,3175071007,2020-10-02,353,22,331,10,3,7
DKI JAKARTA,JAKARTA TIMUR,DUREN SAWIT,PONDOK KOPI,3175071007,2020-10-03,353,24,329,0,2,-2
DKI JAKARTA,JAKARTA TIMUR,DUREN SAWIT,PONDOK KOPI,3175071007,2020-10-04,359,27,332,6,3,3
DKI JAKARTA,JAKARTA TIMUR,DUREN SAWIT,PONDOK KOPI,3175071007,2020-10-05,361,28,333,2,1,1
DKI JAKARTA,JAKARTA TIMUR,DUREN SAWIT,PONDOK KOPI,3175071007,2020-10-06,378,25,353,17,-3,20
DKI JAKARTA,JAKARTA TIMUR,DUREN SAWIT,PONDOK KOPI,3175071007,2020-10-07,412,24,388,34,-1,35
DKI JAKARTA,JAKARTA TIMUR,DUREN SAWIT,PONDOK KOPI,3175071007,2020-10-08,436,28,408,24,4,20
DKI JAKARTA,JAKARTA TIMUR,DUREN SAWIT,PONDOK KOPI,3175071007,2020-10-09,437,29,408,1,1,0
DKI JAKARTA,JAKARTA TIMUR,DUREN SAWIT,PONDOK KOPI,3175071007,2020-10-10,440,29,411,3,0,3
DKI JAKARTA,JAKARTA TIMUR,DUREN SAWIT,PONDOK KOPI,3175071007,2020-10-11,444,28,416,4,-1,5
DKI JAKARTA,JAKARTA TIMUR,DUREN SAWIT,PONDOK KOPI,3175071007,2020-10-12,446,28,418,2,0,2
DKI JAKARTA,JAKARTA TIMUR,DUREN SAWIT,PONDOK KOPI,3175071007,2020-10-13,455,28,427,9,0,9
DKI JAKARTA,JAKARTA TIMUR,DUREN SAWIT,PONDOK KOPI,3175071007,2020-10-14,458,25,433,3,-3,6
DKI JAKARTA,JAKARTA TIMUR,DUREN SAWIT,PONDOK KOPI,3175071007,2020-10-15,469,32,437,11,7,4
DKI JAKARTA,JAKARTA TIMUR,DUREN SAWIT,PONDOK KOPI,3175071007,2020-10-16,477,39,438,8,7,1
DKI JAKARTA,JAKARTA TIMUR,DUREN SAWIT,PONDOK KOPI,3175071007,2020-10-17,485,43,442,8,4,4
DKI JAKARTA,JAKARTA TIMUR,DUREN SAWIT,PONDOK KOPI,3175071007,2020-10-18,489,46,443,4,3,1
DKI JAKARTA,JAKARTA TIMUR,DUREN SAWIT,PONDOK KOPI,3175071007,2020-10-19,489,39,450,0,-7,7
DKI JAKARTA,JAKARTA TIMUR,DUREN SAWIT,PONDOK KOPI,3175071007,2020-10-20,492,38,454,3,-1,4
DKI JAKARTA,JAKARTA TIMUR,DUREN SAWIT,PONDOK KOPI,3175071007,2020-10-21,495,36,459,3,-2,5
DKI JAKARTA,JAKARTA TIMUR,DUREN SAWIT,PONDOK KOPI,3175071007,2020-10-22,498,35,463,3,-1,4
DKI JAKARTA,JAKARTA TIMUR,DUREN SAWIT,PONDOK KOPI,3175071007,2020-10-23,505,41,464,7,6,1
DKI JAKARTA,JAKARTA TIMUR,DUREN SAWIT,PONDOK KOPI,3175071007,2020-10-24,507,33,474,2,-8,10
DKI JAKARTA,JAKARTA TIMUR,DUREN SAWIT,PONDOK KOPI,3175071007,2020-10-25,514,36,478,7,3,4
DKI JAKARTA,JAKARTA TIMUR,DUREN SAWIT,PONDOK KOPI,3175071007,2020-10-26,518,26,492,4,-10,14
DKI JAKARTA,JAKARTA TIMUR,DUREN SAWIT,PONDOK KOPI,3175071007,2020-10-27,518,23,495,0,-3,3
DKI JAKARTA,JAKARTA TIMUR,DUREN SAWIT,PONDOK KOPI,3175071007,2020-10-28,518,19,499,0,-4,4
DKI JAKARTA,JAKARTA TIMUR,DUREN SAWIT,PONDOK KOPI,3175071007,2020-10-29,537,13,524,19,-6,25
DKI JAKARTA,JAKARTA TIMUR,DUREN SAWIT,PONDOK KOPI,3175071007,2020-10-30,540,15,525,3,2,1
DKI JAKARTA,JAKARTA TIMUR,DUREN SAWIT,PONDOK KOPI,3175071007,2020-10-31,549,21,528,9,6,3
DKI JAKARTA,JAKARTA TIMUR,JATINEGARA,BALI MESTER,3175031003,2020-10-01,92,12,80,0,0,0
DKI JAKARTA,JAKARTA TIMUR,JATINEGARA,BALI MESTER,3175031003,2020-10-02,97,13,84,5,1,4
DKI JAKARTA,JAKARTA TIMUR,JATINEGARA,BALI MESTER,3175031003,2020-10-03,100,15,85,3,2,1
DKI JAKARTA,JAKARTA TIMUR,JATINEGARA,BALI MESTER,3175031003,2020-10-04,101,16,85,1,1,0
DKI JAKARTA,JAKARTA TIMUR,JATINEGARA,BALI MESTER,3175031003,2020-10-05,101,14,87,0,-2,2
DKI JAKARTA,JAKARTA TIMUR,JATINEGARA,BALI MESTER,3175031003,2020-10-06,101,11,90,0,-3,3
DKI JAKARTA,JAKARTA TIMUR,JATINEGARA,BALI MESTER,3175031003,2020-10-07,106,16,90,5,5,0
DKI JAKARTA,JAKARTA TIMUR,JATINEGARA,BALI MESTER,3175031003,2020-10-08,108,17,91,2,1,1
DKI JAKARTA,JAKARTA TIMUR,JATINEGARA,BALI MESTER,3175031003,2020-10-09,108,17,91,0,0,0
DKI JAKARTA,JAKARTA TIMUR,JATINEGARA,BALI MESTER,3175031003,2020-10-10,110,17,93,2,0,2
DKI JAKARTA,JAKARTA TIMUR,JATINEGARA,BALI MESTER,3175031003,2020-10-11,110,17,93,0,0,0
DKI JAKARTA,JAKARTA TIMUR,JATINEGARA,BALI MESTER,3175031003,2020-10-12,111,17,94,1,0,1
DKI JAKARTA,JAKARTA TIMUR,JATINEGARA,BALI MESTER,3175031003,2020-10-13,112,14,98,1,-3,4
DKI JAKARTA,JAKARTA TIMUR,JATINEGARA,BALI MESTER,3175031003,2020-10-14,112,11,101,0,-3,3
DKI JAKARTA,JAKARTA TIMUR,JATINEGARA,BALI MESTER,3175031003,2020-10-15,113,8,105,1,-3,4
DKI JAKARTA,JAKARTA TIMUR,JATINEGARA,BALI MESTER,3175031003,2020-10-16,115,6,109,2,-2,4
DKI JAKARTA,JAKARTA TIMUR,JATINEGARA,BALI MESTER,3175031003,2020-10-17,117,8,109,2,2,0
DKI JAKARTA,JAKARTA TIMUR,JATINEGARA,BALI MESTER,3175031003,2020-10-18,120,10,110,3,2,1
DKI JAKARTA,JAKARTA TIMUR,JATINEGARA,BALI MESTER,3175031003,2020-10-19,120,8,112,0,-2,2
DKI JAKARTA,JAKARTA TIMUR,JATINEGARA,BALI MESTER,3175031003,2020-10-20,122,8,114,2,0,2
DKI JAKARTA,JAKARTA TIMUR,JATINEGARA,BALI MESTER,3175031003,2020-10-21,122,6,116,0,-2,2
DKI JAKARTA,JAKARTA TIMUR,JATINEGARA,BALI MESTER,3175031003,2020-10-22,122,6,116,0,0,0
DKI JAKARTA,JAKARTA TIMUR,JATINEGARA,BALI MESTER,3175031003,2020-10-23,123,7,116,1,1,0
DKI JAKARTA,JAKARTA TIMUR,JATINEGARA,BALI MESTER,3175031003,2020-10-24,126,7,119,3,0,3
DKI JAKARTA,JAKARTA TIMUR,JATINEGARA,BALI MESTER,3175031003,2020-10-25,126,6,120,0,-1,1
DKI JAKARTA,JAKARTA TIMUR,JATINEGARA,BALI MESTER,3175031003,2020-10-26,126,6,120,0,0,0
DKI JAKARTA,JAKARTA TIMUR,JATINEGARA,BALI MESTER,3175031003,2020-10-27,152,31,121,26,25,1
DKI JAKARTA,JAKARTA TIMUR,JATINEGARA,BALI MESTER,3175031003,2020-10-28,152,30,122,0,-1,1
DKI JAKARTA,JAKARTA TIMUR,JATINEGARA,BALI MESTER,3175031003,2020-10-29,152,29,123,0,-1,1
DKI JAKARTA,JAKARTA TIMUR,JATINEGARA,BALI MESTER,3175031003,2020-10-30,154,29,125,2,0,2
DKI JAKARTA,JAKARTA TIMUR,JATINEGARA,BALI MESTER,3175031003,2020-10-31,154,28,126,0,-1,1
DKI JAKARTA,JAKARTA TIMUR,JATINEGARA,BIDARA CINA,3175031002,2020-10-01,318,32,286,0,0,0
DKI JAKARTA,JAKARTA TIMUR,JATINEGARA,BIDARA CINA,3175031002,2020-10-02,335,45,290,17,13,4
DKI JAKARTA,JAKARTA TIMUR,JATINEGARA,BIDARA CINA,3175031002,2020-10-03,339,48,291,4,3,1
DKI JAKARTA,JAKARTA TIMUR,JATINEGARA,BIDARA CINA,3175031002,2020-10-04,342,49,293,3,1,2
DKI JAKARTA,JAKARTA TIMUR,JATINEGARA,BIDARA CINA,3175031002,2020-10-05,345,52,293,3,3,0
DKI JAKARTA,JAKARTA TIMUR,JATINEGARA,BIDARA CINA,3175031002,2020-10-06,350,49,301,5,-3,8
DKI JAKARTA,JAKARTA TIMUR,JATINEGARA,BIDARA CINA,3175031002,2020-10-07,365,49,316,15,0,15
DKI JAKARTA,JAKARTA TIMUR,JATINEGARA,BIDARA CINA,3175031002,2020-10-08,373,54,319,8,5,3
DKI JAKARTA,JAKARTA TIMUR,JATINEGARA,BIDARA CINA,3175031002,2020-10-09,376,57,319,3,3,0
DKI JAKARTA,JAKARTA TIMUR,JATINEGARA,BIDARA CINA,3175031002,2020-10-10,386,58,328,10,1,9
DKI JAKARTA,JAKARTA TIMUR,JATINEGARA,BIDARA CINA,3175031002,2020-10-11,386,58,328,0,0,0
DKI JAKARTA,JAKARTA TIMUR,JATINEGARA,BIDARA CINA,3175031002,2020-10-12,388,50,338,2,-8,10
DKI JAKARTA,JAKARTA TIMUR,JATINEGARA,BIDARA CINA,3175031002,2020-10-13,399,53,346,11,3,8
DKI JAKARTA,JAKARTA TIMUR,JATINEGARA,BIDARA CINA,3175031002,2020-10-14,421,55,366,22,2,20
DKI JAKARTA,JAKARTA TIMUR,JATINEGARA,BIDARA CINA,3175031002,2020-10-15,452,49,403,31,-6,37
DKI JAKARTA,JAKARTA TIMUR,JATINEGARA,BIDARA CINA,3175031002,2020-10-16,466,59,407,14,10,4
DKI JAKARTA,JAKARTA TIMUR,JATINEGARA,BIDARA CINA,3175031002,2020-10-17,483,70,413,17,11,6
DKI JAKARTA,JAKARTA TIMUR,JATINEGARA,BIDARA CINA,3175031002,2020-10-18,486,73,413,3,3,0
DKI JAKARTA,JAKARTA TIMUR,JATINEGARA,BIDARA CINA,3175031002,2020-10-19,488,68,420,2,-5,7
DKI JAKARTA,JAKARTA TIMUR,JATINEGARA,BIDARA CINA,3175031002,2020-10-20,503,76,427,15,8,7
DKI JAKARTA,JAKARTA TIMUR,JATINEGARA,BIDARA CINA,3175031002,2020-10-21,527,76,451,24,0,24
DKI JAKARTA,JAKARTA TIMUR,JATINEGARA,BIDARA CINA,3175031002,2020-10-22,536,79,457,9,3,6
DKI JAKARTA,JAKARTA TIMUR,JATINEGARA,BIDARA CINA,3175031002,2020-10-23,537,79,458,1,0,1
DKI JAKARTA,JAKARTA TIMUR,JATINEGARA,BIDARA CINA,3175031002,2020-10-24,550,83,467,13,4,9
DKI JAKARTA,JAKARTA TIMUR,JATINEGARA,BIDARA CINA,3175031002,2020-10-25,552,82,470,2,-1,3
DKI JAKARTA,JAKARTA TIMUR,JATINEGARA,BIDARA CINA,3175031002,2020-10-26,556,77,479,4,-5,9
DKI JAKARTA,JAKARTA TIMUR,JATINEGARA,BIDARA CINA,3175031002,2020-10-27,567,73,494,11,-4,15
DKI JAKARTA,JAKARTA TIMUR,JATINEGARA,BIDARA CINA,3175031002,2020-10-28,580,81,499,13,8,5
DKI JAKARTA,JAKARTA TIMUR,JATINEGARA,BIDARA CINA,3175031002,2020-10-29,584,70,514,4,-11,15
DKI JAKARTA,JAKARTA TIMUR,JATINEGARA,BIDARA CINA,3175031002,2020-10-30,591,75,516,7,5,2
DKI JAKARTA,JAKARTA TIMUR,JATINEGARA,BIDARA CINA,3175031002,2020-10-31,592,76,516,1,1,0
DKI JAKARTA,JAKARTA TIMUR,JATINEGARA,CIPINANG BESAR SELATAN,3175031007,2020-10-01,364,50,314,0,0,0
DKI JAKARTA,JAKARTA TIMUR,JATINEGARA,CIPINANG BESAR SELATAN,3175031007,2020-10-02,374,53,321,10,3,7
DKI JAKARTA,JAKARTA TIMUR,JATINEGARA,CIPINANG BESAR SELATAN,3175031007,2020-10-03,380,59,321,6,6,0
DKI JAKARTA,JAKARTA TIMUR,JATINEGARA,CIPINANG BESAR SELATAN,3175031007,2020-10-04,383,60,323,3,1,2
DKI JAKARTA,JAKARTA TIMUR,JATINEGARA,CIPINANG BESAR SELATAN,3175031007,2020-10-05,383,54,329,0,-6,6
DKI JAKARTA,JAKARTA TIMUR,JATINEGARA,CIPINANG BESAR SELATAN,3175031007,2020-10-06,386,49,337,3,-5,8
DKI JAKARTA,JAKARTA TIMUR,JATINEGARA,CIPINANG BESAR SELATAN,3175031007,2020-10-07,407,61,346,21,12,9
DKI JAKARTA,JAKARTA TIMUR,JATINEGARA,CIPINANG BESAR SELATAN,3175031007,2020-10-08,416,62,354,9,1,8
DKI JAKARTA,JAKARTA TIMUR,JATINEGARA,CIPINANG BESAR SELATAN,3175031007,2020-10-09,418,64,354,2,2,0
DKI JAKARTA,JAKARTA TIMUR,JATINEGARA,CIPINANG BESAR SELATAN,3175031007,2020-10-10,421,55,366,3,-9,12
DKI JAKARTA,JAKARTA TIMUR,JATINEGARA,CIPINANG BESAR SELATAN,3175031007,2020-10-11,424,57,367,3,2,1
DKI JAKARTA,JAKARTA TIMUR,JATINEGARA,CIPINANG BESAR SELATAN,3175031007,2020-10-12,427,48,379,3,-9,12
DKI JAKARTA,JAKARTA TIMUR,JATINEGARA,CIPINANG BESAR SELATAN,3175031007,2020-10-13,435,45,390,8,-3,11
DKI JAKARTA,JAKARTA TIMUR,JATINEGARA,CIPINANG BESAR SELATAN,3175031007,2020-10-14,435,38,397,0,-7,7
DKI JAKARTA,JAKARTA TIMUR,JATINEGARA,CIPINANG BESAR SELATAN,3175031007,2020-10-15,441,33,408,6,-5,11
DKI JAKARTA,JAKARTA TIMUR,JATINEGARA,CIPINANG BESAR SELATAN,3175031007,2020-10-16,451,37,414,10,4,6
DKI JAKARTA,JAKARTA TIMUR,JATINEGARA,CIPINANG BESAR SELATAN,3175031007,2020-10-17,470,55,415,19,18,1
DKI JAKARTA,JAKARTA TIMUR,JATINEGARA,CIPINANG BESAR SELATAN,3175031007,2020-10-18,474,59,415,4,4,0
DKI JAKARTA,JAKARTA TIMUR,JATINEGARA,CIPINANG BESAR SELATAN,3175031007,2020-10-19,475,55,420,1,-4,5
DKI JAKARTA,JAKARTA TIMUR,JATINEGARA,CIPINANG BESAR SELATAN,3175031007,2020-10-20,521,91,430,46,36,10
DKI JAKARTA,JAKARTA TIMUR,JATINEGARA,CIPINANG BESAR SELATAN,3175031007,2020-10-21,523,86,437,2,-5,7
DKI JAKARTA,JAKARTA TIMUR,JATINEGARA,CIPINANG BESAR SELATAN,3175031007,2020-10-22,529,84,445,6,-2,8
DKI JAKARTA,JAKARTA TIMUR,JATINEGARA,CIPINANG BESAR SELATAN,3175031007,2020-10-23,535,88,447,6,4,2
DKI JAKARTA,JAKARTA TIMUR,JATINEGARA,CIPINANG BESAR SELATAN,3175031007,2020-10-24,542,84,458,7,-4,11
DKI JAKARTA,JAKARTA TIMUR,JATINEGARA,CIPINANG BESAR SELATAN,3175031007,2020-10-25,552,93,459,10,9,1
DKI JAKARTA,JAKARTA TIMUR,JATINEGARA,CIPINANG BESAR SELATAN,3175031007,2020-10-26,553,93,460,1,0,1
DKI JAKARTA,JAKARTA TIMUR,JATINEGARA,CIPINANG BESAR SELATAN,3175031007,2020-10-27,563,95,468,10,2,8
DKI JAKARTA,JAKARTA TIMUR,JATINEGARA,CIPINANG BESAR SELATAN,3175031007,2020-10-28,563,91,472,0,-4,4
DKI JAKARTA,JAKARTA TIMUR,JATINEGARA,CIPINANG BESAR SELATAN,3175031007,2020-10-29,576,60,516,13,-31,44
DKI JAKARTA,JAKARTA TIMUR,JATINEGARA,CIPINANG BESAR SELATAN,3175031007,2020-10-30,614,85,529,38,25,13
DKI JAKARTA,JAKARTA TIMUR,JATINEGARA,CIPINANG BESAR SELATAN,3175031007,2020-10-31,617,87,530,3,2,1
DKI JAKARTA,JAKARTA TIMUR,JATINEGARA,CIPINANG BESAR UTARA,3175031008,2020-10-01,496,41,455,0,0,0
DKI JAKARTA,JAKARTA TIMUR,JATINEGARA,CIPINANG BESAR UTARA,3175031008,2020-10-02,519,58,461,23,17,6
DKI JAKARTA,JAKARTA TIMUR,JATINEGARA,CIPINANG BESAR UTARA,3175031008,2020-10-03,524,62,462,5,4,1
DKI JAKARTA,JAKARTA TIMUR,JATINEGARA,CIPINANG BESAR UTARA,3175031008,2020-10-04,525,63,462,1,1,0
DKI JAKARTA,JAKARTA TIMUR,JATINEGARA,CIPINANG BESAR UTARA,3175031008,2020-10-05,530,62,468,5,-1,6
DKI JAKARTA,JAKARTA TIMUR,JATINEGARA,CIPINANG BESAR UTARA,3175031008,2020-10-06,531,61,470,1,-1,2
DKI JAKARTA,JAKARTA TIMUR,JATINEGARA,CIPINANG BESAR UTARA,3175031008,2020-10-07,555,74,481,24,13,11
DKI JAKARTA,JAKARTA TIMUR,JATINEGARA,CIPINANG BESAR UTARA,3175031008,2020-10-08,567,80,487,12,6,6
DKI JAKARTA,JAKARTA TIMUR,JATINEGARA,CIPINANG BESAR UTARA,3175031008,2020-10-09,574,86,488,7,6,1
DKI JAKARTA,JAKARTA TIMUR,JATINEGARA,CIPINANG BESAR UTARA,3175031008,2020-10-10,596,103,493,22,17,5
DKI JAKARTA,JAKARTA TIMUR,JATINEGARA,CIPINANG BESAR UTARA,3175031008,2020-10-11,596,101,495,0,-2,2
DKI JAKARTA,JAKARTA TIMUR,JATINEGARA,CIPINANG BESAR UTARA,3175031008,2020-10-12,602,91,511,6,-10,16
DKI JAKARTA,JAKARTA TIMUR,JATINEGARA,CIPINANG BESAR UTARA,3175031008,2020-10-13,603,71,532,1,-20,21
DKI JAKARTA,JAKARTA TIMUR,JATINEGARA,CIPINANG BESAR UTARA,3175031008,2020-10-14,606,62,544,3,-9,12
DKI JAKARTA,JAKARTA TIMUR,JATINEGARA,CIPINANG BESAR UTARA,3175031008,2020-10-15,625,68,557,19,6,13
DKI JAKARTA,JAKARTA TIMUR,JATINEGARA,CIPINANG BESAR UTARA,3175031008,2020-10-16,646,82,564,21,14,7
DKI JAKARTA,JAKARTA TIMUR,JATINEGARA,CIPINANG BESAR UTARA,3175031008,2020-10-17,699,128,571,53,46,7
DKI JAKARTA,JAKARTA TIMUR,JATINEGARA,CIPINANG BESAR UTARA,3175031008,2020-10-18,714,137,577,15,9,6
DKI JAKARTA,JAKARTA TIMUR,JATINEGARA,CIPINANG BESAR UTARA,3175031008,2020-10-19,717,133,584,3,-4,7
DKI JAKARTA,JAKARTA TIMUR,JATINEGARA,CIPINANG BESAR UTARA,3175031008,2020-10-20,827,232,595,110,99,11
DKI JAKARTA,JAKARTA TIMUR,JATINEGARA,CIPINANG BESAR UTARA,3175031008,2020-10-21,854,232,622,27,0,27
DKI JAKARTA,JAKARTA TIMUR,JATINEGARA,CIPINANG BESAR UTARA,3175031008,2020-10-22,855,228,627,1,-4,5
DKI JAKARTA,JAKARTA TIMUR,JATINEGARA,CIPINANG BESAR UTARA,3175031008,2020-10-23,857,230,627,2,2,0
DKI JAKARTA,JAKARTA TIMUR,JATINEGARA,CIPINANG BESAR UTARA,3175031008,2020-10-24,863,226,637,6,-4,10
DKI JAKARTA,JAKARTA TIMUR,JATINEGARA,CIPINANG BESAR UTARA,3175031008,2020-10-25,874,231,643,11,5,6
DKI JAKARTA,JAKARTA TIMUR,JATINEGARA,CIPINANG BESAR UTARA,3175031008,2020-10-26,876,223,653,2,-8,10
DKI JAKARTA,JAKARTA TIMUR,JATINEGARA,CIPINANG BESAR UTARA,3175031008,2020-10-27,888,223,665,12,0,12
DKI JAKARTA,JAKARTA TIMUR,JATINEGARA,CIPINANG BESAR UTARA,3175031008,2020-10-28,892,202,690,4,-21,25
DKI JAKARTA,JAKARTA TIMUR,JATINEGARA,CIPINANG BESAR UTARA,3175031008,2020-10-29,896,187,709,4,-15,19
DKI JAKARTA,JAKARTA TIMUR,JATINEGARA,CIPINANG BESAR UTARA,3175031008,2020-10-30,907,183,724,11,-4,15
DKI JAKARTA,JAKARTA TIMUR,JATINEGARA,CIPINANG BESAR UTARA,3175031008,2020-10-31,914,189,725,7,6,1
DKI JAKARTA,JAKARTA TIMUR,JATINEGARA,CIPINANG CEMPEDAK,3175031005,2020-10-01,351,45,306,0,0,0
DKI JAKARTA,JAKARTA TIMUR,JATINEGARA,CIPINANG CEMPEDAK,3175031005,2020-10-02,359,51,308,8,6,2
DKI JAKARTA,JAKARTA TIMUR,JATINEGARA,CIPINANG CEMPEDAK,3175031005,2020-10-03,364,55,309,5,4,1
DKI JAKARTA,JAKARTA TIMUR,JATINEGARA,CIPINANG CEMPEDAK,3175031005,2020-10-04,367,58,309,3,3,0
DKI JAKARTA,JAKARTA TIMUR,JATINEGARA,CIPINANG CEMPEDAK,3175031005,2020-10-05,368,48,320,1,-10,11
DKI JAKARTA,JAKARTA TIMUR,JATINEGARA,CIPINANG CEMPEDAK,3175031005,2020-10-06,374,46,328,6,-2,8
DKI JAKARTA,JAKARTA TIMUR,JATINEGARA,CIPINANG CEMPEDAK,3175031005,2020-10-07,378,42,336,4,-4,8
DKI JAKARTA,JAKARTA TIMUR,JATINEGARA,CIPINANG CEMPEDAK,3175031005,2020-10-08,385,47,338,7,5,2
DKI JAKARTA,JAKARTA TIMUR,JATINEGARA,CIPINANG CEMPEDAK,3175031005,2020-10-09,387,48,339,2,1,1
DKI JAKARTA,JAKARTA TIMUR,JATINEGARA,CIPINANG CEMPEDAK,3175031005,2020-10-10,393,51,342,6,3,3
DKI JAKARTA,JAKARTA TIMUR,JATINEGARA,CIPINANG CEMPEDAK,3175031005,2020-10-11,403,60,343,10,9,1
DKI JAKARTA,JAKARTA TIMUR,JATINEGARA,CIPINANG CEMPEDAK,3175031005,2020-10-12,408,53,355,5,-7,12
DKI JAKARTA,JAKARTA TIMUR,JATINEGARA,CIPINANG CEMPEDAK,3175031005,2020-10-13,415,52,363,7,-1,8
DKI JAKARTA,JAKARTA TIMUR,JATINEGARA,CIPINANG CEMPEDAK,3175031005,2020-10-14,431,58,373,16,6,10
DKI JAKARTA,JAKARTA TIMUR,JATINEGARA,CIPINANG CEMPEDAK,3175031005,2020-10-15,446,65,381,15,7,8
DKI JAKARTA,JAKARTA TIMUR,JATINEGARA,CIPINANG CEMPEDAK,3175031005,2020-10-16,452,65,387,6,0,6
DKI JAKARTA,JAKARTA TIMUR,JATINEGARA,CIPINANG CEMPEDAK,3175031005,2020-10-17,473,84,389,21,19,2
DKI JAKARTA,JAKARTA TIMUR,JATINEGARA,CIPINANG CEMPEDAK,3175031005,2020-10-18,479,88,391,6,4,2
DKI JAKARTA,JAKARTA TIMUR,JATINEGARA,CIPINANG CEMPEDAK,3175031005,2020-10-19,480,84,396,1,-4,5
DKI JAKARTA,JAKARTA TIMUR,JATINEGARA,CIPINANG CEMPEDAK,3175031005,2020-10-20,499,99,400,19,15,4
DKI JAKARTA,JAKARTA TIMUR,JATINEGARA,CIPINANG CEMPEDAK,3175031005,2020-10-21,499,91,408,0,-8,8
DKI JAKARTA,JAKARTA TIMUR,JATINEGARA,CIPINANG CEMPEDAK,3175031005,2020-10-22,502,88,414,3,-3,6
DKI JAKARTA,JAKARTA TIMUR,JATINEGARA,CIPINANG CEMPEDAK,3175031005,2020-10-23,504,89,415,2,1,1
DKI JAKARTA,JAKARTA TIMUR,JATINEGARA,CIPINANG CEMPEDAK,3175031005,2020-10-24,507,82,425,3,-7,10
DKI JAKARTA,JAKARTA TIMUR,JATINEGARA,CIPINANG CEMPEDAK,3175031005,2020-10-25,515,88,427,8,6,2
DKI JAKARTA,JAKARTA TIMUR,JATINEGARA,CIPINANG CEMPEDAK,3175031005,2020-10-26,520,84,436,5,-4,9
DKI JAKARTA,JAKARTA TIMUR,JATINEGARA,CIPINANG CEMPEDAK,3175031005,2020-10-27,535,95,440,15,11,4
DKI JAKARTA,JAKARTA TIMUR,JATINEGARA,CIPINANG CEMPEDAK,3175031005,2020-10-28,536,93,443,1,-2,3
DKI JAKARTA,JAKARTA TIMUR,JATINEGARA,CIPINANG CEMPEDAK,3175031005,2020-10-29,538,66,473,2,-27,30
DKI JAKARTA,JAKARTA TIMUR,JATINEGARA,CIPINANG CEMPEDAK,3175031005,2020-10-30,542,63,480,4,-3,7
DKI JAKARTA,JAKARTA TIMUR,JATINEGARA,CIPINANG CEMPEDAK,3175031005,2020-10-31,544,65,480,2,2,0
DKI JAKARTA,JAKARTA TIMUR,JATINEGARA,CIPINANG MUARA,3175031006,2020-10-01,646,64,582,0,0,0
DKI JAKARTA,JAKARTA TIMUR,JATINEGARA,CIPINANG MUARA,3175031006,2020-10-02,662,56,606,16,-8,24
DKI JAKARTA,JAKARTA TIMUR,JATINEGARA,CIPINANG MUARA,3175031006,2020-10-03,671,65,606,9,9,0
DKI JAKARTA,JAKARTA TIMUR,JATINEGARA,CIPINANG MUARA,3175031006,2020-10-04,678,70,608,7,5,2
DKI JAKARTA,JAKARTA TIMUR,JATINEGARA,CIPINANG MUARA,3175031006,2020-10-05,685,69,616,7,-1,8
DKI JAKARTA,JAKARTA TIMUR,JATINEGARA,CIPINANG MUARA,3175031006,2020-10-06,691,69,622,6,0,6
DKI JAKARTA,JAKARTA TIMUR,JATINEGARA,CIPINANG MUARA,3175031006,2020-10-07,705,78,627,14,9,5
DKI JAKARTA,JAKARTA TIMUR,JATINEGARA,CIPINANG MUARA,3175031006,2020-10-08,729,93,636,24,15,9
DKI JAKARTA,JAKARTA TIMUR,JATINEGARA,CIPINANG MUARA,3175031006,2020-10-09,741,102,639,12,9,3
DKI JAKARTA,JAKARTA TIMUR,JATINEGARA,CIPINANG MUARA,3175031006,2020-10-10,755,102,653,14,0,14
DKI JAKARTA,JAKARTA TIMUR,JATINEGARA,CIPINANG MUARA,3175031006,2020-10-11,775,112,663,20,10,10
DKI JAKARTA,JAKARTA TIMUR,JATINEGARA,CIPINANG MUARA,3175031006,2020-10-12,778,91,687,3,-21,24
DKI JAKARTA,JAKARTA TIMUR,JATINEGARA,CIPINANG MUARA,3175031006,2020-10-13,785,80,705,7,-11,18
DKI JAKARTA,JAKARTA TIMUR,JATINEGARA,CIPINANG MUARA,3175031006,2020-10-14,813,89,724,28,9,19
DKI JAKARTA,JAKARTA TIMUR,JATINEGARA,CIPINANG MUARA,3175031006,2020-10-15,824,87,737,11,-2,13
DKI JAKARTA,JAKARTA TIMUR,JATINEGARA,CIPINANG MUARA,3175031006,2020-10-16,835,89,746,11,2,9
DKI JAKARTA,JAKARTA TIMUR,JATINEGARA,CIPINANG MUARA,3175031006,2020-10-17,849,101,748,14,12,2
DKI JAKARTA,JAKARTA TIMUR,JATINEGARA,CIPINANG MUARA,3175031006,2020-10-18,850,101,749,1,0,1
DKI JAKARTA,JAKARTA TIMUR,JATINEGARA,CIPINANG MUARA,3175031006,2020-10-19,851,89,762,1,-12,13
DKI JAKARTA,JAKARTA TIMUR,JATINEGARA,CIPINANG MUARA,3175031006,2020-10-20,885,94,791,34,5,29
DKI JAKARTA,JAKARTA TIMUR,JATINEGARA,CIPINANG MUARA,3175031006,2020-10-21,899,95,804,14,1,13
DKI JAKARTA,JAKARTA TIMUR,JATINEGARA,CIPINANG MUARA,3175031006,2020-10-22,927,106,821,28,11,17
DKI JAKARTA,JAKARTA TIMUR,JATINEGARA,CIPINANG MUARA,3175031006,2020-10-23,936,114,822,9,8,1
DKI JAKARTA,JAKARTA TIMUR,JATINEGARA,CIPINANG MUARA,3175031006,2020-10-24,950,109,841,14,-5,19
DKI JAKARTA,JAKARTA TIMUR,JATINEGARA,CIPINANG MUARA,3175031006,2020-10-25,953,110,843,3,1,2
DKI JAKARTA,JAKARTA TIMUR,JATINEGARA,CIPINANG MUARA,3175031006,2020-10-26,956,101,855,3,-9,12
DKI JAKARTA,JAKARTA TIMUR,JATINEGARA,CIPINANG MUARA,3175031006,2020-10-27,965,97,868,9,-4,13
DKI JAKARTA,JAKARTA TIMUR,JATINEGARA,CIPINANG MUARA,3175031006,2020-10-28,967,85,882,2,-12,14
DKI JAKARTA,JAKARTA TIMUR,JATINEGARA,CIPINANG MUARA,3175031006,2020-10-29,974,81,894,7,-4,12
DKI JAKARTA,JAKARTA TIMUR,JATINEGARA,CIPINANG MUARA,3175031006,2020-10-30,981,78,904,7,-3,10
DKI JAKARTA,JAKARTA TIMUR,JATINEGARA,CIPINANG MUARA,3175031006,2020-10-31,985,79,907,4,1,3
DKI JAKARTA,JAKARTA TIMUR,JATINEGARA,KAMPUNG MELAYU,3175031001,2020-10-01,214,36,178,0,0,0
DKI JAKARTA,JAKARTA TIMUR,JATINEGARA,KAMPUNG MELAYU,3175031001,2020-10-02,227,46,181,13,10,3
DKI JAKARTA,JAKARTA TIMUR,JATINEGARA,KAMPUNG MELAYU,3175031001,2020-10-03,227,45,182,0,-1,1
DKI JAKARTA,JAKARTA TIMUR,JATINEGARA,KAMPUNG MELAYU,3175031001,2020-10-04,228,45,183,1,0,1
DKI JAKARTA,JAKARTA TIMUR,JATINEGARA,KAMPUNG MELAYU,3175031001,2020-10-05,231,46,185,3,1,2
DKI JAKARTA,JAKARTA TIMUR,JATINEGARA,KAMPUNG MELAYU,3175031001,2020-10-06,231,43,188,0,-3,3
DKI JAKARTA,JAKARTA TIMUR,JATINEGARA,KAMPUNG MELAYU,3175031001,2020-10-07,245,43,202,14,0,14
DKI JAKARTA,JAKARTA TIMUR,JATINEGARA,KAMPUNG MELAYU,3175031001,2020-10-08,262,52,210,17,9,8
DKI JAKARTA,JAKARTA TIMUR,JATINEGARA,KAMPUNG MELAYU,3175031001,2020-10-09,266,55,211,4,3,1
DKI JAKARTA,JAKARTA TIMUR,JATINEGARA,KAMPUNG MELAYU,3175031001,2020-10-10,267,47,220,1,-8,9
DKI JAKARTA,JAKARTA TIMUR,JATINEGARA,KAMPUNG MELAYU,3175031001,2020-10-11,269,49,220,2,2,0
DKI JAKARTA,JAKARTA TIMUR,JATINEGARA,KAMPUNG MELAYU,3175031001,2020-10-12,273,45,228,4,-4,8
DKI JAKARTA,JAKARTA TIMUR,JATINEGARA,KAMPUNG MELAYU,3175031001,2020-10-13,281,50,231,8,5,3
DKI JAKARTA,JAKARTA TIMUR,JATINEGARA,KAMPUNG MELAYU,3175031001,2020-10-14,281,47,234,0,-3,3
DKI JAKARTA,JAKARTA TIMUR,JATINEGARA,KAMPUNG MELAYU,3175031001,2020-10-15,290,53,237,9,6,3
DKI JAKARTA,JAKARTA TIMUR,JATINEGARA,KAMPUNG MELAYU,3175031001,2020-10-16,297,45,252,7,-8,15
DKI JAKARTA,JAKARTA TIMUR,JATINEGARA,KAMPUNG MELAYU,3175031001,2020-10-17,305,53,252,8,8,0
DKI JAKARTA,JAKARTA TIMUR,JATINEGARA,KAMPUNG MELAYU,3175031001,2020-10-18,308,55,253,3,2,1
DKI JAKARTA,JAKARTA TIMUR,JATINEGARA,KAMPUNG MELAYU,3175031001,2020-10-19,309,49,260,1,-6,7
DKI JAKARTA,JAKARTA TIMUR,JATINEGARA,KAMPUNG MELAYU,3175031001,2020-10-20,314,47,267,5,-2,7
DKI JAKARTA,JAKARTA TIMUR,JATINEGARA,KAMPUNG MELAYU,3175031001,2020-10-21,324,55,269,10,8,2
DKI JAKARTA,JAKARTA TIMUR,JATINEGARA,KAMPUNG MELAYU,3175031001,2020-10-22,333,54,279,9,-1,10
DKI JAKARTA,JAKARTA TIMUR,JATINEGARA,KAMPUNG MELAYU,3175031001,2020-10-23,334,55,279,1,1,0
DKI JAKARTA,JAKARTA TIMUR,JATINEGARA,KAMPUNG MELAYU,3175031001,2020-10-24,338,55,283,4,0,4
DKI JAKARTA,JAKARTA TIMUR,JATINEGARA,KAMPUNG MELAYU,3175031001,2020-10-25,343,52,291,5,-3,8
DKI JAKARTA,JAKARTA TIMUR,JATINEGARA,KAMPUNG MELAYU,3175031001,2020-10-26,344,42,302,1,-10,11
DKI JAKARTA,JAKARTA TIMUR,JATINEGARA,KAMPUNG MELAYU,3175031001,2020-10-27,348,39,309,4,-3,7
DKI JAKARTA,JAKARTA TIMUR,JATINEGARA,KAMPUNG MELAYU,3175031001,2020-10-28,348,36,312,0,-3,3
DKI JAKARTA,JAKARTA TIMUR,JATINEGARA,KAMPUNG MELAYU,3175031001,2020-10-29,350,35,315,2,-1,3
DKI JAKARTA,JAKARTA TIMUR,JATINEGARA,KAMPUNG MELAYU,3175031001,2020-10-30,353,34,319,3,-1,4
DKI JAKARTA,JAKARTA TIMUR,JATINEGARA,KAMPUNG MELAYU,3175031001,2020-10-31,356,35,321,3,1,2
DKI JAKARTA,JAKARTA TIMUR,JATINEGARA,RAWA BUNGA,3175031004,2020-10-01,176,14,162,0,0,0
DKI JAKARTA,JAKARTA TIMUR,JATINEGARA,RAWA BUNGA,3175031004,2020-10-02,181,19,162,5,5,0
DKI JAKARTA,JAKARTA TIMUR,JATINEGARA,RAWA BUNGA,3175031004,2020-10-03,182,20,162,1,1,0
DKI JAKARTA,JAKARTA TIMUR,JATINEGARA,RAWA BUNGA,3175031004,2020-10-04,185,22,163,3,2,1
DKI JAKARTA,JAKARTA TIMUR,JATINEGARA,RAWA BUNGA,3175031004,2020-10-05,185,20,165,0,-2,2
DKI JAKARTA,JAKARTA TIMUR,JATINEGARA,RAWA BUNGA,3175031004,2020-10-06,188,17,171,3,-3,6
DKI JAKARTA,JAKARTA TIMUR,JATINEGARA,RAWA BUNGA,3175031004,2020-10-07,205,30,175,17,13,4
DKI JAKARTA,JAKARTA TIMUR,JATINEGARA,RAWA BUNGA,3175031004,2020-10-08,211,33,178,6,3,3
DKI JAKARTA,JAKARTA TIMUR,JATINEGARA,RAWA BUNGA,3175031004,2020-10-09,212,33,179,1,0,1
DKI JAKARTA,JAKARTA TIMUR,JATINEGARA,RAWA BUNGA,3175031004,2020-10-10,220,37,183,8,4,4
DKI JAKARTA,JAKARTA TIMUR,JATINEGARA,RAWA BUNGA,3175031004,2020-10-11,220,37,183,0,0,0
DKI JAKARTA,JAKARTA TIMUR,JATINEGARA,RAWA BUNGA,3175031004,2020-10-12,223,37,186,3,0,3
DKI JAKARTA,JAKARTA TIMUR,JATINEGARA,RAWA BUNGA,3175031004,2020-10-13,224,34,190,1,-3,4
DKI JAKARTA,JAKARTA TIMUR,JATINEGARA,RAWA BUNGA,3175031004,2020-10-14,224,33,191,0,-1,1
DKI JAKARTA,JAKARTA TIMUR,JATINEGARA,RAWA BUNGA,3175031004,2020-10-15,227,28,199,3,-5,8
DKI JAKARTA,JAKARTA TIMUR,JATINEGARA,RAWA BUNGA,3175031004,2020-10-16,238,33,205,11,5,6
DKI JAKARTA,JAKARTA TIMUR,JATINEGARA,RAWA BUNGA,3175031004,2020-10-17,240,34,206,2,1,1
DKI JAKARTA,JAKARTA TIMUR,JATINEGARA,RAWA BUNGA,3175031004,2020-10-18,250,44,206,10,10,0
DKI JAKARTA,JAKARTA TIMUR,JATINEGARA,RAWA BUNGA,3175031004,2020-10-19,250,38,212,0,-6,6
DKI JAKARTA,JAKARTA TIMUR,JATINEGARA,RAWA BUNGA,3175031004,2020-10-20,254,36,218,4,-2,6
DKI JAKARTA,JAKARTA TIMUR,JATINEGARA,RAWA BUNGA,3175031004,2020-10-21,279,35,244,25,-1,26
DKI JAKARTA,JAKARTA TIMUR,JATINEGARA,RAWA BUNGA,3175031004,2020-10-22,288,33,255,9,-2,11
DKI JAKARTA,JAKARTA TIMUR,JATINEGARA,RAWA BUNGA,3175031004,2020-10-23,293,37,256,5,4,1
DKI JAKARTA,JAKARTA TIMUR,JATINEGARA,RAWA BUNGA,3175031004,2020-10-24,293,32,261,0,-5,5
DKI JAKARTA,JAKARTA TIMUR,JATINEGARA,RAWA BUNGA,3175031004,2020-10-25,295,33,262,2,1,1
DKI JAKARTA,JAKARTA TIMUR,JATINEGARA,RAWA BUNGA,3175031004,2020-10-26,297,29,268,2,-4,6
DKI JAKARTA,JAKARTA TIMUR,JATINEGARA,RAWA BUNGA,3175031004,2020-10-27,300,21,279,3,-8,11
DKI JAKARTA,JAKARTA TIMUR,JATINEGARA,RAWA BUNGA,3175031004,2020-10-28,303,18,285,3,-3,6
DKI JAKARTA,JAKARTA TIMUR,JATINEGARA,RAWA BUNGA,3175031004,2020-10-29,303,15,288,0,-3,3
DKI JAKARTA,JAKARTA TIMUR,JATINEGARA,RAWA BUNGA,3175031004,2020-10-30,309,18,291,6,3,3
DKI JAKARTA,JAKARTA TIMUR,JATINEGARA,RAWA BUNGA,3175031004,2020-10-31,310,17,293,1,-1,2
DKI JAKARTA,JAKARTA TIMUR,KRAMAT JATI,BALE KAMBANG,3175041005,2020-10-01,418,30,388,0,0,0
DKI JAKARTA,JAKARTA TIMUR,KRAMAT JATI,BALE KAMBANG,3175041005,2020-10-02,423,31,392,5,1,4
DKI JAKARTA,JAKARTA TIMUR,KRAMAT JATI,BALE KAMBANG,3175041005,2020-10-03,428,35,393,5,4,1
DKI JAKARTA,JAKARTA TIMUR,KRAMAT JATI,BALE KAMBANG,3175041005,2020-10-04,433,37,396,5,2,3
DKI JAKARTA,JAKARTA TIMUR,KRAMAT JATI,BALE KAMBANG,3175041005,2020-10-05,433,32,401,0,-5,5
DKI JAKARTA,JAKARTA TIMUR,KRAMAT JATI,BALE KAMBANG,3175041005,2020-10-06,436,30,406,3,-2,5
DKI JAKARTA,JAKARTA TIMUR,KRAMAT JATI,BALE KAMBANG,3175041005,2020-10-07,443,34,409,7,4,3
DKI JAKARTA,JAKARTA TIMUR,KRAMAT JATI,BALE KAMBANG,3175041005,2020-10-08,447,34,413,4,0,4
DKI JAKARTA,JAKARTA TIMUR,KRAMAT JATI,BALE KAMBANG,3175041005,2020-10-09,449,36,413,2,2,0
DKI JAKARTA,JAKARTA TIMUR,KRAMAT JATI,BALE KAMBANG,3175041005,2020-10-10,453,38,415,4,2,2
DKI JAKARTA,JAKARTA TIMUR,KRAMAT JATI,BALE KAMBANG,3175041005,2020-10-11,459,43,416,6,5,1
DKI JAKARTA,JAKARTA TIMUR,KRAMAT JATI,BALE KAMBANG,3175041005,2020-10-12,461,34,427,2,-9,11
DKI JAKARTA,JAKARTA TIMUR,KRAMAT JATI,BALE KAMBANG,3175041005,2020-10-13,462,31,431,1,-3,4
DKI JAKARTA,JAKARTA TIMUR,KRAMAT JATI,BALE KAMBANG,3175041005,2020-10-14,466,31,435,4,0,4
DKI JAKARTA,JAKARTA TIMUR,KRAMAT JATI,BALE KAMBANG,3175041005,2020-10-15,471,32,439,5,1,4
DKI JAKARTA,JAKARTA TIMUR,KRAMAT JATI,BALE KAMBANG,3175041005,2020-10-16,472,30,442,1,-2,3
DKI JAKARTA,JAKARTA TIMUR,KRAMAT JATI,BALE KAMBANG,3175041005,2020-10-17,477,33,444,5,3,2
DKI JAKARTA,JAKARTA TIMUR,KRAMAT JATI,BALE KAMBANG,3175041005,2020-10-18,479,34,445,2,1,1
DKI JAKARTA,JAKARTA TIMUR,KRAMAT JATI,BALE KAMBANG,3175041005,2020-10-19,486,36,450,7,2,5
DKI JAKARTA,JAKARTA TIMUR,KRAMAT JATI,BALE KAMBANG,3175041005,2020-10-20,492,40,452,6,4,2
DKI JAKARTA,JAKARTA TIMUR,KRAMAT JATI,BALE KAMBANG,3175041005,2020-10-21,492,33,459,0,-7,7
DKI JAKARTA,JAKARTA TIMUR,KRAMAT JATI,BALE KAMBANG,3175041005,2020-10-22,492,29,463,0,-4,4
DKI JAKARTA,JAKARTA TIMUR,KRAMAT JATI,BALE KAMBANG,3175041005,2020-10-23,502,37,465,10,8,2
DKI JAKARTA,JAKARTA TIMUR,KRAMAT JATI,BALE KAMBANG,3175041005,2020-10-24,504,29,475,2,-8,10
DKI JAKARTA,JAKARTA TIMUR,KRAMAT JATI,BALE KAMBANG,3175041005,2020-10-25,505,27,478,1,-2,3
DKI JAKARTA,JAKARTA TIMUR,KRAMAT JATI,BALE KAMBANG,3175041005,2020-10-26,507,21,486,2,-6,8
DKI JAKARTA,JAKARTA TIMUR,KRAMAT JATI,BALE KAMBANG,3175041005,2020-10-27,513,25,488,6,4,2
DKI JAKARTA,JAKARTA TIMUR,KRAMAT JATI,BALE KAMBANG,3175041005,2020-10-28,515,25,490,2,0,2
DKI JAKARTA,JAKARTA TIMUR,KRAMAT JATI,BALE KAMBANG,3175041005,2020-10-29,526,22,504,11,-3,14
DKI JAKARTA,JAKARTA TIMUR,KRAMAT JATI,BALE KAMBANG,3175041005,2020-10-30,545,33,512,19,11,8
DKI JAKARTA,JAKARTA TIMUR,KRAMAT JATI,BALE KAMBANG,3175041005,2020-10-31,545,33,512,0,0,0
DKI JAKARTA,JAKARTA TIMUR,KRAMAT JATI,BATU AMPAR,3175041004,2020-10-01,731,61,670,0,0,0
DKI JAKARTA,JAKARTA TIMUR,KRAMAT JATI,BATU AMPAR,3175041004,2020-10-02,739,55,684,8,-6,14
DKI JAKARTA,JAKARTA TIMUR,KRAMAT JATI,BATU AMPAR,3175041004,2020-10-03,744,57,687,5,2,3
DKI JAKARTA,JAKARTA TIMUR,KRAMAT JATI,BATU AMPAR,3175041004,2020-10-04,751,63,688,7,6,1
DKI JAKARTA,JAKARTA TIMUR,KRAMAT JATI,BATU AMPAR,3175041004,2020-10-05,753,57,696,2,-6,8
DKI JAKARTA,JAKARTA TIMUR,KRAMAT JATI,BATU AMPAR,3175041004,2020-10-06,758,47,711,5,-10,15
DKI JAKARTA,JAKARTA TIMUR,KRAMAT JATI,BATU AMPAR,3175041004,2020-10-07,774,52,722,16,5,11
DKI JAKARTA,JAKARTA TIMUR,KRAMAT JATI,BATU AMPAR,3175041004,2020-10-08,788,61,727,14,9,5
DKI JAKARTA,JAKARTA TIMUR,KRAMAT JATI,BATU AMPAR,3175041004,2020-10-09,793,65,728,5,4,1
DKI JAKARTA,JAKARTA TIMUR,KRAMAT JATI,BATU AMPAR,3175041004,2020-10-10,808,72,736,15,7,8
DKI JAKARTA,JAKARTA TIMUR,KRAMAT JATI,BATU AMPAR,3175041004,2020-10-11,830,92,738,22,20,2
DKI JAKARTA,JAKARTA TIMUR,KRAMAT JATI,BATU AMPAR,3175041004,2020-10-12,835,84,751,5,-8,13
DKI JAKARTA,JAKARTA TIMUR,KRAMAT JATI,BATU AMPAR,3175041004,2020-10-13,858,88,770,23,4,19
DKI JAKARTA,JAKARTA TIMUR,KRAMAT JATI,BATU AMPAR,3175041004,2020-10-14,873,93,780,15,5,10
DKI JAKARTA,JAKARTA TIMUR,KRAMAT JATI,BATU AMPAR,3175041004,2020-10-15,885,104,781,12,11,1
DKI JAKARTA,JAKARTA TIMUR,KRAMAT JATI,BATU AMPAR,3175041004,2020-10-16,893,103,790,8,-1,9
DKI JAKARTA,JAKARTA TIMUR,KRAMAT JATI,BATU AMPAR,3175041004,2020-10-17,912,119,793,19,16,3
DKI JAKARTA,JAKARTA TIMUR,KRAMAT JATI,BATU AMPAR,3175041004,2020-10-18,920,124,796,8,5,3
DKI JAKARTA,JAKARTA TIMUR,KRAMAT JATI,BATU AMPAR,3175041004,2020-10-19,926,122,804,6,-2,8
DKI JAKARTA,JAKARTA TIMUR,KRAMAT JATI,BATU AMPAR,3175041004,2020-10-20,941,122,819,15,0,15
DKI JAKARTA,JAKARTA TIMUR,KRAMAT JATI,BATU AMPAR,3175041004,2020-10-21,952,118,834,11,-4,15
DKI JAKARTA,JAKARTA TIMUR,KRAMAT JATI,BATU AMPAR,3175041004,2020-10-22,956,103,853,4,-15,19
DKI JAKARTA,JAKARTA TIMUR,KRAMAT JATI,BATU AMPAR,3175041004,2020-10-23,960,105,855,4,2,2
DKI JAKARTA,JAKARTA TIMUR,KRAMAT JATI,BATU AMPAR,3175041004,2020-10-24,987,110,877,27,5,22
DKI JAKARTA,JAKARTA TIMUR,KRAMAT JATI,BATU AMPAR,3175041004,2020-10-25,991,112,879,4,2,2
DKI JAKARTA,JAKARTA TIMUR,KRAMAT JATI,BATU AMPAR,3175041004,2020-10-26,995,100,895,4,-12,16
DKI JAKARTA,JAKARTA TIMUR,KRAMAT JATI,BATU AMPAR,3175041004,2020-10-27,1011,112,899,16,12,4
DKI JAKARTA,JAKARTA TIMUR,KRAMAT JATI,BATU AMPAR,3175041004,2020-10-28,1017,103,914,6,-9,15
DKI JAKARTA,JAKARTA TIMUR,KRAMAT JATI,BATU AMPAR,3175041004,2020-10-29,1040,86,954,23,-17,40
DKI JAKARTA,JAKARTA TIMUR,KRAMAT JATI,BATU AMPAR,3175041004,2020-10-30,1069,96,973,29,10,19
DKI JAKARTA,JAKARTA TIMUR,KRAMAT JATI,BATU AMPAR,3175041004,2020-10-31,1086,110,976,17,14,3
DKI JAKARTA,JAKARTA TIMUR,KRAMAT JATI,CAWANG,3175041007,2020-10-01,565,89,476,0,0,0
DKI JAKARTA,JAKARTA TIMUR,KRAMAT JATI,CAWANG,3175041007,2020-10-02,585,103,482,20,14,6
DKI JAKARTA,JAKARTA TIMUR,KRAMAT JATI,CAWANG,3175041007,2020-10-03,590,107,483,5,4,1
DKI JAKARTA,JAKARTA TIMUR,KRAMAT JATI,CAWANG,3175041007,2020-10-04,608,123,485,18,16,2
DKI JAKARTA,JAKARTA TIMUR,KRAMAT JATI,CAWANG,3175041007,2020-10-05,611,121,490,3,-2,5
DKI JAKARTA,JAKARTA TIMUR,KRAMAT JATI,CAWANG,3175041007,2020-10-06,621,116,505,10,-5,15
DKI JAKARTA,JAKARTA TIMUR,KRAMAT JATI,CAWANG,3175041007,2020-10-07,632,122,510,11,6,5
DKI JAKARTA,JAKARTA TIMUR,KRAMAT JATI,CAWANG,3175041007,2020-10-08,664,144,520,32,22,10
DKI JAKARTA,JAKARTA TIMUR,KRAMAT JATI,CAWANG,3175041007,2020-10-09,671,151,520,7,7,0
DKI JAKARTA,JAKARTA TIMUR,KRAMAT JATI,CAWANG,3175041007,2020-10-10,674,143,531,3,-8,11
DKI JAKARTA,JAKARTA TIMUR,KRAMAT JATI,CAWANG,3175041007,2020-10-11,689,154,535,15,11,4
DKI JAKARTA,JAKARTA TIMUR,KRAMAT JATI,CAWANG,3175041007,2020-10-12,702,161,541,13,7,6
DKI JAKARTA,JAKARTA TIMUR,KRAMAT JATI,CAWANG,3175041007,2020-10-13,705,122,583,3,-39,42
DKI JAKARTA,JAKARTA TIMUR,KRAMAT JATI,CAWANG,3175041007,2020-10-14,715,96,619,10,-26,36
DKI JAKARTA,JAKARTA TIMUR,KRAMAT JATI,CAWANG,3175041007,2020-10-15,723,88,635,8,-8,16
DKI JAKARTA,JAKARTA TIMUR,KRAMAT JATI,CAWANG,3175041007,2020-10-16,726,86,640,3,-2,5
DKI JAKARTA,JAKARTA TIMUR,KRAMAT JATI,CAWANG,3175041007,2020-10-17,764,121,643,38,35,3
DKI JAKARTA,JAKARTA TIMUR,KRAMAT JATI,CAWANG,3175041007,2020-10-18,770,127,643,6,6,0
DKI JAKARTA,JAKARTA TIMUR,KRAMAT JATI,CAWANG,3175041007,2020-10-19,772,111,661,2,-16,18
DKI JAKARTA,JAKARTA TIMUR,KRAMAT JATI,CAWANG,3175041007,2020-10-20,777,101,676,5,-10,15
DKI JAKARTA,JAKARTA TIMUR,KRAMAT JATI,CAWANG,3175041007,2020-10-21,800,116,684,23,15,8
DKI JAKARTA,JAKARTA TIMUR,KRAMAT JATI,CAWANG,3175041007,2020-10-22,807,111,696,7,-5,12
DKI JAKARTA,JAKARTA TIMUR,KRAMAT JATI,CAWANG,3175041007,2020-10-23,825,129,696,18,18,0
DKI JAKARTA,JAKARTA TIMUR,KRAMAT JATI,CAWANG,3175041007,2020-10-24,924,216,708,99,87,12
DKI JAKARTA,JAKARTA TIMUR,KRAMAT JATI,CAWANG,3175041007,2020-10-25,928,216,712,4,0,4
DKI JAKARTA,JAKARTA TIMUR,KRAMAT JATI,CAWANG,3175041007,2020-10-26,962,241,721,34,25,9
DKI JAKARTA,JAKARTA TIMUR,KRAMAT JATI,CAWANG,3175041007,2020-10-27,969,239,730,7,-2,9
DKI JAKARTA,JAKARTA TIMUR,KRAMAT JATI,CAWANG,3175041007,2020-10-28,969,211,758,0,-28,28
DKI JAKARTA,JAKARTA TIMUR,KRAMAT JATI,CAWANG,3175041007,2020-10-29,973,193,780,4,-18,22
DKI JAKARTA,JAKARTA TIMUR,KRAMAT JATI,CAWANG,3175041007,2020-10-30,980,196,784,7,3,4
DKI JAKARTA,JAKARTA TIMUR,KRAMAT JATI,CAWANG,3175041007,2020-10-31,988,203,785,8,7,1
DKI JAKARTA,JAKARTA TIMUR,KRAMAT JATI,CILILITAN,3175041006,2020-10-01,615,49,566,0,0,0
DKI JAKARTA,JAKARTA TIMUR,KRAMAT JATI,CILILITAN,3175041006,2020-10-02,631,54,577,16,5,11
DKI JAKARTA,JAKARTA TIMUR,KRAMAT JATI,CILILITAN,3175041006,2020-10-03,640,59,581,9,5,4
DKI JAKARTA,JAKARTA TIMUR,KRAMAT JATI,CILILITAN,3175041006,2020-10-04,645,61,584,5,2,3
DKI JAKARTA,JAKARTA TIMUR,KRAMAT JATI,CILILITAN,3175041006,2020-10-05,646,56,590,1,-5,6
DKI JAKARTA,JAKARTA TIMUR,KRAMAT JATI,CILILITAN,3175041006,2020-10-06,651,57,594,5,1,4
DKI JAKARTA,JAKARTA TIMUR,KRAMAT JATI,CILILITAN,3175041006,2020-10-07,666,65,601,15,8,7
DKI JAKARTA,JAKARTA TIMUR,KRAMAT JATI,CILILITAN,3175041006,2020-10-08,676,73,603,10,8,2
DKI JAKARTA,JAKARTA TIMUR,KRAMAT JATI,CILILITAN,3175041006,2020-10-09,679,76,603,3,3,0
DKI JAKARTA,JAKARTA TIMUR,KRAMAT JATI,CILILITAN,3175041006,2020-10-10,690,79,611,11,3,8
DKI JAKARTA,JAKARTA TIMUR,KRAMAT JATI,CILILITAN,3175041006,2020-10-11,707,93,614,17,14,3
DKI JAKARTA,JAKARTA TIMUR,KRAMAT JATI,CILILITAN,3175041006,2020-10-12,714,92,622,7,-1,8
DKI JAKARTA,JAKARTA TIMUR,KRAMAT JATI,CILILITAN,3175041006,2020-10-13,719,77,642,5,-15,20
DKI JAKARTA,JAKARTA TIMUR,KRAMAT JATI,CILILITAN,3175041006,2020-10-14,721,71,650,2,-6,8
DKI JAKARTA,JAKARTA TIMUR,KRAMAT JATI,CILILITAN,3175041006,2020-10-15,733,77,656,12,6,6
DKI JAKARTA,JAKARTA TIMUR,KRAMAT JATI,CILILITAN,3175041006,2020-10-16,740,79,661,7,2,5
DKI JAKARTA,JAKARTA TIMUR,KRAMAT JATI,CILILITAN,3175041006,2020-10-17,750,87,663,10,8,2
DKI JAKARTA,JAKARTA TIMUR,KRAMAT JATI,CILILITAN,3175041006,2020-10-18,758,93,665,8,6,2
DKI JAKARTA,JAKARTA TIMUR,KRAMAT JATI,CILILITAN,3175041006,2020-10-19,780,100,680,22,7,15
DKI JAKARTA,JAKARTA TIMUR,KRAMAT JATI,CILILITAN,3175041006,2020-10-20,802,118,684,22,18,4
DKI JAKARTA,JAKARTA TIMUR,KRAMAT JATI,CILILITAN,3175041006,2020-10-21,820,124,696,18,6,12
DKI JAKARTA,JAKARTA TIMUR,KRAMAT JATI,CILILITAN,3175041006,2020-10-22,827,113,714,7,-11,18
DKI JAKARTA,JAKARTA TIMUR,KRAMAT JATI,CILILITAN,3175041006,2020-10-23,847,131,716,20,18,2
DKI JAKARTA,JAKARTA TIMUR,KRAMAT JATI,CILILITAN,3175041006,2020-10-24,852,121,731,5,-10,15
DKI JAKARTA,JAKARTA TIMUR,KRAMAT JATI,CILILITAN,3175041006,2020-10-25,854,119,735,2,-2,4
DKI JAKARTA,JAKARTA TIMUR,KRAMAT JATI,CILILITAN,3175041006,2020-10-26,861,121,740,7,2,5
DKI JAKARTA,JAKARTA TIMUR,KRAMAT JATI,CILILITAN,3175041006,2020-10-27,867,123,744,6,2,4
DKI JAKARTA,JAKARTA TIMUR,KRAMAT JATI,CILILITAN,3175041006,2020-10-28,877,119,758,10,-4,14
DKI JAKARTA,JAKARTA TIMUR,KRAMAT JATI,CILILITAN,3175041006,2020-10-29,878,109,769,1,-10,11
DKI JAKARTA,JAKARTA TIMUR,KRAMAT JATI,CILILITAN,3175041006,2020-10-30,893,85,808,15,-24,39
DKI JAKARTA,JAKARTA TIMUR,KRAMAT JATI,CILILITAN,3175041006,2020-10-31,898,90,808,5,5,0
DKI JAKARTA,JAKARTA TIMUR,KRAMAT JATI,DUKUH,3175041003,2020-10-01,500,79,421,0,0,0
DKI JAKARTA,JAKARTA TIMUR,KRAMAT JATI,DUKUH,3175041003,2020-10-02,508,85,423,8,6,2
DKI JAKARTA,JAKARTA TIMUR,KRAMAT JATI,DUKUH,3175041003,2020-10-03,513,89,424,5,4,1
DKI JAKARTA,JAKARTA TIMUR,KRAMAT JATI,DUKUH,3175041003,2020-10-04,523,98,425,10,9,1
DKI JAKARTA,JAKARTA TIMUR,KRAMAT JATI,DUKUH,3175041003,2020-10-05,524,85,439,1,-13,14
DKI JAKARTA,JAKARTA TIMUR,KRAMAT JATI,DUKUH,3175041003,2020-10-06,543,92,451,19,7,12
DKI JAKARTA,JAKARTA TIMUR,KRAMAT JATI,DUKUH,3175041003,2020-10-07,560,91,469,17,-1,18
DKI JAKARTA,JAKARTA TIMUR,KRAMAT JATI,DUKUH,3175041003,2020-10-08,576,97,479,16,6,10
DKI JAKARTA,JAKARTA TIMUR,KRAMAT JATI,DUKUH,3175041003,2020-10-09,578,98,480,2,1,1
DKI JAKARTA,JAKARTA TIMUR,KRAMAT JATI,DUKUH,3175041003,2020-10-10,580,89,491,2,-9,11
DKI JAKARTA,JAKARTA TIMUR,KRAMAT JATI,DUKUH,3175041003,2020-10-11,591,100,491,11,11,0
DKI JAKARTA,JAKARTA TIMUR,KRAMAT JATI,DUKUH,3175041003,2020-10-12,595,89,506,4,-11,15
DKI JAKARTA,JAKARTA TIMUR,KRAMAT JATI,DUKUH,3175041003,2020-10-13,596,84,512,1,-5,6
DKI JAKARTA,JAKARTA TIMUR,KRAMAT JATI,DUKUH,3175041003,2020-10-14,609,82,527,13,-2,15
DKI JAKARTA,JAKARTA TIMUR,KRAMAT JATI,DUKUH,3175041003,2020-10-15,626,86,540,17,4,13
DKI JAKARTA,JAKARTA TIMUR,KRAMAT JATI,DUKUH,3175041003,2020-10-16,629,71,558,3,-15,18
DKI JAKARTA,JAKARTA TIMUR,KRAMAT JATI,DUKUH,3175041003,2020-10-17,634,76,558,5,5,0
DKI JAKARTA,JAKARTA TIMUR,KRAMAT JATI,DUKUH,3175041003,2020-10-18,640,78,562,6,2,4
DKI JAKARTA,JAKARTA TIMUR,KRAMAT JATI,DUKUH,3175041003,2020-10-19,645,72,573,5,-6,11
DKI JAKARTA,JAKARTA TIMUR,KRAMAT JATI,DUKUH,3175041003,2020-10-20,653,70,583,8,-2,10
DKI JAKARTA,JAKARTA TIMUR,KRAMAT JATI,DUKUH,3175041003,2020-10-21,658,68,590,5,-2,7
DKI JAKARTA,JAKARTA TIMUR,KRAMAT JATI,DUKUH,3175041003,2020-10-22,666,65,601,8,-3,11
DKI JAKARTA,JAKARTA TIMUR,KRAMAT JATI,DUKUH,3175041003,2020-10-23,670,69,601,4,4,0
DKI JAKARTA,JAKARTA TIMUR,KRAMAT JATI,DUKUH,3175041003,2020-10-24,679,70,609,9,1,8
DKI JAKARTA,JAKARTA TIMUR,KRAMAT JATI,DUKUH,3175041003,2020-10-25,684,73,611,5,3,2
DKI JAKARTA,JAKARTA TIMUR,KRAMAT JATI,DUKUH,3175041003,2020-10-26,687,68,619,3,-5,8
DKI JAKARTA,JAKARTA TIMUR,KRAMAT JATI,DUKUH,3175041003,2020-10-27,702,65,637,15,-3,18
DKI JAKARTA,JAKARTA TIMUR,KRAMAT JATI,DUKUH,3175041003,2020-10-28,709,66,643,7,1,6
DKI JAKARTA,JAKARTA TIMUR,KRAMAT JATI,DUKUH,3175041003,2020-10-29,711,60,651,2,-6,8
DKI JAKARTA,JAKARTA TIMUR,KRAMAT JATI,DUKUH,3175041003,2020-10-30,726,66,660,15,6,9
DKI JAKARTA,JAKARTA TIMUR,KRAMAT JATI,DUKUH,3175041003,2020-10-31,736,75,661,10,9,1
DKI JAKARTA,JAKARTA TIMUR,KRAMAT JATI,KAMPUNG TENGAH,3175041002,2020-10-01,940,38,902,0,0,0
DKI JAKARTA,JAKARTA TIMUR,KRAMAT JATI,KAMPUNG TENGAH,3175041002,2020-10-02,958,47,911,18,9,9
DKI JAKARTA,JAKARTA TIMUR,KRAMAT JATI,KAMPUNG TENGAH,3175041002,2020-10-03,963,54,909,5,7,-2
DKI JAKARTA,JAKARTA TIMUR,KRAMAT JATI,KAMPUNG TENGAH,3175041002,2020-10-04,982,67,915,19,13,6
DKI JAKARTA,JAKARTA TIMUR,KRAMAT JATI,KAMPUNG TENGAH,3175041002,2020-10-05,983,67,916,1,0,1
DKI JAKARTA,JAKARTA TIMUR,KRAMAT JATI,KAMPUNG TENGAH,3175041002,2020-10-06,996,78,918,13,11,2
DKI JAKARTA,JAKARTA TIMUR,KRAMAT JATI,KAMPUNG TENGAH,3175041002,2020-10-07,1012,83,929,16,5,11
DKI JAKARTA,JAKARTA TIMUR,KRAMAT JATI,KAMPUNG TENGAH,3175041002,2020-10-08,1031,98,933,19,15,4
DKI JAKARTA,JAKARTA TIMUR,KRAMAT JATI,KAMPUNG TENGAH,3175041002,2020-10-09,1041,108,933,10,10,0
DKI JAKARTA,JAKARTA TIMUR,KRAMAT JATI,KAMPUNG TENGAH,3175041002,2020-10-10,1046,110,936,5,2,3
DKI JAKARTA,JAKARTA TIMUR,KRAMAT JATI,KAMPUNG TENGAH,3175041002,2020-10-11,1065,127,938,19,17,2
DKI JAKARTA,JAKARTA TIMUR,KRAMAT JATI,KAMPUNG TENGAH,3175041002,2020-10-12,1070,125,945,5,-2,7
DKI JAKARTA,JAKARTA TIMUR,KRAMAT JATI,KAMPUNG TENGAH,3175041002,2020-10-13,1077,111,966,7,-14,21
DKI JAKARTA,JAKARTA TIMUR,KRAMAT JATI,KAMPUNG TENGAH,3175041002,2020-10-14,1096,113,983,19,2,17
DKI JAKARTA,JAKARTA TIMUR,KRAMAT JATI,KAMPUNG TENGAH,3175041002,2020-10-15,1121,125,996,25,12,13
DKI JAKARTA,JAKARTA TIMUR,KRAMAT JATI,KAMPUNG TENGAH,3175041002,2020-10-16,1133,123,1010,12,-2,14
DKI JAKARTA,JAKARTA TIMUR,KRAMAT JATI,KAMPUNG TENGAH,3175041002,2020-10-17,1145,133,1012,12,10,2
DKI JAKARTA,JAKARTA TIMUR,KRAMAT JATI,KAMPUNG TENGAH,3175041002,2020-10-18,1148,132,1016,3,-1,4
DKI JAKARTA,JAKARTA TIMUR,KRAMAT JATI,KAMPUNG TENGAH,3175041002,2020-10-19,1156,125,1031,8,-7,15
DKI JAKARTA,JAKARTA TIMUR,KRAMAT JATI,KAMPUNG TENGAH,3175041002,2020-10-20,1166,119,1047,10,-6,16
DKI JAKARTA,JAKARTA TIMUR,KRAMAT JATI,KAMPUNG TENGAH,3175041002,2020-10-21,1196,125,1071,30,6,24
DKI JAKARTA,JAKARTA TIMUR,KRAMAT JATI,KAMPUNG TENGAH,3175041002,2020-10-22,1185,118,1067,-11,-7,-4
DKI JAKARTA,JAKARTA TIMUR,KRAMAT JATI,KAMPUNG TENGAH,3175041002,2020-10-23,1190,122,1068,5,4,1
DKI JAKARTA,JAKARTA TIMUR,KRAMAT JATI,KAMPUNG TENGAH,3175041002,2020-10-24,1194,107,1087,4,-15,19
DKI JAKARTA,JAKARTA TIMUR,KRAMAT JATI,KAMPUNG TENGAH,3175041002,2020-10-25,1198,109,1089,4,2,2
DKI JAKARTA,JAKARTA TIMUR,KRAMAT JATI,KAMPUNG TENGAH,3175041002,2020-10-26,1207,87,1120,9,-22,31
DKI JAKARTA,JAKARTA TIMUR,KRAMAT JATI,KAMPUNG TENGAH,3175041002,2020-10-27,1216,84,1132,9,-3,12
DKI JAKARTA,JAKARTA TIMUR,KRAMAT JATI,KAMPUNG TENGAH,3175041002,2020-10-28,1227,81,1146,11,-3,14
DKI JAKARTA,JAKARTA TIMUR,KRAMAT JATI,KAMPUNG TENGAH,3175041002,2020-10-29,1231,72,1159,4,-9,13
DKI JAKARTA,JAKARTA TIMUR,KRAMAT JATI,KAMPUNG TENGAH,3175041002,2020-10-30,1242,71,1171,11,-1,12
DKI JAKARTA,JAKARTA TIMUR,KRAMAT JATI,KAMPUNG TENGAH,3175041002,2020-10-31,1255,84,1171,13,13,0
DKI JAKARTA,JAKARTA TIMUR,KRAMAT JATI,KRAMAT JATI,3175041001,2020-10-01,684,121,563,0,0,0
DKI JAKARTA,JAKARTA TIMUR,KRAMAT JATI,KRAMAT JATI,3175041001,2020-10-02,702,126,576,18,5,13
DKI JAKARTA,JAKARTA TIMUR,KRAMAT JATI,KRAMAT JATI,3175041001,2020-10-03,701,123,578,-1,-3,2
DKI JAKARTA,JAKARTA TIMUR,KRAMAT JATI,KRAMAT JATI,3175041001,2020-10-04,713,132,581,12,9,3
DKI JAKARTA,JAKARTA TIMUR,KRAMAT JATI,KRAMAT JATI,3175041001,2020-10-05,713,115,598,0,-17,17
DKI JAKARTA,JAKARTA TIMUR,KRAMAT JATI,KRAMAT JATI,3175041001,2020-10-06,750,141,609,37,26,11
DKI JAKARTA,JAKARTA TIMUR,KRAMAT JATI,KRAMAT JATI,3175041001,2020-10-07,769,135,634,19,-6,25
DKI JAKARTA,JAKARTA TIMUR,KRAMAT JATI,KRAMAT JATI,3175041001,2020-10-08,792,149,643,23,14,9
DKI JAKARTA,JAKARTA TIMUR,KRAMAT JATI,KRAMAT JATI,3175041001,2020-10-09,795,151,644,3,2,1
DKI JAKARTA,JAKARTA TIMUR,KRAMAT JATI,KRAMAT JATI,3175041001,2020-10-10,799,140,659,4,-11,15
DKI JAKARTA,JAKARTA TIMUR,KRAMAT JATI,KRAMAT JATI,3175041001,2020-10-11,818,156,662,19,16,3
DKI JAKARTA,JAKARTA TIMUR,KRAMAT JATI,KRAMAT JATI,3175041001,2020-10-12,821,131,690,3,-25,28
DKI JAKARTA,JAKARTA TIMUR,KRAMAT JATI,KRAMAT JATI,3175041001,2020-10-13,825,114,711,4,-17,21
DKI JAKARTA,JAKARTA TIMUR,KRAMAT JATI,KRAMAT JATI,3175041001,2020-10-14,831,109,722,6,-5,11
DKI JAKARTA,JAKARTA TIMUR,KRAMAT JATI,KRAMAT JATI,3175041001,2020-10-15,848,90,758,17,-19,36
DKI JAKARTA,JAKARTA TIMUR,KRAMAT JATI,KRAMAT JATI,3175041001,2020-10-16,858,79,779,10,-11,21
DKI JAKARTA,JAKARTA TIMUR,KRAMAT JATI,KRAMAT JATI,3175041001,2020-10-17,872,92,780,14,13,1
DKI JAKARTA,JAKARTA TIMUR,KRAMAT JATI,KRAMAT JATI,3175041001,2020-10-18,882,101,781,10,9,1
DKI JAKARTA,JAKARTA TIMUR,KRAMAT JATI,KRAMAT JATI,3175041001,2020-10-19,891,95,796,9,-6,15
DKI JAKARTA,JAKARTA TIMUR,KRAMAT JATI,KRAMAT JATI,3175041001,2020-10-20,901,92,809,10,-3,13
DKI JAKARTA,JAKARTA TIMUR,KRAMAT JATI,KRAMAT JATI,3175041001,2020-10-21,927,89,838,26,-3,29
DKI JAKARTA,JAKARTA TIMUR,KRAMAT JATI,KRAMAT JATI,3175041001,2020-10-22,907,84,823,-20,-5,-15
DKI JAKARTA,JAKARTA TIMUR,KRAMAT JATI,KRAMAT JATI,3175041001,2020-10-23,909,86,823,2,2,0
DKI JAKARTA,JAKARTA TIMUR,KRAMAT JATI,KRAMAT JATI,3175041001,2020-10-24,919,74,845,10,-12,22
DKI JAKARTA,JAKARTA TIMUR,KRAMAT JATI,KRAMAT JATI,3175041001,2020-10-25,922,74,848,3,0,3
DKI JAKARTA,JAKARTA TIMUR,KRAMAT JATI,KRAMAT JATI,3175041001,2020-10-26,925,71,854,3,-3,6
DKI JAKARTA,JAKARTA TIMUR,KRAMAT JATI,KRAMAT JATI,3175041001,2020-10-27,933,73,860,8,2,6
DKI JAKARTA,JAKARTA TIMUR,KRAMAT JATI,KRAMAT JATI,3175041001,2020-10-28,953,79,874,20,6,14
DKI JAKARTA,JAKARTA TIMUR,KRAMAT JATI,KRAMAT JATI,3175041001,2020-10-29,962,71,891,9,-8,17
DKI JAKARTA,JAKARTA TIMUR,KRAMAT JATI,KRAMAT JATI,3175041001,2020-10-30,969,59,910,7,-12,19
DKI JAKARTA,JAKARTA TIMUR,KRAMAT JATI,KRAMAT JATI,3175041001,2020-10-31,996,84,912,27,25,2
DKI JAKARTA,JAKARTA TIMUR,MAKASAR,CIPINANG MELAYU,3175081005,2020-10-01,590,40,550,0,0,0
DKI JAKARTA,JAKARTA TIMUR,MAKASAR,CIPINANG MELAYU,3175081005,2020-10-02,603,46,557,13,6,7
DKI JAKARTA,JAKARTA TIMUR,MAKASAR,CIPINANG MELAYU,3175081005,2020-10-03,611,52,559,8,6,2
DKI JAKARTA,JAKARTA TIMUR,MAKASAR,CIPINANG MELAYU,3175081005,2020-10-04,613,54,559,2,2,0
DKI JAKARTA,JAKARTA TIMUR,MAKASAR,CIPINANG MELAYU,3175081005,2020-10-05,615,52,563,2,-2,4
DKI JAKARTA,JAKARTA TIMUR,MAKASAR,CIPINANG MELAYU,3175081005,2020-10-06,615,50,565,0,-2,2
DKI JAKARTA,JAKARTA TIMUR,MAKASAR,CIPINANG MELAYU,3175081005,2020-10-07,623,51,572,8,1,7
DKI JAKARTA,JAKARTA TIMUR,MAKASAR,CIPINANG MELAYU,3175081005,2020-10-08,635,57,578,12,6,6
DKI JAKARTA,JAKARTA TIMUR,MAKASAR,CIPINANG MELAYU,3175081005,2020-10-09,642,63,579,7,6,1
DKI JAKARTA,JAKARTA TIMUR,MAKASAR,CIPINANG MELAYU,3175081005,2020-10-10,648,64,584,6,1,5
DKI JAKARTA,JAKARTA TIMUR,MAKASAR,CIPINANG MELAYU,3175081005,2020-10-11,655,60,595,7,-4,11
DKI JAKARTA,JAKARTA TIMUR,MAKASAR,CIPINANG MELAYU,3175081005,2020-10-12,666,65,601,11,5,6
DKI JAKARTA,JAKARTA TIMUR,MAKASAR,CIPINANG MELAYU,3175081005,2020-10-13,673,59,614,7,-6,13
DKI JAKARTA,JAKARTA TIMUR,MAKASAR,CIPINANG MELAYU,3175081005,2020-10-14,675,54,621,2,-5,7
DKI JAKARTA,JAKARTA TIMUR,MAKASAR,CIPINANG MELAYU,3175081005,2020-10-15,687,61,626,12,7,5
DKI JAKARTA,JAKARTA TIMUR,MAKASAR,CIPINANG MELAYU,3175081005,2020-10-16,702,75,627,15,14,1
DKI JAKARTA,JAKARTA TIMUR,MAKASAR,CIPINANG MELAYU,3175081005,2020-10-17,711,82,629,9,7,2
DKI JAKARTA,JAKARTA TIMUR,MAKASAR,CIPINANG MELAYU,3175081005,2020-10-18,720,89,631,9,7,2
DKI JAKARTA,JAKARTA TIMUR,MAKASAR,CIPINANG MELAYU,3175081005,2020-10-19,723,84,639,3,-5,8
DKI JAKARTA,JAKARTA TIMUR,MAKASAR,CIPINANG MELAYU,3175081005,2020-10-20,729,83,646,6,-1,7
DKI JAKARTA,JAKARTA TIMUR,MAKASAR,CIPINANG MELAYU,3175081005,2020-10-21,733,69,664,4,-14,18
DKI JAKARTA,JAKARTA TIMUR,MAKASAR,CIPINANG MELAYU,3175081005,2020-10-22,733,63,670,0,-6,6
DKI JAKARTA,JAKARTA TIMUR,MAKASAR,CIPINANG MELAYU,3175081005,2020-10-23,734,64,670,1,1,0
DKI JAKARTA,JAKARTA TIMUR,MAKASAR,CIPINANG MELAYU,3175081005,2020-10-24,739,53,686,5,-11,16
DKI JAKARTA,JAKARTA TIMUR,MAKASAR,CIPINANG MELAYU,3175081005,2020-10-25,742,54,688,3,1,2
DKI JAKARTA,JAKARTA TIMUR,MAKASAR,CIPINANG MELAYU,3175081005,2020-10-26,744,48,696,2,-6,8
DKI JAKARTA,JAKARTA TIMUR,MAKASAR,CIPINANG MELAYU,3175081005,2020-10-27,749,36,713,5,-12,17
DKI JAKARTA,JAKARTA TIMUR,MAKASAR,CIPINANG MELAYU,3175081005,2020-10-28,751,30,721,2,-6,8
DKI JAKARTA,JAKARTA TIMUR,MAKASAR,CIPINANG MELAYU,3175081005,2020-10-29,759,24,735,8,-6,14
DKI JAKARTA,JAKARTA TIMUR,MAKASAR,CIPINANG MELAYU,3175081005,2020-10-30,776,33,743,17,9,8
DKI JAKARTA,JAKARTA TIMUR,MAKASAR,CIPINANG MELAYU,3175081005,2020-10-31,779,34,745,3,1,2
DKI JAKARTA,JAKARTA TIMUR,MAKASAR,HALIM PERDANA KUSUMAH,3175081004,2020-10-01,427,41,386,0,0,0
DKI JAKARTA,JAKARTA TIMUR,MAKASAR,HALIM PERDANA KUSUMAH,3175081004,2020-10-02,441,43,398,14,2,12
DKI JAKARTA,JAKARTA TIMUR,MAKASAR,HALIM PERDANA KUSUMAH,3175081004,2020-10-03,447,48,399,6,5,1
DKI JAKARTA,JAKARTA TIMUR,MAKASAR,HALIM PERDANA KUSUMAH,3175081004,2020-10-04,451,51,400,4,3,1
DKI JAKARTA,JAKARTA TIMUR,MAKASAR,HALIM PERDANA KUSUMAH,3175081004,2020-10-05,455,50,405,4,-1,5
DKI JAKARTA,JAKARTA TIMUR,MAKASAR,HALIM PERDANA KUSUMAH,3175081004,2020-10-06,463,48,415,8,-2,10
DKI JAKARTA,JAKARTA TIMUR,MAKASAR,HALIM PERDANA KUSUMAH,3175081004,2020-10-07,475,52,423,12,4,8
DKI JAKARTA,JAKARTA TIMUR,MAKASAR,HALIM PERDANA KUSUMAH,3175081004,2020-10-08,479,54,425,4,2,2
DKI JAKARTA,JAKARTA TIMUR,MAKASAR,HALIM PERDANA KUSUMAH,3175081004,2020-10-09,483,57,426,4,3,1
DKI JAKARTA,JAKARTA TIMUR,MAKASAR,HALIM PERDANA KUSUMAH,3175081004,2020-10-10,493,60,433,10,3,7
DKI JAKARTA,JAKARTA TIMUR,MAKASAR,HALIM PERDANA KUSUMAH,3175081004,2020-10-11,496,63,433,3,3,0
DKI JAKARTA,JAKARTA TIMUR,MAKASAR,HALIM PERDANA KUSUMAH,3175081004,2020-10-12,498,52,446,2,-11,13
DKI JAKARTA,JAKARTA TIMUR,MAKASAR,HALIM PERDANA KUSUMAH,3175081004,2020-10-13,502,48,454,4,-4,8
DKI JAKARTA,JAKARTA TIMUR,MAKASAR,HALIM PERDANA KUSUMAH,3175081004,2020-10-14,505,44,461,3,-4,7
DKI JAKARTA,JAKARTA TIMUR,MAKASAR,HALIM PERDANA KUSUMAH,3175081004,2020-10-15,520,43,477,15,-1,16
DKI JAKARTA,JAKARTA TIMUR,MAKASAR,HALIM PERDANA KUSUMAH,3175081004,2020-10-16,528,41,487,8,-2,10
DKI JAKARTA,JAKARTA TIMUR,MAKASAR,HALIM PERDANA KUSUMAH,3175081004,2020-10-17,535,45,490,7,4,3
DKI JAKARTA,JAKARTA TIMUR,MAKASAR,HALIM PERDANA KUSUMAH,3175081004,2020-10-18,542,50,492,7,5,2
DKI JAKARTA,JAKARTA TIMUR,MAKASAR,HALIM PERDANA KUSUMAH,3175081004,2020-10-19,544,51,493,2,1,1
DKI JAKARTA,JAKARTA TIMUR,MAKASAR,HALIM PERDANA KUSUMAH,3175081004,2020-10-20,551,55,496,7,4,3
DKI JAKARTA,JAKARTA TIMUR,MAKASAR,HALIM PERDANA KUSUMAH,3175081004,2020-10-21,551,48,503,0,-7,7
DKI JAKARTA,JAKARTA TIMUR,MAKASAR,HALIM PERDANA KUSUMAH,3175081004,2020-10-22,551,47,504,0,-1,1
DKI JAKARTA,JAKARTA TIMUR,MAKASAR,HALIM PERDANA KUSUMAH,3175081004,2020-10-23,553,49,504,2,2,0
DKI JAKARTA,JAKARTA TIMUR,MAKASAR,HALIM PERDANA KUSUMAH,3175081004,2020-10-24,559,41,518,6,-8,14
DKI JAKARTA,JAKARTA TIMUR,MAKASAR,HALIM PERDANA KUSUMAH,3175081004,2020-10-25,561,41,520,2,0,2
DKI JAKARTA,JAKARTA TIMUR,MAKASAR,HALIM PERDANA KUSUMAH,3175081004,2020-10-26,565,31,534,4,-10,14
DKI JAKARTA,JAKARTA TIMUR,MAKASAR,HALIM PERDANA KUSUMAH,3175081004,2020-10-27,566,26,540,1,-5,6
DKI JAKARTA,JAKARTA TIMUR,MAKASAR,HALIM PERDANA KUSUMAH,3175081004,2020-10-28,569,17,552,3,-9,12
DKI JAKARTA,JAKARTA TIMUR,MAKASAR,HALIM PERDANA KUSUMAH,3175081004,2020-10-29,571,14,557,2,-3,5
DKI JAKARTA,JAKARTA TIMUR,MAKASAR,HALIM PERDANA KUSUMAH,3175081004,2020-10-30,575,16,559,4,2,2
DKI JAKARTA,JAKARTA TIMUR,MAKASAR,HALIM PERDANA KUSUMAH,3175081004,2020-10-31,579,20,559,4,4,0
DKI JAKARTA,JAKARTA TIMUR,MAKASAR,KEBON PALA,3175081003,2020-10-01,795,43,752,0,0,0
DKI JAKARTA,JAKARTA TIMUR,MAKASAR,KEBON PALA,3175081003,2020-10-02,806,45,761,11,2,9
DKI JAKARTA,JAKARTA TIMUR,MAKASAR,KEBON PALA,3175081003,2020-10-03,817,58,759,11,13,-2
DKI JAKARTA,JAKARTA TIMUR,MAKASAR,KEBON PALA,3175081003,2020-10-04,824,62,762,7,4,3
DKI JAKARTA,JAKARTA TIMUR,MAKASAR,KEBON PALA,3175081003,2020-10-05,832,62,770,8,0,8
DKI JAKARTA,JAKARTA TIMUR,MAKASAR,KEBON PALA,3175081003,2020-10-06,834,62,772,2,0,2
DKI JAKARTA,JAKARTA TIMUR,MAKASAR,KEBON PALA,3175081003,2020-10-07,849,71,778,15,9,6
DKI JAKARTA,JAKARTA TIMUR,MAKASAR,KEBON PALA,3175081003,2020-10-08,866,82,784,17,11,6
DKI JAKARTA,JAKARTA TIMUR,MAKASAR,KEBON PALA,3175081003,2020-10-09,870,86,784,4,4,0
DKI JAKARTA,JAKARTA TIMUR,MAKASAR,KEBON PALA,3175081003,2020-10-10,874,79,795,4,-7,11
DKI JAKARTA,JAKARTA TIMUR,MAKASAR,KEBON PALA,3175081003,2020-10-11,878,82,796,4,3,1
DKI JAKARTA,JAKARTA TIMUR,MAKASAR,KEBON PALA,3175081003,2020-10-12,890,86,804,12,4,8
DKI JAKARTA,JAKARTA TIMUR,MAKASAR,KEBON PALA,3175081003,2020-10-13,895,79,816,5,-7,12
DKI JAKARTA,JAKARTA TIMUR,MAKASAR,KEBON PALA,3175081003,2020-10-14,898,69,829,3,-10,13
DKI JAKARTA,JAKARTA TIMUR,MAKASAR,KEBON PALA,3175081003,2020-10-15,912,67,845,14,-2,16
DKI JAKARTA,JAKARTA TIMUR,MAKASAR,KEBON PALA,3175081003,2020-10-16,922,70,852,10,3,7
DKI JAKARTA,JAKARTA TIMUR,MAKASAR,KEBON PALA,3175081003,2020-10-17,932,78,854,10,8,2
DKI JAKARTA,JAKARTA TIMUR,MAKASAR,KEBON PALA,3175081003,2020-10-18,955,101,854,23,23,0
DKI JAKARTA,JAKARTA TIMUR,MAKASAR,KEBON PALA,3175081003,2020-10-19,957,91,866,2,-10,12
DKI JAKARTA,JAKARTA TIMUR,MAKASAR,KEBON PALA,3175081003,2020-10-20,969,99,870,12,8,4
DKI JAKARTA,JAKARTA TIMUR,MAKASAR,KEBON PALA,3175081003,2020-10-21,971,96,875,2,-3,5
DKI JAKARTA,JAKARTA TIMUR,MAKASAR,KEBON PALA,3175081003,2020-10-22,975,86,889,4,-10,14
DKI JAKARTA,JAKARTA TIMUR,MAKASAR,KEBON PALA,3175081003,2020-10-23,977,88,889,2,2,0
DKI JAKARTA,JAKARTA TIMUR,MAKASAR,KEBON PALA,3175081003,2020-10-24,981,74,907,4,-14,18
DKI JAKARTA,JAKARTA TIMUR,MAKASAR,KEBON PALA,3175081003,2020-10-25,986,74,912,5,0,5
DKI JAKARTA,JAKARTA TIMUR,MAKASAR,KEBON PALA,3175081003,2020-10-26,997,71,926,11,-3,14
DKI JAKARTA,JAKARTA TIMUR,MAKASAR,KEBON PALA,3175081003,2020-10-27,1000,65,935,3,-6,9
DKI JAKARTA,JAKARTA TIMUR,MAKASAR,KEBON PALA,3175081003,2020-10-28,1001,45,956,1,-20,21
DKI JAKARTA,JAKARTA TIMUR,MAKASAR,KEBON PALA,3175081003,2020-10-29,1004,35,969,3,-10,13
DKI JAKARTA,JAKARTA TIMUR,MAKASAR,KEBON PALA,3175081003,2020-10-30,1018,35,983,14,0,14
DKI JAKARTA,JAKARTA TIMUR,MAKASAR,KEBON PALA,3175081003,2020-10-31,1023,40,983,5,5,0
DKI JAKARTA,JAKARTA TIMUR,MAKASAR,MAKASAR,3175081001,2020-10-01,922,57,865,0,0,0
DKI JAKARTA,JAKARTA TIMUR,MAKASAR,MAKASAR,3175081001,2020-10-02,931,55,876,9,-2,11
DKI JAKARTA,JAKARTA TIMUR,MAKASAR,MAKASAR,3175081001,2020-10-03,942,64,878,11,9,2
DKI JAKARTA,JAKARTA TIMUR,MAKASAR,MAKASAR,3175081001,2020-10-04,954,71,883,12,7,5
DKI JAKARTA,JAKARTA TIMUR,MAKASAR,MAKASAR,3175081001,2020-10-05,970,83,887,16,12,4
DKI JAKARTA,JAKARTA TIMUR,MAKASAR,MAKASAR,3175081001,2020-10-06,971,81,890,1,-2,3
DKI JAKARTA,JAKARTA TIMUR,MAKASAR,MAKASAR,3175081001,2020-10-07,990,92,898,19,11,8
DKI JAKARTA,JAKARTA TIMUR,MAKASAR,MAKASAR,3175081001,2020-10-08,1014,108,906,24,16,8
DKI JAKARTA,JAKARTA TIMUR,MAKASAR,MAKASAR,3175081001,2020-10-09,1021,114,907,7,6,1
DKI JAKARTA,JAKARTA TIMUR,MAKASAR,MAKASAR,3175081001,2020-10-10,1030,110,920,9,-4,13
DKI JAKARTA,JAKARTA TIMUR,MAKASAR,MAKASAR,3175081001,2020-10-11,1037,116,921,7,6,1
DKI JAKARTA,JAKARTA TIMUR,MAKASAR,MAKASAR,3175081001,2020-10-12,1055,115,940,18,-1,19
DKI JAKARTA,JAKARTA TIMUR,MAKASAR,MAKASAR,3175081001,2020-10-13,1061,115,946,6,0,6
DKI JAKARTA,JAKARTA TIMUR,MAKASAR,MAKASAR,3175081001,2020-10-14,1066,111,955,5,-4,9
DKI JAKARTA,JAKARTA TIMUR,MAKASAR,MAKASAR,3175081001,2020-10-15,1106,122,984,40,11,29
DKI JAKARTA,JAKARTA TIMUR,MAKASAR,MAKASAR,3175081001,2020-10-16,1121,127,994,15,5,10
DKI JAKARTA,JAKARTA TIMUR,MAKASAR,MAKASAR,3175081001,2020-10-17,1175,179,996,54,52,2
DKI JAKARTA,JAKARTA TIMUR,MAKASAR,MAKASAR,3175081001,2020-10-18,1196,198,998,21,19,2
DKI JAKARTA,JAKARTA TIMUR,MAKASAR,MAKASAR,3175081001,2020-10-19,1196,187,1009,0,-11,11
DKI JAKARTA,JAKARTA TIMUR,MAKASAR,MAKASAR,3175081001,2020-10-20,1228,202,1026,32,15,17
DKI JAKARTA,JAKARTA TIMUR,MAKASAR,MAKASAR,3175081001,2020-10-21,1230,188,1042,2,-14,16
DKI JAKARTA,JAKARTA TIMUR,MAKASAR,MAKASAR,3175081001,2020-10-22,1230,179,1051,0,-9,9
DKI JAKARTA,JAKARTA TIMUR,MAKASAR,MAKASAR,3175081001,2020-10-23,1232,180,1052,2,1,1
DKI JAKARTA,JAKARTA TIMUR,MAKASAR,MAKASAR,3175081001,2020-10-24,1236,158,1078,4,-22,26
DKI JAKARTA,JAKARTA TIMUR,MAKASAR,MAKASAR,3175081001,2020-10-25,1241,155,1086,5,-3,8
DKI JAKARTA,JAKARTA TIMUR,MAKASAR,MAKASAR,3175081001,2020-10-26,1253,133,1120,12,-22,34
DKI JAKARTA,JAKARTA TIMUR,MAKASAR,MAKASAR,3175081001,2020-10-27,1259,117,1142,6,-16,22
DKI JAKARTA,JAKARTA TIMUR,MAKASAR,MAKASAR,3175081001,2020-10-28,1261,108,1153,2,-9,11
DKI JAKARTA,JAKARTA TIMUR,MAKASAR,MAKASAR,3175081001,2020-10-29,1268,36,1232,7,-72,79
DKI JAKARTA,JAKARTA TIMUR,MAKASAR,MAKASAR,3175081001,2020-10-30,1283,35,1248,15,-1,16
DKI JAKARTA,JAKARTA TIMUR,MAKASAR,MAKASAR,3175081001,2020-10-31,1286,37,1249,3,2,1
DKI JAKARTA,JAKARTA TIMUR,MAKASAR,PINANG RANTI,3175081002,2020-10-01,563,20,543,0,0,0
DKI JAKARTA,JAKARTA TIMUR,MAKASAR,PINANG RANTI,3175081002,2020-10-02,569,22,547,6,2,4
DKI JAKARTA,JAKARTA TIMUR,MAKASAR,PINANG RANTI,3175081002,2020-10-03,574,26,548,5,4,1
DKI JAKARTA,JAKARTA TIMUR,MAKASAR,PINANG RANTI,3175081002,2020-10-04,578,29,549,4,3,1
DKI JAKARTA,JAKARTA TIMUR,MAKASAR,PINANG RANTI,3175081002,2020-10-05,581,30,551,3,1,2
DKI JAKARTA,JAKARTA TIMUR,MAKASAR,PINANG RANTI,3175081002,2020-10-06,581,29,552,0,-1,1
DKI JAKARTA,JAKARTA TIMUR,MAKASAR,PINANG RANTI,3175081002,2020-10-07,591,38,553,10,9,1
DKI JAKARTA,JAKARTA TIMUR,MAKASAR,PINANG RANTI,3175081002,2020-10-08,605,51,554,14,13,1
DKI JAKARTA,JAKARTA TIMUR,MAKASAR,PINANG RANTI,3175081002,2020-10-09,606,52,554,1,1,0
DKI JAKARTA,JAKARTA TIMUR,MAKASAR,PINANG RANTI,3175081002,2020-10-10,615,54,561,9,2,7
DKI JAKARTA,JAKARTA TIMUR,MAKASAR,PINANG RANTI,3175081002,2020-10-11,623,60,563,8,6,2
DKI JAKARTA,JAKARTA TIMUR,MAKASAR,PINANG RANTI,3175081002,2020-10-12,643,72,571,20,12,8
DKI JAKARTA,JAKARTA TIMUR,MAKASAR,PINANG RANTI,3175081002,2020-10-13,665,92,573,22,20,2
DKI JAKARTA,JAKARTA TIMUR,MAKASAR,PINANG RANTI,3175081002,2020-10-14,667,83,584,2,-9,11
DKI JAKARTA,JAKARTA TIMUR,MAKASAR,PINANG RANTI,3175081002,2020-10-15,672,80,592,5,-3,8
DKI JAKARTA,JAKARTA TIMUR,MAKASAR,PINANG RANTI,3175081002,2020-10-16,681,87,594,9,7,2
DKI JAKARTA,JAKARTA TIMUR,MAKASAR,PINANG RANTI,3175081002,2020-10-17,687,90,597,6,3,3
DKI JAKARTA,JAKARTA TIMUR,MAKASAR,PINANG RANTI,3175081002,2020-10-18,697,99,598,10,9,1
DKI JAKARTA,JAKARTA TIMUR,MAKASAR,PINANG RANTI,3175081002,2020-10-19,700,95,605,3,-4,7
DKI JAKARTA,JAKARTA TIMUR,MAKASAR,PINANG RANTI,3175081002,2020-10-20,711,95,616,11,0,11
DKI JAKARTA,JAKARTA TIMUR,MAKASAR,PINANG RANTI,3175081002,2020-10-21,715,88,627,4,-7,11
DKI JAKARTA,JAKARTA TIMUR,MAKASAR,PINANG RANTI,3175081002,2020-10-22,713,62,651,-2,-26,24
DKI JAKARTA,JAKARTA TIMUR,MAKASAR,PINANG RANTI,3175081002,2020-10-23,714,63,651,1,1,0
DKI JAKARTA,JAKARTA TIMUR,MAKASAR,PINANG RANTI,3175081002,2020-10-24,718,44,674,4,-19,23
DKI JAKARTA,JAKARTA TIMUR,MAKASAR,PINANG RANTI,3175081002,2020-10-25,720,45,675,2,1,1
DKI JAKARTA,JAKARTA TIMUR,MAKASAR,PINANG RANTI,3175081002,2020-10-26,724,43,681,4,-2,6
DKI JAKARTA,JAKARTA TIMUR,MAKASAR,PINANG RANTI,3175081002,2020-10-27,727,38,689,3,-5,8
DKI JAKARTA,JAKARTA TIMUR,MAKASAR,PINANG RANTI,3175081002,2020-10-28,728,36,692,1,-2,3
DKI JAKARTA,JAKARTA TIMUR,MAKASAR,PINANG RANTI,3175081002,2020-10-29,734,28,706,6,-8,14
DKI JAKARTA,JAKARTA TIMUR,MAKASAR,PINANG RANTI,3175081002,2020-10-30,745,26,719,11,-2,13
DKI JAKARTA,JAKARTA TIMUR,MAKASAR,PINANG RANTI,3175081002,2020-10-31,749,28,721,4,2,2
DKI JAKARTA,JAKARTA TIMUR,MATRAMAN,KAYU MANIS,3175011003,2020-10-01,581,49,532,0,0,0
DKI JAKARTA,JAKARTA TIMUR,MATRAMAN,KAYU MANIS,3175011003,2020-10-02,586,34,552,5,-15,20
DKI JAKARTA,JAKARTA TIMUR,MATRAMAN,KAYU MANIS,3175011003,2020-10-03,591,35,556,5,1,4
DKI JAKARTA,JAKARTA TIMUR,MATRAMAN,KAYU MANIS,3175011003,2020-10-04,594,37,557,3,2,1
DKI JAKARTA,JAKARTA TIMUR,MATRAMAN,KAYU MANIS,3175011003,2020-10-05,599,27,572,5,-10,15
DKI JAKARTA,JAKARTA TIMUR,MATRAMAN,KAYU MANIS,3175011003,2020-10-06,613,38,575,14,11,3
DKI JAKARTA,JAKARTA TIMUR,MATRAMAN,KAYU MANIS,3175011003,2020-10-07,620,32,588,7,-6,13
DKI JAKARTA,JAKARTA TIMUR,MATRAMAN,KAYU MANIS,3175011003,2020-10-08,627,38,589,7,6,1
DKI JAKARTA,JAKARTA TIMUR,MATRAMAN,KAYU MANIS,3175011003,2020-10-09,630,41,589,3,3,0
DKI JAKARTA,JAKARTA TIMUR,MATRAMAN,KAYU MANIS,3175011003,2020-10-10,638,47,591,8,6,2
DKI JAKARTA,JAKARTA TIMUR,MATRAMAN,KAYU MANIS,3175011003,2020-10-11,640,47,593,2,0,2
DKI JAKARTA,JAKARTA TIMUR,MATRAMAN,KAYU MANIS,3175011003,2020-10-12,647,49,598,7,2,5
DKI JAKARTA,JAKARTA TIMUR,MATRAMAN,KAYU MANIS,3175011003,2020-10-13,650,48,602,3,-1,4
DKI JAKARTA,JAKARTA TIMUR,MATRAMAN,KAYU MANIS,3175011003,2020-10-14,655,37,618,5,-11,16
DKI JAKARTA,JAKARTA TIMUR,MATRAMAN,KAYU MANIS,3175011003,2020-10-15,662,41,621,7,4,3
DKI JAKARTA,JAKARTA TIMUR,MATRAMAN,KAYU MANIS,3175011003,2020-10-16,664,39,625,2,-2,4
DKI JAKARTA,JAKARTA TIMUR,MATRAMAN,KAYU MANIS,3175011003,2020-10-17,673,48,625,9,9,0
DKI JAKARTA,JAKARTA TIMUR,MATRAMAN,KAYU MANIS,3175011003,2020-10-18,680,54,626,7,6,1
DKI JAKARTA,JAKARTA TIMUR,MATRAMAN,KAYU MANIS,3175011003,2020-10-19,680,38,642,0,-16,16
DKI JAKARTA,JAKARTA TIMUR,MATRAMAN,KAYU MANIS,3175011003,2020-10-20,686,40,646,6,2,4
DKI JAKARTA,JAKARTA TIMUR,MATRAMAN,KAYU MANIS,3175011003,2020-10-21,707,51,656,21,11,10
DKI JAKARTA,JAKARTA TIMUR,MATRAMAN,KAYU MANIS,3175011003,2020-10-22,706,49,657,-1,-2,1
DKI JAKARTA,JAKARTA TIMUR,MATRAMAN,KAYU MANIS,3175011003,2020-10-23,707,49,658,1,0,1
DKI JAKARTA,JAKARTA TIMUR,MATRAMAN,KAYU MANIS,3175011003,2020-10-24,710,46,664,3,-3,6
DKI JAKARTA,JAKARTA TIMUR,MATRAMAN,KAYU MANIS,3175011003,2020-10-25,714,47,667,4,1,3
DKI JAKARTA,JAKARTA TIMUR,MATRAMAN,KAYU MANIS,3175011003,2020-10-26,716,45,671,2,-2,4
DKI JAKARTA,JAKARTA TIMUR,MATRAMAN,KAYU MANIS,3175011003,2020-10-27,719,43,676,3,-2,5
DKI JAKARTA,JAKARTA TIMUR,MATRAMAN,KAYU MANIS,3175011003,2020-10-28,720,39,681,1,-4,5
DKI JAKARTA,JAKARTA TIMUR,MATRAMAN,KAYU MANIS,3175011003,2020-10-29,725,34,691,5,-5,10
DKI JAKARTA,JAKARTA TIMUR,MATRAMAN,KAYU MANIS,3175011003,2020-10-30,744,40,704,19,6,13
DKI JAKARTA,JAKARTA TIMUR,MATRAMAN,KAYU MANIS,3175011003,2020-10-31,750,44,706,6,4,2
DKI JAKARTA,JAKARTA TIMUR,MATRAMAN,KEBON MANGGIS,3175011005,2020-10-01,217,10,207,0,0,0
DKI JAKARTA,JAKARTA TIMUR,MATRAMAN,KEBON MANGGIS,3175011005,2020-10-02,219,8,211,2,-2,4
DKI JAKARTA,JAKARTA TIMUR,MATRAMAN,KEBON MANGGIS,3175011005,2020-10-03,220,9,211,1,1,0
DKI JAKARTA,JAKARTA TIMUR,MATRAMAN,KEBON MANGGIS,3175011005,2020-10-04,223,12,211,3,3,0
DKI JAKARTA,JAKARTA TIMUR,MATRAMAN,KEBON MANGGIS,3175011005,2020-10-05,226,15,211,3,3,0
DKI JAKARTA,JAKARTA TIMUR,MATRAMAN,KEBON MANGGIS,3175011005,2020-10-06,228,15,213,2,0,2
DKI JAKARTA,JAKARTA TIMUR,MATRAMAN,KEBON MANGGIS,3175011005,2020-10-07,230,14,216,2,-1,3
DKI JAKARTA,JAKARTA TIMUR,MATRAMAN,KEBON MANGGIS,3175011005,2020-10-08,232,16,216,2,2,0
DKI JAKARTA,JAKARTA TIMUR,MATRAMAN,KEBON MANGGIS,3175011005,2020-10-09,235,19,216,3,3,0
DKI JAKARTA,JAKARTA TIMUR,MATRAMAN,KEBON MANGGIS,3175011005,2020-10-10,237,19,218,2,0,2
DKI JAKARTA,JAKARTA TIMUR,MATRAMAN,KEBON MANGGIS,3175011005,2020-10-11,242,24,218,5,5,0
DKI JAKARTA,JAKARTA TIMUR,MATRAMAN,KEBON MANGGIS,3175011005,2020-10-12,243,25,218,1,1,0
DKI JAKARTA,JAKARTA TIMUR,MATRAMAN,KEBON MANGGIS,3175011005,2020-10-13,248,28,220,5,3,2
DKI JAKARTA,JAKARTA TIMUR,MATRAMAN,KEBON MANGGIS,3175011005,2020-10-14,253,28,225,5,0,5
DKI JAKARTA,JAKARTA TIMUR,MATRAMAN,KEBON MANGGIS,3175011005,2020-10-15,258,32,226,5,4,1
DKI JAKARTA,JAKARTA TIMUR,MATRAMAN,KEBON MANGGIS,3175011005,2020-10-16,264,31,233,6,-1,7
DKI JAKARTA,JAKARTA TIMUR,MATRAMAN,KEBON MANGGIS,3175011005,2020-10-17,265,32,233,1,1,0
DKI JAKARTA,JAKARTA TIMUR,MATRAMAN,KEBON MANGGIS,3175011005,2020-10-18,266,31,235,1,-1,2
DKI JAKARTA,JAKARTA TIMUR,MATRAMAN,KEBON MANGGIS,3175011005,2020-10-19,266,26,240,0,-5,5
DKI JAKARTA,JAKARTA TIMUR,MATRAMAN,KEBON MANGGIS,3175011005,2020-10-20,268,27,241,2,1,1
DKI JAKARTA,JAKARTA TIMUR,MATRAMAN,KEBON MANGGIS,3175011005,2020-10-21,270,24,246,2,-3,5
DKI JAKARTA,JAKARTA TIMUR,MATRAMAN,KEBON MANGGIS,3175011005,2020-10-22,273,23,250,3,-1,4
DKI JAKARTA,JAKARTA TIMUR,MATRAMAN,KEBON MANGGIS,3175011005,2020-10-23,275,25,250,2,2,0
DKI JAKARTA,JAKARTA TIMUR,MATRAMAN,KEBON MANGGIS,3175011005,2020-10-24,276,16,260,1,-9,10
DKI JAKARTA,JAKARTA TIMUR,MATRAMAN,KEBON MANGGIS,3175011005,2020-10-25,277,16,261,1,0,1
DKI JAKARTA,JAKARTA TIMUR,MATRAMAN,KEBON MANGGIS,3175011005,2020-10-26,277,12,265,0,-4,4
DKI JAKARTA,JAKARTA TIMUR,MATRAMAN,KEBON MANGGIS,3175011005,2020-10-27,281,13,268,4,1,3
DKI JAKARTA,JAKARTA TIMUR,MATRAMAN,KEBON MANGGIS,3175011005,2020-10-28,281,10,271,0,-3,3
DKI JAKARTA,JAKARTA TIMUR,MATRAMAN,KEBON MANGGIS,3175011005,2020-10-29,285,12,273,4,2,2
DKI JAKARTA,JAKARTA TIMUR,MATRAMAN,KEBON MANGGIS,3175011005,2020-10-30,293,15,278,8,3,5
DKI JAKARTA,JAKARTA TIMUR,MATRAMAN,KEBON MANGGIS,3175011005,2020-10-31,297,15,282,4,0,4
DKI JAKARTA,JAKARTA TIMUR,MATRAMAN,PAL MERIAM,3175011004,2020-10-01,532,39,493,0,0,0
DKI JAKARTA,JAKARTA TIMUR,MATRAMAN,PAL MERIAM,3175011004,2020-10-02,539,37,502,7,-2,9
DKI JAKARTA,JAKARTA TIMUR,MATRAMAN,PAL MERIAM,3175011004,2020-10-03,545,40,505,6,3,3
DKI JAKARTA,JAKARTA TIMUR,MATRAMAN,PAL MERIAM,3175011004,2020-10-04,546,41,505,1,1,0
DKI JAKARTA,JAKARTA TIMUR,MATRAMAN,PAL MERIAM,3175011004,2020-10-05,551,42,509,5,1,4
DKI JAKARTA,JAKARTA TIMUR,MATRAMAN,PAL MERIAM,3175011004,2020-10-06,571,57,514,20,15,5
DKI JAKARTA,JAKARTA TIMUR,MATRAMAN,PAL MERIAM,3175011004,2020-10-07,575,41,534,4,-16,20
DKI JAKARTA,JAKARTA TIMUR,MATRAMAN,PAL MERIAM,3175011004,2020-10-08,581,45,536,6,4,2
DKI JAKARTA,JAKARTA TIMUR,MATRAMAN,PAL MERIAM,3175011004,2020-10-09,584,48,536,3,3,0
DKI JAKARTA,JAKARTA TIMUR,MATRAMAN,PAL MERIAM,3175011004,2020-10-10,589,41,548,5,-7,12
DKI JAKARTA,JAKARTA TIMUR,MATRAMAN,PAL MERIAM,3175011004,2020-10-11,594,42,552,5,1,4
DKI JAKARTA,JAKARTA TIMUR,MATRAMAN,PAL MERIAM,3175011004,2020-10-12,595,39,556,1,-3,4
DKI JAKARTA,JAKARTA TIMUR,MATRAMAN,PAL MERIAM,3175011004,2020-10-13,598,36,562,3,-3,6
DKI JAKARTA,JAKARTA TIMUR,MATRAMAN,PAL MERIAM,3175011004,2020-10-14,617,39,578,19,3,16
DKI JAKARTA,JAKARTA TIMUR,MATRAMAN,PAL MERIAM,3175011004,2020-10-15,623,43,580,6,4,2
DKI JAKARTA,JAKARTA TIMUR,MATRAMAN,PAL MERIAM,3175011004,2020-10-16,627,31,596,4,-12,16
DKI JAKARTA,JAKARTA TIMUR,MATRAMAN,PAL MERIAM,3175011004,2020-10-17,628,32,596,1,1,0
DKI JAKARTA,JAKARTA TIMUR,MATRAMAN,PAL MERIAM,3175011004,2020-10-18,630,34,596,2,2,0
DKI JAKARTA,JAKARTA TIMUR,MATRAMAN,PAL MERIAM,3175011004,2020-10-19,634,33,601,4,-1,5
DKI JAKARTA,JAKARTA TIMUR,MATRAMAN,PAL MERIAM,3175011004,2020-10-20,639,38,601,5,5,0
DKI JAKARTA,JAKARTA TIMUR,MATRAMAN,PAL MERIAM,3175011004,2020-10-21,641,36,605,2,-2,4
DKI JAKARTA,JAKARTA TIMUR,MATRAMAN,PAL MERIAM,3175011004,2020-10-22,643,33,610,2,-3,5
DKI JAKARTA,JAKARTA TIMUR,MATRAMAN,PAL MERIAM,3175011004,2020-10-23,646,35,611,3,2,1
DKI JAKARTA,JAKARTA TIMUR,MATRAMAN,PAL MERIAM,3175011004,2020-10-24,648,31,617,2,-4,6
DKI JAKARTA,JAKARTA TIMUR,MATRAMAN,PAL MERIAM,3175011004,2020-10-25,649,31,618,1,0,1
DKI JAKARTA,JAKARTA TIMUR,MATRAMAN,PAL MERIAM,3175011004,2020-10-26,655,25,630,6,-6,12
DKI JAKARTA,JAKARTA TIMUR,MATRAMAN,PAL MERIAM,3175011004,2020-10-27,659,27,632,4,2,2
DKI JAKARTA,JAKARTA TIMUR,MATRAMAN,PAL MERIAM,3175011004,2020-10-28,660,19,641,1,-8,9
DKI JAKARTA,JAKARTA TIMUR,MATRAMAN,PAL MERIAM,3175011004,2020-10-29,662,20,642,2,1,1
DKI JAKARTA,JAKARTA TIMUR,MATRAMAN,PAL MERIAM,3175011004,2020-10-30,683,24,659,21,4,17
DKI JAKARTA,JAKARTA TIMUR,MATRAMAN,PAL MERIAM,3175011004,2020-10-31,684,24,660,1,0,1
DKI JAKARTA,JAKARTA TIMUR,MATRAMAN,PISANGAN BARU,3175011001,2020-10-01,380,62,318,0,0,0
DKI JAKARTA,JAKARTA TIMUR,MATRAMAN,PISANGAN BARU,3175011001,2020-10-02,388,56,332,8,-6,14
DKI JAKARTA,JAKARTA TIMUR,MATRAMAN,PISANGAN BARU,3175011001,2020-10-03,391,53,338,3,-3,6
DKI JAKARTA,JAKARTA TIMUR,MATRAMAN,PISANGAN BARU,3175011001,2020-10-04,394,53,341,3,0,3
DKI JAKARTA,JAKARTA TIMUR,MATRAMAN,PISANGAN BARU,3175011001,2020-10-05,400,54,346,6,1,5
DKI JAKARTA,JAKARTA TIMUR,MATRAMAN,PISANGAN BARU,3175011001,2020-10-06,417,65,352,17,11,6
DKI JAKARTA,JAKARTA TIMUR,MATRAMAN,PISANGAN BARU,3175011001,2020-10-07,420,43,377,3,-22,25
DKI JAKARTA,JAKARTA TIMUR,MATRAMAN,PISANGAN BARU,3175011001,2020-10-08,425,44,381,5,1,4
DKI JAKARTA,JAKARTA TIMUR,MATRAMAN,PISANGAN BARU,3175011001,2020-10-09,431,49,382,6,5,1
DKI JAKARTA,JAKARTA TIMUR,MATRAMAN,PISANGAN BARU,3175011001,2020-10-10,439,49,390,8,0,8
DKI JAKARTA,JAKARTA TIMUR,MATRAMAN,PISANGAN BARU,3175011001,2020-10-11,441,51,390,2,2,0
DKI JAKARTA,JAKARTA TIMUR,MATRAMAN,PISANGAN BARU,3175011001,2020-10-12,444,40,404,3,-11,14
DKI JAKARTA,JAKARTA TIMUR,MATRAMAN,PISANGAN BARU,3175011001,2020-10-13,448,42,406,4,2,2
DKI JAKARTA,JAKARTA TIMUR,MATRAMAN,PISANGAN BARU,3175011001,2020-10-14,452,39,413,4,-3,7
DKI JAKARTA,JAKARTA TIMUR,MATRAMAN,PISANGAN BARU,3175011001,2020-10-15,456,41,415,4,2,2
DKI JAKARTA,JAKARTA TIMUR,MATRAMAN,PISANGAN BARU,3175011001,2020-10-16,460,31,429,4,-10,14
DKI JAKARTA,JAKARTA TIMUR,MATRAMAN,PISANGAN BARU,3175011001,2020-10-17,465,33,432,5,2,3
DKI JAKARTA,JAKARTA TIMUR,MATRAMAN,PISANGAN BARU,3175011001,2020-10-18,469,37,432,4,4,0
DKI JAKARTA,JAKARTA TIMUR,MATRAMAN,PISANGAN BARU,3175011001,2020-10-19,478,43,435,9,6,3
DKI JAKARTA,JAKARTA TIMUR,MATRAMAN,PISANGAN BARU,3175011001,2020-10-20,486,50,436,8,7,1
DKI JAKARTA,JAKARTA TIMUR,MATRAMAN,PISANGAN BARU,3175011001,2020-10-21,497,50,447,11,0,11
DKI JAKARTA,JAKARTA TIMUR,MATRAMAN,PISANGAN BARU,3175011001,2020-10-22,508,59,449,11,9,2
DKI JAKARTA,JAKARTA TIMUR,MATRAMAN,PISANGAN BARU,3175011001,2020-10-23,511,61,450,3,2,1
DKI JAKARTA,JAKARTA TIMUR,MATRAMAN,PISANGAN BARU,3175011001,2020-10-24,522,69,453,11,8,3
DKI JAKARTA,JAKARTA TIMUR,MATRAMAN,PISANGAN BARU,3175011001,2020-10-25,526,72,454,4,3,1
DKI JAKARTA,JAKARTA TIMUR,MATRAMAN,PISANGAN BARU,3175011001,2020-10-26,536,77,459,10,5,5
DKI JAKARTA,JAKARTA TIMUR,MATRAMAN,PISANGAN BARU,3175011001,2020-10-27,541,77,464,5,0,5
DKI JAKARTA,JAKARTA TIMUR,MATRAMAN,PISANGAN BARU,3175011001,2020-10-28,542,75,467,1,-2,3
DKI JAKARTA,JAKARTA TIMUR,MATRAMAN,PISANGAN BARU,3175011001,2020-10-29,550,78,472,8,3,5
DKI JAKARTA,JAKARTA TIMUR,MATRAMAN,PISANGAN BARU,3175011001,2020-10-30,590,87,503,40,9,31
DKI JAKARTA,JAKARTA TIMUR,MATRAMAN,PISANGAN BARU,3175011001,2020-10-31,600,96,504,10,9,1
DKI JAKARTA,JAKARTA TIMUR,MATRAMAN,UTAN KAYU SELATAN,3175011006,2020-10-01,689,42,647,0,0,0
DKI JAKARTA,JAKARTA TIMUR,MATRAMAN,UTAN KAYU SELATAN,3175011006,2020-10-02,700,44,656,11,2,9
DKI JAKARTA,JAKARTA TIMUR,MATRAMAN,UTAN KAYU SELATAN,3175011006,2020-10-03,706,48,658,6,4,2
DKI JAKARTA,JAKARTA TIMUR,MATRAMAN,UTAN KAYU SELATAN,3175011006,2020-10-04,711,49,662,5,1,4
DKI JAKARTA,JAKARTA TIMUR,MATRAMAN,UTAN KAYU SELATAN,3175011006,2020-10-05,717,48,669,6,-1,7
DKI JAKARTA,JAKARTA TIMUR,MATRAMAN,UTAN KAYU SELATAN,3175011006,2020-10-06,731,60,671,14,12,2
DKI JAKARTA,JAKARTA TIMUR,MATRAMAN,UTAN KAYU SELATAN,3175011006,2020-10-07,737,55,682,6,-5,11
DKI JAKARTA,JAKARTA TIMUR,MATRAMAN,UTAN KAYU SELATAN,3175011006,2020-10-08,742,53,689,5,-2,7
DKI JAKARTA,JAKARTA TIMUR,MATRAMAN,UTAN KAYU SELATAN,3175011006,2020-10-09,746,57,689,4,4,0
DKI JAKARTA,JAKARTA TIMUR,MATRAMAN,UTAN KAYU SELATAN,3175011006,2020-10-10,769,53,716,23,-4,27
DKI JAKARTA,JAKARTA TIMUR,MATRAMAN,UTAN KAYU SELATAN,3175011006,2020-10-11,772,52,720,3,-1,4
DKI JAKARTA,JAKARTA TIMUR,MATRAMAN,UTAN KAYU SELATAN,3175011006,2020-10-12,774,47,727,2,-5,7
DKI JAKARTA,JAKARTA TIMUR,MATRAMAN,UTAN KAYU SELATAN,3175011006,2020-10-13,775,42,733,1,-5,6
DKI JAKARTA,JAKARTA TIMUR,MATRAMAN,UTAN KAYU SELATAN,3175011006,2020-10-14,787,42,745,12,0,12
DKI JAKARTA,JAKARTA TIMUR,MATRAMAN,UTAN KAYU SELATAN,3175011006,2020-10-15,791,38,753,4,-4,8
DKI JAKARTA,JAKARTA TIMUR,MATRAMAN,UTAN KAYU SELATAN,3175011006,2020-10-16,794,30,764,3,-8,11
DKI JAKARTA,JAKARTA TIMUR,MATRAMAN,UTAN KAYU SELATAN,3175011006,2020-10-17,800,35,765,6,5,1
DKI JAKARTA,JAKARTA TIMUR,MATRAMAN,UTAN KAYU SELATAN,3175011006,2020-10-18,802,36,766,2,1,1
DKI JAKARTA,JAKARTA TIMUR,MATRAMAN,UTAN KAYU SELATAN,3175011006,2020-10-19,816,38,778,14,2,12
DKI JAKARTA,JAKARTA TIMUR,MATRAMAN,UTAN KAYU SELATAN,3175011006,2020-10-20,818,39,779,2,1,1
DKI JAKARTA,JAKARTA TIMUR,MATRAMAN,UTAN KAYU SELATAN,3175011006,2020-10-21,823,32,791,5,-7,12
DKI JAKARTA,JAKARTA TIMUR,MATRAMAN,UTAN KAYU SELATAN,3175011006,2020-10-22,825,31,794,2,-1,3
DKI JAKARTA,JAKARTA TIMUR,MATRAMAN,UTAN KAYU SELATAN,3175011006,2020-10-23,826,31,795,1,0,1
DKI JAKARTA,JAKARTA TIMUR,MATRAMAN,UTAN KAYU SELATAN,3175011006,2020-10-24,831,33,798,5,2,3
DKI JAKARTA,JAKARTA TIMUR,MATRAMAN,UTAN KAYU SELATAN,3175011006,2020-10-25,836,36,800,5,3,2
DKI JAKARTA,JAKARTA TIMUR,MATRAMAN,UTAN KAYU SELATAN,3175011006,2020-10-26,844,42,802,8,6,2
DKI JAKARTA,JAKARTA TIMUR,MATRAMAN,UTAN KAYU SELATAN,3175011006,2020-10-27,851,45,806,7,3,4
DKI JAKARTA,JAKARTA TIMUR,MATRAMAN,UTAN KAYU SELATAN,3175011006,2020-10-28,864,54,810,13,9,4
DKI JAKARTA,JAKARTA TIMUR,MATRAMAN,UTAN KAYU SELATAN,3175011006,2020-10-29,876,60,817,12,6,7
DKI JAKARTA,JAKARTA TIMUR,MATRAMAN,UTAN KAYU SELATAN,3175011006,2020-10-30,888,42,847,12,-18,30
DKI JAKARTA,JAKARTA TIMUR,MATRAMAN,UTAN KAYU SELATAN,3175011006,2020-10-31,922,42,881,34,0,34
DKI JAKARTA,JAKARTA TIMUR,MATRAMAN,UTAN KAYU UTARA,3175011002,2020-10-01,551,42,509,0,0,0
DKI JAKARTA,JAKARTA TIMUR,MATRAMAN,UTAN KAYU UTARA,3175011002,2020-10-02,560,42,518,9,0,9
DKI JAKARTA,JAKARTA TIMUR,MATRAMAN,UTAN KAYU UTARA,3175011002,2020-10-03,563,44,519,3,2,1
DKI JAKARTA,JAKARTA TIMUR,MATRAMAN,UTAN KAYU UTARA,3175011002,2020-10-04,568,44,524,5,0,5
DKI JAKARTA,JAKARTA TIMUR,MATRAMAN,UTAN KAYU UTARA,3175011002,2020-10-05,577,45,532,9,1,8
DKI JAKARTA,JAKARTA TIMUR,MATRAMAN,UTAN KAYU UTARA,3175011002,2020-10-06,590,53,537,13,8,5
DKI JAKARTA,JAKARTA TIMUR,MATRAMAN,UTAN KAYU UTARA,3175011002,2020-10-07,593,47,546,3,-6,9
DKI JAKARTA,JAKARTA TIMUR,MATRAMAN,UTAN KAYU UTARA,3175011002,2020-10-08,593,44,549,0,-3,3
DKI JAKARTA,JAKARTA TIMUR,MATRAMAN,UTAN KAYU UTARA,3175011002,2020-10-09,596,45,551,3,1,2
DKI JAKARTA,JAKARTA TIMUR,MATRAMAN,UTAN KAYU UTARA,3175011002,2020-10-10,610,39,571,14,-6,20
DKI JAKARTA,JAKARTA TIMUR,MATRAMAN,UTAN KAYU UTARA,3175011002,2020-10-11,611,39,572,1,0,1
DKI JAKARTA,JAKARTA TIMUR,MATRAMAN,UTAN KAYU UTARA,3175011002,2020-10-12,614,35,579,3,-4,7
DKI JAKARTA,JAKARTA TIMUR,MATRAMAN,UTAN KAYU UTARA,3175011002,2020-10-13,620,39,581,6,4,2
DKI JAKARTA,JAKARTA TIMUR,MATRAMAN,UTAN KAYU UTARA,3175011002,2020-10-14,629,41,588,9,2,7
DKI JAKARTA,JAKARTA TIMUR,MATRAMAN,UTAN KAYU UTARA,3175011002,2020-10-15,635,45,590,6,4,2
DKI JAKARTA,JAKARTA TIMUR,MATRAMAN,UTAN KAYU UTARA,3175011002,2020-10-16,635,24,611,0,-21,21
DKI JAKARTA,JAKARTA TIMUR,MATRAMAN,UTAN KAYU UTARA,3175011002,2020-10-17,639,27,612,4,3,1
DKI JAKARTA,JAKARTA TIMUR,MATRAMAN,UTAN KAYU UTARA,3175011002,2020-10-18,643,30,613,4,3,1
DKI JAKARTA,JAKARTA TIMUR,MATRAMAN,UTAN KAYU UTARA,3175011002,2020-10-19,648,30,618,5,0,5
DKI JAKARTA,JAKARTA TIMUR,MATRAMAN,UTAN KAYU UTARA,3175011002,2020-10-20,653,34,619,5,4,1
DKI JAKARTA,JAKARTA TIMUR,MATRAMAN,UTAN KAYU UTARA,3175011002,2020-10-21,658,35,623,5,1,4
DKI JAKARTA,JAKARTA TIMUR,MATRAMAN,UTAN KAYU UTARA,3175011002,2020-10-22,662,37,625,4,2,2
DKI JAKARTA,JAKARTA TIMUR,MATRAMAN,UTAN KAYU UTARA,3175011002,2020-10-23,664,38,626,2,1,1
DKI JAKARTA,JAKARTA TIMUR,MATRAMAN,UTAN KAYU UTARA,3175011002,2020-10-24,670,33,637,6,-5,11
DKI JAKARTA,JAKARTA TIMUR,MATRAMAN,UTAN KAYU UTARA,3175011002,2020-10-25,672,34,638,2,1,1
DKI JAKARTA,JAKARTA TIMUR,MATRAMAN,UTAN KAYU UTARA,3175011002,2020-10-26,676,32,644,4,-2,6
DKI JAKARTA,JAKARTA TIMUR,MATRAMAN,UTAN KAYU UTARA,3175011002,2020-10-27,677,31,646,1,-1,2
DKI JAKARTA,JAKARTA TIMUR,MATRAMAN,UTAN KAYU UTARA,3175011002,2020-10-28,679,31,648,2,0,2
DKI JAKARTA,JAKARTA TIMUR,MATRAMAN,UTAN KAYU UTARA,3175011002,2020-10-29,685,31,655,6,0,7
DKI JAKARTA,JAKARTA TIMUR,MATRAMAN,UTAN KAYU UTARA,3175011002,2020-10-30,711,45,667,26,14,12
DKI JAKARTA,JAKARTA TIMUR,MATRAMAN,UTAN KAYU UTARA,3175011002,2020-10-31,721,55,667,10,10,0
DKI JAKARTA,JAKARTA TIMUR,PASAR REBO,BARU,3175051002,2020-10-01,328,20,308,0,0,0
DKI JAKARTA,JAKARTA TIMUR,PASAR REBO,BARU,3175051002,2020-10-02,341,31,310,13,11,2
DKI JAKARTA,JAKARTA TIMUR,PASAR REBO,BARU,3175051002,2020-10-03,342,32,310,1,1,0
DKI JAKARTA,JAKARTA TIMUR,PASAR REBO,BARU,3175051002,2020-10-04,344,32,312,2,0,2
DKI JAKARTA,JAKARTA TIMUR,PASAR REBO,BARU,3175051002,2020-10-05,345,32,313,1,0,1
DKI JAKARTA,JAKARTA TIMUR,PASAR REBO,BARU,3175051002,2020-10-06,350,34,316,5,2,3
DKI JAKARTA,JAKARTA TIMUR,PASAR REBO,BARU,3175051002,2020-10-07,354,31,323,4,-3,7
DKI JAKARTA,JAKARTA TIMUR,PASAR REBO,BARU,3175051002,2020-10-08,359,32,327,5,1,4
DKI JAKARTA,JAKARTA TIMUR,PASAR REBO,BARU,3175051002,2020-10-09,362,34,328,3,2,1
DKI JAKARTA,JAKARTA TIMUR,PASAR REBO,BARU,3175051002,2020-10-10,364,33,331,2,-1,3
DKI JAKARTA,JAKARTA TIMUR,PASAR REBO,BARU,3175051002,2020-10-11,367,36,331,3,3,0
DKI JAKARTA,JAKARTA TIMUR,PASAR REBO,BARU,3175051002,2020-10-12,368,27,341,1,-9,10
DKI JAKARTA,JAKARTA TIMUR,PASAR REBO,BARU,3175051002,2020-10-13,371,26,345,3,-1,4
DKI JAKARTA,JAKARTA TIMUR,PASAR REBO,BARU,3175051002,2020-10-14,373,22,351,2,-4,6
DKI JAKARTA,JAKARTA TIMUR,PASAR REBO,BARU,3175051002,2020-10-15,378,25,353,5,3,2
DKI JAKARTA,JAKARTA TIMUR,PASAR REBO,BARU,3175051002,2020-10-16,379,23,356,1,-2,3
DKI JAKARTA,JAKARTA TIMUR,PASAR REBO,BARU,3175051002,2020-10-17,387,29,358,8,6,2
DKI JAKARTA,JAKARTA TIMUR,PASAR REBO,BARU,3175051002,2020-10-18,389,31,358,2,2,0
DKI JAKARTA,JAKARTA TIMUR,PASAR REBO,BARU,3175051002,2020-10-19,390,27,363,1,-4,5
DKI JAKARTA,JAKARTA TIMUR,PASAR REBO,BARU,3175051002,2020-10-20,390,26,364,0,-1,1
DKI JAKARTA,JAKARTA TIMUR,PASAR REBO,BARU,3175051002,2020-10-21,391,23,368,1,-3,4
DKI JAKARTA,JAKARTA TIMUR,PASAR REBO,BARU,3175051002,2020-10-22,392,20,372,1,-3,4
DKI JAKARTA,JAKARTA TIMUR,PASAR REBO,BARU,3175051002,2020-10-23,395,22,373,3,2,1
DKI JAKARTA,JAKARTA TIMUR,PASAR REBO,BARU,3175051002,2020-10-24,395,20,375,0,-2,2
DKI JAKARTA,JAKARTA TIMUR,PASAR REBO,BARU,3175051002,2020-10-25,397,18,379,2,-2,4
DKI JAKARTA,JAKARTA TIMUR,PASAR REBO,BARU,3175051002,2020-10-26,397,15,382,0,-3,3
DKI JAKARTA,JAKARTA TIMUR,PASAR REBO,BARU,3175051002,2020-10-27,397,13,384,0,-2,2
DKI JAKARTA,JAKARTA TIMUR,PASAR REBO,BARU,3175051002,2020-10-28,397,12,385,0,-1,1
DKI JAKARTA,JAKARTA TIMUR,PASAR REBO,BARU,3175051002,2020-10-29,398,6,392,1,-6,7
DKI JAKARTA,JAKARTA TIMUR,PASAR REBO,BARU,3175051002,2020-10-30,404,9,395,6,3,3
DKI JAKARTA,JAKARTA TIMUR,PASAR REBO,BARU,3175051002,2020-10-31,405,10,395,1,1,0
DKI JAKARTA,JAKARTA TIMUR,PASAR REBO,CIJANTUNG,3175051003,2020-10-01,436,30,406,0,0,0
DKI JAKARTA,JAKARTA TIMUR,PASAR REBO,CIJANTUNG,3175051003,2020-10-02,442,31,411,6,1,5
DKI JAKARTA,JAKARTA TIMUR,PASAR REBO,CIJANTUNG,3175051003,2020-10-03,446,33,413,4,2,2
DKI JAKARTA,JAKARTA TIMUR,PASAR REBO,CIJANTUNG,3175051003,2020-10-04,454,38,416,8,5,3
DKI JAKARTA,JAKARTA TIMUR,PASAR REBO,CIJANTUNG,3175051003,2020-10-05,456,36,420,2,-2,4
DKI JAKARTA,JAKARTA TIMUR,PASAR REBO,CIJANTUNG,3175051003,2020-10-06,458,36,422,2,0,2
DKI JAKARTA,JAKARTA TIMUR,PASAR REBO,CIJANTUNG,3175051003,2020-10-07,461,35,426,3,-1,4
DKI JAKARTA,JAKARTA TIMUR,PASAR REBO,CIJANTUNG,3175051003,2020-10-08,466,34,432,5,-1,6
DKI JAKARTA,JAKARTA TIMUR,PASAR REBO,CIJANTUNG,3175051003,2020-10-09,470,38,432,4,4,0
DKI JAKARTA,JAKARTA TIMUR,PASAR REBO,CIJANTUNG,3175051003,2020-10-10,477,36,441,7,-2,9
DKI JAKARTA,JAKARTA TIMUR,PASAR REBO,CIJANTUNG,3175051003,2020-10-11,481,39,442,4,3,1
DKI JAKARTA,JAKARTA TIMUR,PASAR REBO,CIJANTUNG,3175051003,2020-10-12,482,34,448,1,-5,6
DKI JAKARTA,JAKARTA TIMUR,PASAR REBO,CIJANTUNG,3175051003,2020-10-13,483,32,451,1,-2,3
DKI JAKARTA,JAKARTA TIMUR,PASAR REBO,CIJANTUNG,3175051003,2020-10-14,485,28,457,2,-4,6
DKI JAKARTA,JAKARTA TIMUR,PASAR REBO,CIJANTUNG,3175051003,2020-10-15,491,28,463,6,0,6
DKI JAKARTA,JAKARTA TIMUR,PASAR REBO,CIJANTUNG,3175051003,2020-10-16,495,28,467,4,0,4
DKI JAKARTA,JAKARTA TIMUR,PASAR REBO,CIJANTUNG,3175051003,2020-10-17,516,48,468,21,20,1
DKI JAKARTA,JAKARTA TIMUR,PASAR REBO,CIJANTUNG,3175051003,2020-10-18,519,50,469,3,2,1
DKI JAKARTA,JAKARTA TIMUR,PASAR REBO,CIJANTUNG,3175051003,2020-10-19,523,48,475,4,-2,6
DKI JAKARTA,JAKARTA TIMUR,PASAR REBO,CIJANTUNG,3175051003,2020-10-20,528,47,481,5,-1,6
DKI JAKARTA,JAKARTA TIMUR,PASAR REBO,CIJANTUNG,3175051003,2020-10-21,529,44,485,1,-3,4
DKI JAKARTA,JAKARTA TIMUR,PASAR REBO,CIJANTUNG,3175051003,2020-10-22,533,40,493,4,-4,8
DKI JAKARTA,JAKARTA TIMUR,PASAR REBO,CIJANTUNG,3175051003,2020-10-23,535,40,495,2,0,2
DKI JAKARTA,JAKARTA TIMUR,PASAR REBO,CIJANTUNG,3175051003,2020-10-24,537,37,500,2,-3,5
DKI JAKARTA,JAKARTA TIMUR,PASAR REBO,CIJANTUNG,3175051003,2020-10-25,540,38,502,3,1,2
DKI JAKARTA,JAKARTA TIMUR,PASAR REBO,CIJANTUNG,3175051003,2020-10-26,547,40,507,7,2,5
DKI JAKARTA,JAKARTA TIMUR,PASAR REBO,CIJANTUNG,3175051003,2020-10-27,551,41,510,4,1,3
DKI JAKARTA,JAKARTA TIMUR,PASAR REBO,CIJANTUNG,3175051003,2020-10-28,556,42,514,5,1,4
DKI JAKARTA,JAKARTA TIMUR,PASAR REBO,CIJANTUNG,3175051003,2020-10-29,557,18,539,1,-24,25
DKI JAKARTA,JAKARTA TIMUR,PASAR REBO,CIJANTUNG,3175051003,2020-10-30,559,18,541,2,0,2
DKI JAKARTA,JAKARTA TIMUR,PASAR REBO,CIJANTUNG,3175051003,2020-10-31,561,19,542,2,1,1
DKI JAKARTA,JAKARTA TIMUR,PASAR REBO,GEDONG,3175051001,2020-10-01,305,33,272,0,0,0
DKI JAKARTA,JAKARTA TIMUR,PASAR REBO,GEDONG,3175051001,2020-10-02,317,43,274,12,10,2
DKI JAKARTA,JAKARTA TIMUR,PASAR REBO,GEDONG,3175051001,2020-10-03,322,46,276,5,3,2
DKI JAKARTA,JAKARTA TIMUR,PASAR REBO,GEDONG,3175051001,2020-10-04,330,51,279,8,5,3
DKI JAKARTA,JAKARTA TIMUR,PASAR REBO,GEDONG,3175051001,2020-10-05,331,50,281,1,-1,2
DKI JAKARTA,JAKARTA TIMUR,PASAR REBO,GEDONG,3175051001,2020-10-06,331,45,286,0,-5,5
DKI JAKARTA,JAKARTA TIMUR,PASAR REBO,GEDONG,3175051001,2020-10-07,337,49,288,6,4,2
DKI JAKARTA,JAKARTA TIMUR,PASAR REBO,GEDONG,3175051001,2020-10-08,347,54,293,10,5,5
DKI JAKARTA,JAKARTA TIMUR,PASAR REBO,GEDONG,3175051001,2020-10-09,351,57,294,4,3,1
DKI JAKARTA,JAKARTA TIMUR,PASAR REBO,GEDONG,3175051001,2020-10-10,355,49,306,4,-8,12
DKI JAKARTA,JAKARTA TIMUR,PASAR REBO,GEDONG,3175051001,2020-10-11,362,55,307,7,6,1
DKI JAKARTA,JAKARTA TIMUR,PASAR REBO,GEDONG,3175051001,2020-10-12,368,55,313,6,0,6
DKI JAKARTA,JAKARTA TIMUR,PASAR REBO,GEDONG,3175051001,2020-10-13,369,43,326,1,-12,13
DKI JAKARTA,JAKARTA TIMUR,PASAR REBO,GEDONG,3175051001,2020-10-14,370,39,331,1,-4,5
DKI JAKARTA,JAKARTA TIMUR,PASAR REBO,GEDONG,3175051001,2020-10-15,378,41,337,8,2,6
DKI JAKARTA,JAKARTA TIMUR,PASAR REBO,GEDONG,3175051001,2020-10-16,385,42,343,7,1,6
DKI JAKARTA,JAKARTA TIMUR,PASAR REBO,GEDONG,3175051001,2020-10-17,404,59,345,19,17,2
DKI JAKARTA,JAKARTA TIMUR,PASAR REBO,GEDONG,3175051001,2020-10-18,405,58,347,1,-1,2
DKI JAKARTA,JAKARTA TIMUR,PASAR REBO,GEDONG,3175051001,2020-10-19,406,49,357,1,-9,10
DKI JAKARTA,JAKARTA TIMUR,PASAR REBO,GEDONG,3175051001,2020-10-20,411,48,363,5,-1,6
DKI JAKARTA,JAKARTA TIMUR,PASAR REBO,GEDONG,3175051001,2020-10-21,410,43,367,-1,-5,4
DKI JAKARTA,JAKARTA TIMUR,PASAR REBO,GEDONG,3175051001,2020-10-22,416,40,376,6,-3,9
DKI JAKARTA,JAKARTA TIMUR,PASAR REBO,GEDONG,3175051001,2020-10-23,416,40,376,0,0,0
DKI JAKARTA,JAKARTA TIMUR,PASAR REBO,GEDONG,3175051001,2020-10-24,420,40,380,4,0,4
DKI JAKARTA,JAKARTA TIMUR,PASAR REBO,GEDONG,3175051001,2020-10-25,424,43,381,4,3,1
DKI JAKARTA,JAKARTA TIMUR,PASAR REBO,GEDONG,3175051001,2020-10-26,430,41,389,6,-2,8
DKI JAKARTA,JAKARTA TIMUR,PASAR REBO,GEDONG,3175051001,2020-10-27,433,37,396,3,-4,7
DKI JAKARTA,JAKARTA TIMUR,PASAR REBO,GEDONG,3175051001,2020-10-28,433,31,402,0,-6,6
DKI JAKARTA,JAKARTA TIMUR,PASAR REBO,GEDONG,3175051001,2020-10-29,438,17,421,5,-14,19
DKI JAKARTA,JAKARTA TIMUR,PASAR REBO,GEDONG,3175051001,2020-10-30,444,22,422,6,5,1
DKI JAKARTA,JAKARTA TIMUR,PASAR REBO,GEDONG,3175051001,2020-10-31,448,24,424,4,2,2
DKI JAKARTA,JAKARTA TIMUR,PASAR REBO,KALISARI,3175051004,2020-10-01,391,31,360,0,0,0
DKI JAKARTA,JAKARTA TIMUR,PASAR REBO,KALISARI,3175051004,2020-10-02,405,33,372,14,2,12
DKI JAKARTA,JAKARTA TIMUR,PASAR REBO,KALISARI,3175051004,2020-10-03,409,35,374,4,2,2
DKI JAKARTA,JAKARTA TIMUR,PASAR REBO,KALISARI,3175051004,2020-10-04,415,39,376,6,4,2
DKI JAKARTA,JAKARTA TIMUR,PASAR REBO,KALISARI,3175051004,2020-10-05,418,38,380,3,-1,4
DKI JAKARTA,JAKARTA TIMUR,PASAR REBO,KALISARI,3175051004,2020-10-06,419,36,383,1,-2,3
DKI JAKARTA,JAKARTA TIMUR,PASAR REBO,KALISARI,3175051004,2020-10-07,423,35,388,4,-1,5
DKI JAKARTA,JAKARTA TIMUR,PASAR REBO,KALISARI,3175051004,2020-10-08,429,33,396,6,-2,8
DKI JAKARTA,JAKARTA TIMUR,PASAR REBO,KALISARI,3175051004,2020-10-09,434,37,397,5,4,1
DKI JAKARTA,JAKARTA TIMUR,PASAR REBO,KALISARI,3175051004,2020-10-10,445,38,407,11,1,10
DKI JAKARTA,JAKARTA TIMUR,PASAR REBO,KALISARI,3175051004,2020-10-11,452,39,413,7,1,6
DKI JAKARTA,JAKARTA TIMUR,PASAR REBO,KALISARI,3175051004,2020-10-12,460,42,418,8,3,5
DKI JAKARTA,JAKARTA TIMUR,PASAR REBO,KALISARI,3175051004,2020-10-13,464,42,422,4,0,4
DKI JAKARTA,JAKARTA TIMUR,PASAR REBO,KALISARI,3175051004,2020-10-14,468,43,425,4,1,3
DKI JAKARTA,JAKARTA TIMUR,PASAR REBO,KALISARI,3175051004,2020-10-15,475,40,435,7,-3,10
DKI JAKARTA,JAKARTA TIMUR,PASAR REBO,KALISARI,3175051004,2020-10-16,482,43,439,7,3,4
DKI JAKARTA,JAKARTA TIMUR,PASAR REBO,KALISARI,3175051004,2020-10-17,504,65,439,22,22,0
DKI JAKARTA,JAKARTA TIMUR,PASAR REBO,KALISARI,3175051004,2020-10-18,508,69,439,4,4,0
DKI JAKARTA,JAKARTA TIMUR,PASAR REBO,KALISARI,3175051004,2020-10-19,509,62,447,1,-7,8
DKI JAKARTA,JAKARTA TIMUR,PASAR REBO,KALISARI,3175051004,2020-10-20,513,63,450,4,1,3
DKI JAKARTA,JAKARTA TIMUR,PASAR REBO,KALISARI,3175051004,2020-10-21,514,57,457,1,-6,7
DKI JAKARTA,JAKARTA TIMUR,PASAR REBO,KALISARI,3175051004,2020-10-22,516,49,467,2,-8,10
DKI JAKARTA,JAKARTA TIMUR,PASAR REBO,KALISARI,3175051004,2020-10-23,519,51,468,3,2,1
DKI JAKARTA,JAKARTA TIMUR,PASAR REBO,KALISARI,3175051004,2020-10-24,523,42,481,4,-9,13
DKI JAKARTA,JAKARTA TIMUR,PASAR REBO,KALISARI,3175051004,2020-10-25,526,44,482,3,2,1
DKI JAKARTA,JAKARTA TIMUR,PASAR REBO,KALISARI,3175051004,2020-10-26,529,42,487,3,-2,5
DKI JAKARTA,JAKARTA TIMUR,PASAR REBO,KALISARI,3175051004,2020-10-27,533,39,494,4,-3,7
DKI JAKARTA,JAKARTA TIMUR,PASAR REBO,KALISARI,3175051004,2020-10-28,534,37,497,1,-2,3
DKI JAKARTA,JAKARTA TIMUR,PASAR REBO,KALISARI,3175051004,2020-10-29,542,14,528,8,-23,31
DKI JAKARTA,JAKARTA TIMUR,PASAR REBO,KALISARI,3175051004,2020-10-30,557,26,531,15,12,3
DKI JAKARTA,JAKARTA TIMUR,PASAR REBO,KALISARI,3175051004,2020-10-31,558,27,531,1,1,0
DKI JAKARTA,JAKARTA TIMUR,PASAR REBO,PEKAYON,3175051005,2020-10-01,269,22,247,0,0,0
DKI JAKARTA,JAKARTA TIMUR,PASAR REBO,PEKAYON,3175051005,2020-10-02,279,29,250,10,7,3
DKI JAKARTA,JAKARTA TIMUR,PASAR REBO,PEKAYON,3175051005,2020-10-03,283,32,251,4,3,1
DKI JAKARTA,JAKARTA TIMUR,PASAR REBO,PEKAYON,3175051005,2020-10-04,290,38,252,7,6,1
DKI JAKARTA,JAKARTA TIMUR,PASAR REBO,PEKAYON,3175051005,2020-10-05,293,36,257,3,-2,5
DKI JAKARTA,JAKARTA TIMUR,PASAR REBO,PEKAYON,3175051005,2020-10-06,297,33,264,4,-3,7
DKI JAKARTA,JAKARTA TIMUR,PASAR REBO,PEKAYON,3175051005,2020-10-07,302,36,266,5,3,2
DKI JAKARTA,JAKARTA TIMUR,PASAR REBO,PEKAYON,3175051005,2020-10-08,307,36,271,5,0,5
DKI JAKARTA,JAKARTA TIMUR,PASAR REBO,PEKAYON,3175051005,2020-10-09,308,37,271,1,1,0
DKI JAKARTA,JAKARTA TIMUR,PASAR REBO,PEKAYON,3175051005,2020-10-10,309,33,276,1,-4,5
DKI JAKARTA,JAKARTA TIMUR,PASAR REBO,PEKAYON,3175051005,2020-10-11,314,37,277,5,4,1
DKI JAKARTA,JAKARTA TIMUR,PASAR REBO,PEKAYON,3175051005,2020-10-12,317,32,285,3,-5,8
DKI JAKARTA,JAKARTA TIMUR,PASAR REBO,PEKAYON,3175051005,2020-10-13,318,29,289,1,-3,4
DKI JAKARTA,JAKARTA TIMUR,PASAR REBO,PEKAYON,3175051005,2020-10-14,321,24,297,3,-5,8
DKI JAKARTA,JAKARTA TIMUR,PASAR REBO,PEKAYON,3175051005,2020-10-15,330,27,303,9,3,6
DKI JAKARTA,JAKARTA TIMUR,PASAR REBO,PEKAYON,3175051005,2020-10-16,335,26,309,5,-1,6
DKI JAKARTA,JAKARTA TIMUR,PASAR REBO,PEKAYON,3175051005,2020-10-17,360,50,310,25,24,1
DKI JAKARTA,JAKARTA TIMUR,PASAR REBO,PEKAYON,3175051005,2020-10-18,361,51,310,1,1,0
DKI JAKARTA,JAKARTA TIMUR,PASAR REBO,PEKAYON,3175051005,2020-10-19,363,51,312,2,0,2
DKI JAKARTA,JAKARTA TIMUR,PASAR REBO,PEKAYON,3175051005,2020-10-20,366,50,316,3,-1,4
DKI JAKARTA,JAKARTA TIMUR,PASAR REBO,PEKAYON,3175051005,2020-10-21,367,49,318,1,-1,2
DKI JAKARTA,JAKARTA TIMUR,PASAR REBO,PEKAYON,3175051005,2020-10-22,370,48,322,3,-1,4
DKI JAKARTA,JAKARTA TIMUR,PASAR REBO,PEKAYON,3175051005,2020-10-23,371,48,323,1,0,1
DKI JAKARTA,JAKARTA TIMUR,PASAR REBO,PEKAYON,3175051005,2020-10-24,375,46,329,4,-2,6
DKI JAKARTA,JAKARTA TIMUR,PASAR REBO,PEKAYON,3175051005,2020-10-25,377,48,329,2,2,0
DKI JAKARTA,JAKARTA TIMUR,PASAR REBO,PEKAYON,3175051005,2020-10-26,384,46,338,7,-2,9
DKI JAKARTA,JAKARTA TIMUR,PASAR REBO,PEKAYON,3175051005,2020-10-27,387,43,344,3,-3,6
DKI JAKARTA,JAKARTA TIMUR,PASAR REBO,PEKAYON,3175051005,2020-10-28,392,42,350,5,-1,6
DKI JAKARTA,JAKARTA TIMUR,PASAR REBO,PEKAYON,3175051005,2020-10-29,396,17,379,4,-25,29
DKI JAKARTA,JAKARTA TIMUR,PASAR REBO,PEKAYON,3175051005,2020-10-30,403,20,383,7,3,4
DKI JAKARTA,JAKARTA TIMUR,PASAR REBO,PEKAYON,3175051005,2020-10-31,403,20,383,0,0,0
DKI JAKARTA,JAKARTA TIMUR,PULO GADUNG,CIPINANG,3175021003,2020-10-01,709,39,670,0,0,0
DKI JAKARTA,JAKARTA TIMUR,PULO GADUNG,CIPINANG,3175021003,2020-10-02,716,38,678,7,-1,8
DKI JAKARTA,JAKARTA TIMUR,PULO GADUNG,CIPINANG,3175021003,2020-10-03,731,49,682,15,11,4
DKI JAKARTA,JAKARTA TIMUR,PULO GADUNG,CIPINANG,3175021003,2020-10-04,738,55,683,7,6,1
DKI JAKARTA,JAKARTA TIMUR,PULO GADUNG,CIPINANG,3175021003,2020-10-05,754,63,691,16,8,8
DKI JAKARTA,JAKARTA TIMUR,PULO GADUNG,CIPINANG,3175021003,2020-10-06,765,67,698,11,4,7
DKI JAKARTA,JAKARTA TIMUR,PULO GADUNG,CIPINANG,3175021003,2020-10-07,779,72,707,14,5,9
DKI JAKARTA,JAKARTA TIMUR,PULO GADUNG,CIPINANG,3175021003,2020-10-08,794,86,708,15,14,1
DKI JAKARTA,JAKARTA TIMUR,PULO GADUNG,CIPINANG,3175021003,2020-10-09,801,91,710,7,5,2
DKI JAKARTA,JAKARTA TIMUR,PULO GADUNG,CIPINANG,3175021003,2020-10-10,801,87,714,0,-4,4
DKI JAKARTA,JAKARTA TIMUR,PULO GADUNG,CIPINANG,3175021003,2020-10-11,814,96,718,13,9,4
DKI JAKARTA,JAKARTA TIMUR,PULO GADUNG,CIPINANG,3175021003,2020-10-12,824,102,722,10,6,4
DKI JAKARTA,JAKARTA TIMUR,PULO GADUNG,CIPINANG,3175021003,2020-10-13,828,95,733,4,-7,11
DKI JAKARTA,JAKARTA TIMUR,PULO GADUNG,CIPINANG,3175021003,2020-10-14,839,89,750,11,-6,17
DKI JAKARTA,JAKARTA TIMUR,PULO GADUNG,CIPINANG,3175021003,2020-10-15,858,83,775,19,-6,25
DKI JAKARTA,JAKARTA TIMUR,PULO GADUNG,CIPINANG,3175021003,2020-10-16,865,72,793,7,-11,18
DKI JAKARTA,JAKARTA TIMUR,PULO GADUNG,CIPINANG,3175021003,2020-10-17,873,77,796,8,5,3
DKI JAKARTA,JAKARTA TIMUR,PULO GADUNG,CIPINANG,3175021003,2020-10-18,879,83,796,6,6,0
DKI JAKARTA,JAKARTA TIMUR,PULO GADUNG,CIPINANG,3175021003,2020-10-19,883,75,808,4,-8,12
DKI JAKARTA,JAKARTA TIMUR,PULO GADUNG,CIPINANG,3175021003,2020-10-20,894,76,818,11,1,10
DKI JAKARTA,JAKARTA TIMUR,PULO GADUNG,CIPINANG,3175021003,2020-10-21,899,79,820,5,3,2
DKI JAKARTA,JAKARTA TIMUR,PULO GADUNG,CIPINANG,3175021003,2020-10-22,906,75,831,7,-4,11
DKI JAKARTA,JAKARTA TIMUR,PULO GADUNG,CIPINANG,3175021003,2020-10-23,909,78,831,3,3,0
DKI JAKARTA,JAKARTA TIMUR,PULO GADUNG,CIPINANG,3175021003,2020-10-24,911,69,842,2,-9,11
DKI JAKARTA,JAKARTA TIMUR,PULO GADUNG,CIPINANG,3175021003,2020-10-25,914,69,845,3,0,3
DKI JAKARTA,JAKARTA TIMUR,PULO GADUNG,CIPINANG,3175021003,2020-10-26,915,52,863,1,-17,18
DKI JAKARTA,JAKARTA TIMUR,PULO GADUNG,CIPINANG,3175021003,2020-10-27,919,49,870,4,-3,7
DKI JAKARTA,JAKARTA TIMUR,PULO GADUNG,CIPINANG,3175021003,2020-10-28,926,41,885,7,-8,15
DKI JAKARTA,JAKARTA TIMUR,PULO GADUNG,CIPINANG,3175021003,2020-10-29,928,34,895,2,-7,10
DKI JAKARTA,JAKARTA TIMUR,PULO GADUNG,CIPINANG,3175021003,2020-10-30,934,31,904,6,-3,9
DKI JAKARTA,JAKARTA TIMUR,PULO GADUNG,CIPINANG,3175021003,2020-10-31,940,36,905,6,5,1
DKI JAKARTA,JAKARTA TIMUR,PULO GADUNG,JATI,3175021007,2020-10-01,778,68,710,0,0,0
DKI JAKARTA,JAKARTA TIMUR,PULO GADUNG,JATI,3175021007,2020-10-02,792,75,717,14,7,7
DKI JAKARTA,JAKARTA TIMUR,PULO GADUNG,JATI,3175021007,2020-10-03,801,79,722,9,4,5
DKI JAKARTA,JAKARTA TIMUR,PULO GADUNG,JATI,3175021007,2020-10-04,807,83,724,6,4,2
DKI JAKARTA,JAKARTA TIMUR,PULO GADUNG,JATI,3175021007,2020-10-05,814,81,733,7,-2,9
DKI JAKARTA,JAKARTA TIMUR,PULO GADUNG,JATI,3175021007,2020-10-06,817,76,741,3,-5,8
DKI JAKARTA,JAKARTA TIMUR,PULO GADUNG,JATI,3175021007,2020-10-07,827,80,747,10,4,6
DKI JAKARTA,JAKARTA TIMUR,PULO GADUNG,JATI,3175021007,2020-10-08,840,77,763,13,-3,16
DKI JAKARTA,JAKARTA TIMUR,PULO GADUNG,JATI,3175021007,2020-10-09,843,80,763,3,3,0
DKI JAKARTA,JAKARTA TIMUR,PULO GADUNG,JATI,3175021007,2020-10-10,850,79,771,7,-1,8
DKI JAKARTA,JAKARTA TIMUR,PULO GADUNG,JATI,3175021007,2020-10-11,856,81,775,6,2,4
DKI JAKARTA,JAKARTA TIMUR,PULO GADUNG,JATI,3175021007,2020-10-12,862,68,794,6,-13,19
DKI JAKARTA,JAKARTA TIMUR,PULO GADUNG,JATI,3175021007,2020-10-13,865,58,807,3,-10,13
DKI JAKARTA,JAKARTA TIMUR,PULO GADUNG,JATI,3175021007,2020-10-14,874,56,818,9,-2,11
DKI JAKARTA,JAKARTA TIMUR,PULO GADUNG,JATI,3175021007,2020-10-15,876,55,821,2,-1,3
DKI JAKARTA,JAKARTA TIMUR,PULO GADUNG,JATI,3175021007,2020-10-16,883,43,840,7,-12,19
DKI JAKARTA,JAKARTA TIMUR,PULO GADUNG,JATI,3175021007,2020-10-17,892,48,844,9,5,4
DKI JAKARTA,JAKARTA TIMUR,PULO GADUNG,JATI,3175021007,2020-10-18,901,56,845,9,8,1
DKI JAKARTA,JAKARTA TIMUR,PULO GADUNG,JATI,3175021007,2020-10-19,905,55,850,4,-1,5
DKI JAKARTA,JAKARTA TIMUR,PULO GADUNG,JATI,3175021007,2020-10-20,914,52,862,9,-3,12
DKI JAKARTA,JAKARTA TIMUR,PULO GADUNG,JATI,3175021007,2020-10-21,923,52,871,9,0,9
DKI JAKARTA,JAKARTA TIMUR,PULO GADUNG,JATI,3175021007,2020-10-22,929,51,878,6,-1,7
DKI JAKARTA,JAKARTA TIMUR,PULO GADUNG,JATI,3175021007,2020-10-23,935,56,879,6,5,1
DKI JAKARTA,JAKARTA TIMUR,PULO GADUNG,JATI,3175021007,2020-10-24,941,51,890,6,-5,11
DKI JAKARTA,JAKARTA TIMUR,PULO GADUNG,JATI,3175021007,2020-10-25,944,52,892,3,1,2
DKI JAKARTA,JAKARTA TIMUR,PULO GADUNG,JATI,3175021007,2020-10-26,946,48,898,2,-4,6
DKI JAKARTA,JAKARTA TIMUR,PULO GADUNG,JATI,3175021007,2020-10-27,948,48,900,2,0,2
DKI JAKARTA,JAKARTA TIMUR,PULO GADUNG,JATI,3175021007,2020-10-28,950,41,909,2,-7,9
DKI JAKARTA,JAKARTA TIMUR,PULO GADUNG,JATI,3175021007,2020-10-29,957,39,918,7,-2,9
DKI JAKARTA,JAKARTA TIMUR,PULO GADUNG,JATI,3175021007,2020-10-30,964,39,925,7,0,7
DKI JAKARTA,JAKARTA TIMUR,PULO GADUNG,JATI,3175021007,2020-10-31,973,45,928,9,6,3
DKI JAKARTA,JAKARTA TIMUR,PULO GADUNG,JATINEGARA KAUM,3175021004,2020-10-01,273,39,234,0,0,0
DKI JAKARTA,JAKARTA TIMUR,PULO GADUNG,JATINEGARA KAUM,3175021004,2020-10-02,280,44,236,7,5,2
DKI JAKARTA,JAKARTA TIMUR,PULO GADUNG,JATINEGARA KAUM,3175021004,2020-10-03,287,51,236,7,7,0
DKI JAKARTA,JAKARTA TIMUR,PULO GADUNG,JATINEGARA KAUM,3175021004,2020-10-04,289,52,237,2,1,1
DKI JAKARTA,JAKARTA TIMUR,PULO GADUNG,JATINEGARA KAUM,3175021004,2020-10-05,295,55,240,6,3,3
DKI JAKARTA,JAKARTA TIMUR,PULO GADUNG,JATINEGARA KAUM,3175021004,2020-10-06,304,55,249,9,0,9
DKI JAKARTA,JAKARTA TIMUR,PULO GADUNG,JATINEGARA KAUM,3175021004,2020-10-07,310,55,255,6,0,6
DKI JAKARTA,JAKARTA TIMUR,PULO GADUNG,JATINEGARA KAUM,3175021004,2020-10-08,317,56,261,7,1,6
DKI JAKARTA,JAKARTA TIMUR,PULO GADUNG,JATINEGARA KAUM,3175021004,2020-10-09,317,56,261,0,0,0
DKI JAKARTA,JAKARTA TIMUR,PULO GADUNG,JATINEGARA KAUM,3175021004,2020-10-10,320,56,264,3,0,3
DKI JAKARTA,JAKARTA TIMUR,PULO GADUNG,JATINEGARA KAUM,3175021004,2020-10-11,326,62,264,6,6,0
DKI JAKARTA,JAKARTA TIMUR,PULO GADUNG,JATINEGARA KAUM,3175021004,2020-10-12,328,56,272,2,-6,8
DKI JAKARTA,JAKARTA TIMUR,PULO GADUNG,JATINEGARA KAUM,3175021004,2020-10-13,328,42,286,0,-14,14
DKI JAKARTA,JAKARTA TIMUR,PULO GADUNG,JATINEGARA KAUM,3175021004,2020-10-14,332,40,292,4,-2,6
DKI JAKARTA,JAKARTA TIMUR,PULO GADUNG,JATINEGARA KAUM,3175021004,2020-10-15,339,38,301,7,-2,9
DKI JAKARTA,JAKARTA TIMUR,PULO GADUNG,JATINEGARA KAUM,3175021004,2020-10-16,343,33,310,4,-5,9
DKI JAKARTA,JAKARTA TIMUR,PULO GADUNG,JATINEGARA KAUM,3175021004,2020-10-17,348,37,311,5,4,1
DKI JAKARTA,JAKARTA TIMUR,PULO GADUNG,JATINEGARA KAUM,3175021004,2020-10-18,352,41,311,4,4,0
DKI JAKARTA,JAKARTA TIMUR,PULO GADUNG,JATINEGARA KAUM,3175021004,2020-10-19,357,37,320,5,-4,9
DKI JAKARTA,JAKARTA TIMUR,PULO GADUNG,JATINEGARA KAUM,3175021004,2020-10-20,363,40,323,6,3,3
DKI JAKARTA,JAKARTA TIMUR,PULO GADUNG,JATINEGARA KAUM,3175021004,2020-10-21,376,50,326,13,10,3
DKI JAKARTA,JAKARTA TIMUR,PULO GADUNG,JATINEGARA KAUM,3175021004,2020-10-22,379,48,331,3,-2,5
DKI JAKARTA,JAKARTA TIMUR,PULO GADUNG,JATINEGARA KAUM,3175021004,2020-10-23,385,54,331,6,6,0
DKI JAKARTA,JAKARTA TIMUR,PULO GADUNG,JATINEGARA KAUM,3175021004,2020-10-24,388,52,336,3,-2,5
DKI JAKARTA,JAKARTA TIMUR,PULO GADUNG,JATINEGARA KAUM,3175021004,2020-10-25,392,54,338,4,2,2
DKI JAKARTA,JAKARTA TIMUR,PULO GADUNG,JATINEGARA KAUM,3175021004,2020-10-26,392,47,345,0,-7,7
DKI JAKARTA,JAKARTA TIMUR,PULO GADUNG,JATINEGARA KAUM,3175021004,2020-10-27,395,48,347,3,1,2
DKI JAKARTA,JAKARTA TIMUR,PULO GADUNG,JATINEGARA KAUM,3175021004,2020-10-28,403,51,352,8,3,5
DKI JAKARTA,JAKARTA TIMUR,PULO GADUNG,JATINEGARA KAUM,3175021004,2020-10-29,405,49,356,2,-2,4
DKI JAKARTA,JAKARTA TIMUR,PULO GADUNG,JATINEGARA KAUM,3175021004,2020-10-30,406,40,366,1,-9,10
DKI JAKARTA,JAKARTA TIMUR,PULO GADUNG,JATINEGARA KAUM,3175021004,2020-10-31,407,41,366,1,1,0
DKI JAKARTA,JAKARTA TIMUR,PULO GADUNG,KAYU PUTIH,3175021006,2020-10-01,933,79,854,0,0,0
DKI JAKARTA,JAKARTA TIMUR,PULO GADUNG,KAYU PUTIH,3175021006,2020-10-02,948,83,865,15,4,11
DKI JAKARTA,JAKARTA TIMUR,PULO GADUNG,KAYU PUTIH,3175021006,2020-10-03,953,85,868,5,2,3
DKI JAKARTA,JAKARTA TIMUR,PULO GADUNG,KAYU PUTIH,3175021006,2020-10-04,955,85,870,2,0,2
DKI JAKARTA,JAKARTA TIMUR,PULO GADUNG,KAYU PUTIH,3175021006,2020-10-05,962,80,882,7,-5,12
DKI JAKARTA,JAKARTA TIMUR,PULO GADUNG,KAYU PUTIH,3175021006,2020-10-06,965,75,890,3,-5,8
DKI JAKARTA,JAKARTA TIMUR,PULO GADUNG,KAYU PUTIH,3175021006,2020-10-07,968,56,912,3,-19,22
DKI JAKARTA,JAKARTA TIMUR,PULO GADUNG,KAYU PUTIH,3175021006,2020-10-08,986,60,926,18,4,14
DKI JAKARTA,JAKARTA TIMUR,PULO GADUNG,KAYU PUTIH,3175021006,2020-10-09,992,64,928,6,4,2
DKI JAKARTA,JAKARTA TIMUR,PULO GADUNG,KAYU PUTIH,3175021006,2020-10-10,998,63,935,6,-1,7
DKI JAKARTA,JAKARTA TIMUR,PULO GADUNG,KAYU PUTIH,3175021006,2020-10-11,1008,69,939,10,6,4
DKI JAKARTA,JAKARTA TIMUR,PULO GADUNG,KAYU PUTIH,3175021006,2020-10-12,1011,60,951,3,-9,12
DKI JAKARTA,JAKARTA TIMUR,PULO GADUNG,KAYU PUTIH,3175021006,2020-10-13,1016,58,958,5,-2,7
DKI JAKARTA,JAKARTA TIMUR,PULO GADUNG,KAYU PUTIH,3175021006,2020-10-14,1026,58,968,10,0,10
DKI JAKARTA,JAKARTA TIMUR,PULO GADUNG,KAYU PUTIH,3175021006,2020-10-15,1036,60,976,10,2,8
DKI JAKARTA,JAKARTA TIMUR,PULO GADUNG,KAYU PUTIH,3175021006,2020-10-16,1050,68,982,14,8,6
DKI JAKARTA,JAKARTA TIMUR,PULO GADUNG,KAYU PUTIH,3175021006,2020-10-17,1071,83,988,21,15,6
DKI JAKARTA,JAKARTA TIMUR,PULO GADUNG,KAYU PUTIH,3175021006,2020-10-18,1078,88,990,7,5,2
DKI JAKARTA,JAKARTA TIMUR,PULO GADUNG,KAYU PUTIH,3175021006,2020-10-19,1083,79,1004,5,-9,14
DKI JAKARTA,JAKARTA TIMUR,PULO GADUNG,KAYU PUTIH,3175021006,2020-10-20,1086,75,1011,3,-4,7
DKI JAKARTA,JAKARTA TIMUR,PULO GADUNG,KAYU PUTIH,3175021006,2020-10-21,1093,77,1016,7,2,5
DKI JAKARTA,JAKARTA TIMUR,PULO GADUNG,KAYU PUTIH,3175021006,2020-10-22,1095,64,1031,2,-13,15
DKI JAKARTA,JAKARTA TIMUR,PULO GADUNG,KAYU PUTIH,3175021006,2020-10-23,1098,66,1032,3,2,1
DKI JAKARTA,JAKARTA TIMUR,PULO GADUNG,KAYU PUTIH,3175021006,2020-10-24,1106,68,1038,8,2,6
DKI JAKARTA,JAKARTA TIMUR,PULO GADUNG,KAYU PUTIH,3175021006,2020-10-25,1113,72,1041,7,4,3
DKI JAKARTA,JAKARTA TIMUR,PULO GADUNG,KAYU PUTIH,3175021006,2020-10-26,1118,66,1052,5,-6,11
DKI JAKARTA,JAKARTA TIMUR,PULO GADUNG,KAYU PUTIH,3175021006,2020-10-27,1125,58,1067,7,-8,15
DKI JAKARTA,JAKARTA TIMUR,PULO GADUNG,KAYU PUTIH,3175021006,2020-10-28,1128,54,1074,3,-4,7
DKI JAKARTA,JAKARTA TIMUR,PULO GADUNG,KAYU PUTIH,3175021006,2020-10-29,1132,45,1088,4,-9,14
DKI JAKARTA,JAKARTA TIMUR,PULO GADUNG,KAYU PUTIH,3175021006,2020-10-30,1141,48,1094,9,3,6
DKI JAKARTA,JAKARTA TIMUR,PULO GADUNG,KAYU PUTIH,3175021006,2020-10-31,1149,52,1098,8,4,4
DKI JAKARTA,JAKARTA TIMUR,PULO GADUNG,PISANGAN TIMUR,3175021002,2020-10-01,565,55,510,0,0,0
DKI JAKARTA,JAKARTA TIMUR,PULO GADUNG,PISANGAN TIMUR,3175021002,2020-10-02,578,64,514,13,9,4
DKI JAKARTA,JAKARTA TIMUR,PULO GADUNG,PISANGAN TIMUR,3175021002,2020-10-03,588,71,517,10,7,3
DKI JAKARTA,JAKARTA TIMUR,PULO GADUNG,PISANGAN TIMUR,3175021002,2020-10-04,590,72,518,2,1,1
DKI JAKARTA,JAKARTA TIMUR,PULO GADUNG,PISANGAN TIMUR,3175021002,2020-10-05,596,73,523,6,1,5
DKI JAKARTA,JAKARTA TIMUR,PULO GADUNG,PISANGAN TIMUR,3175021002,2020-10-06,601,62,539,5,-11,16
DKI JAKARTA,JAKARTA TIMUR,PULO GADUNG,PISANGAN TIMUR,3175021002,2020-10-07,637,83,554,36,21,15
DKI JAKARTA,JAKARTA TIMUR,PULO GADUNG,PISANGAN TIMUR,3175021002,2020-10-08,682,123,559,45,40,5
DKI JAKARTA,JAKARTA TIMUR,PULO GADUNG,PISANGAN TIMUR,3175021002,2020-10-09,687,127,560,5,4,1
DKI JAKARTA,JAKARTA TIMUR,PULO GADUNG,PISANGAN TIMUR,3175021002,2020-10-10,694,129,565,7,2,5
DKI JAKARTA,JAKARTA TIMUR,PULO GADUNG,PISANGAN TIMUR,3175021002,2020-10-11,709,143,566,15,14,1
DKI JAKARTA,JAKARTA TIMUR,PULO GADUNG,PISANGAN TIMUR,3175021002,2020-10-12,714,137,577,5,-6,11
DKI JAKARTA,JAKARTA TIMUR,PULO GADUNG,PISANGAN TIMUR,3175021002,2020-10-13,715,126,589,1,-11,12
DKI JAKARTA,JAKARTA TIMUR,PULO GADUNG,PISANGAN TIMUR,3175021002,2020-10-14,728,103,625,13,-23,36
DKI JAKARTA,JAKARTA TIMUR,PULO GADUNG,PISANGAN TIMUR,3175021002,2020-10-15,743,109,634,15,6,9
DKI JAKARTA,JAKARTA TIMUR,PULO GADUNG,PISANGAN TIMUR,3175021002,2020-10-16,750,71,679,7,-38,45
DKI JAKARTA,JAKARTA TIMUR,PULO GADUNG,PISANGAN TIMUR,3175021002,2020-10-17,758,77,681,8,6,2
DKI JAKARTA,JAKARTA TIMUR,PULO GADUNG,PISANGAN TIMUR,3175021002,2020-10-18,764,83,681,6,6,0
DKI JAKARTA,JAKARTA TIMUR,PULO GADUNG,PISANGAN TIMUR,3175021002,2020-10-19,768,84,684,4,1,3
DKI JAKARTA,JAKARTA TIMUR,PULO GADUNG,PISANGAN TIMUR,3175021002,2020-10-20,773,84,689,5,0,5
DKI JAKARTA,JAKARTA TIMUR,PULO GADUNG,PISANGAN TIMUR,3175021002,2020-10-21,781,75,706,8,-9,17
DKI JAKARTA,JAKARTA TIMUR,PULO GADUNG,PISANGAN TIMUR,3175021002,2020-10-22,783,66,717,2,-9,11
DKI JAKARTA,JAKARTA TIMUR,PULO GADUNG,PISANGAN TIMUR,3175021002,2020-10-23,798,79,719,15,13,2
DKI JAKARTA,JAKARTA TIMUR,PULO GADUNG,PISANGAN TIMUR,3175021002,2020-10-24,802,72,730,4,-7,11
DKI JAKARTA,JAKARTA TIMUR,PULO GADUNG,PISANGAN TIMUR,3175021002,2020-10-25,836,105,731,34,33,1
DKI JAKARTA,JAKARTA TIMUR,PULO GADUNG,PISANGAN TIMUR,3175021002,2020-10-26,857,106,751,21,1,20
DKI JAKARTA,JAKARTA TIMUR,PULO GADUNG,PISANGAN TIMUR,3175021002,2020-10-27,860,103,757,3,-3,6
DKI JAKARTA,JAKARTA TIMUR,PULO GADUNG,PISANGAN TIMUR,3175021002,2020-10-28,873,109,764,13,6,7
DKI JAKARTA,JAKARTA TIMUR,PULO GADUNG,PISANGAN TIMUR,3175021002,2020-10-29,883,108,775,10,-1,11
DKI JAKARTA,JAKARTA TIMUR,PULO GADUNG,PISANGAN TIMUR,3175021002,2020-10-30,888,103,785,5,-5,10
DKI JAKARTA,JAKARTA TIMUR,PULO GADUNG,PISANGAN TIMUR,3175021002,2020-10-31,898,113,785,10,10,0
DKI JAKARTA,JAKARTA TIMUR,PULO GADUNG,PULO GADUNG,3175021001,2020-10-01,728,68,660,0,0,0
DKI JAKARTA,JAKARTA TIMUR,PULO GADUNG,PULO GADUNG,3175021001,2020-10-02,747,75,672,19,7,12
DKI JAKARTA,JAKARTA TIMUR,PULO GADUNG,PULO GADUNG,3175021001,2020-10-03,751,75,676,4,0,4
DKI JAKARTA,JAKARTA TIMUR,PULO GADUNG,PULO GADUNG,3175021001,2020-10-04,755,79,676,4,4,0
DKI JAKARTA,JAKARTA TIMUR,PULO GADUNG,PULO GADUNG,3175021001,2020-10-05,761,75,686,6,-4,10
DKI JAKARTA,JAKARTA TIMUR,PULO GADUNG,PULO GADUNG,3175021001,2020-10-06,774,76,698,13,1,12
DKI JAKARTA,JAKARTA TIMUR,PULO GADUNG,PULO GADUNG,3175021001,2020-10-07,784,72,712,10,-4,14
DKI JAKARTA,JAKARTA TIMUR,PULO GADUNG,PULO GADUNG,3175021001,2020-10-08,806,79,727,22,7,15
DKI JAKARTA,JAKARTA TIMUR,PULO GADUNG,PULO GADUNG,3175021001,2020-10-09,807,80,727,1,1,0
DKI JAKARTA,JAKARTA TIMUR,PULO GADUNG,PULO GADUNG,3175021001,2020-10-10,812,80,732,5,0,5
DKI JAKARTA,JAKARTA TIMUR,PULO GADUNG,PULO GADUNG,3175021001,2020-10-11,833,100,733,21,20,1
DKI JAKARTA,JAKARTA TIMUR,PULO GADUNG,PULO GADUNG,3175021001,2020-10-12,841,95,746,8,-5,13
DKI JAKARTA,JAKARTA TIMUR,PULO GADUNG,PULO GADUNG,3175021001,2020-10-13,843,83,760,2,-12,14
DKI JAKARTA,JAKARTA TIMUR,PULO GADUNG,PULO GADUNG,3175021001,2020-10-14,859,92,767,16,9,7
DKI JAKARTA,JAKARTA TIMUR,PULO GADUNG,PULO GADUNG,3175021001,2020-10-15,865,88,777,6,-4,10
DKI JAKARTA,JAKARTA TIMUR,PULO GADUNG,PULO GADUNG,3175021001,2020-10-16,868,78,790,3,-10,13
DKI JAKARTA,JAKARTA TIMUR,PULO GADUNG,PULO GADUNG,3175021001,2020-10-17,880,87,793,12,9,3
DKI JAKARTA,JAKARTA TIMUR,PULO GADUNG,PULO GADUNG,3175021001,2020-10-18,884,89,795,4,2,2
DKI JAKARTA,JAKARTA TIMUR,PULO GADUNG,PULO GADUNG,3175021001,2020-10-19,890,88,802,6,-1,7
DKI JAKARTA,JAKARTA TIMUR,PULO GADUNG,PULO GADUNG,3175021001,2020-10-20,898,82,816,8,-6,14
DKI JAKARTA,JAKARTA TIMUR,PULO GADUNG,PULO GADUNG,3175021001,2020-10-21,904,77,827,6,-5,11
DKI JAKARTA,JAKARTA TIMUR,PULO GADUNG,PULO GADUNG,3175021001,2020-10-22,905,62,843,1,-15,16
DKI JAKARTA,JAKARTA TIMUR,PULO GADUNG,PULO GADUNG,3175021001,2020-10-23,914,69,845,9,7,2
DKI JAKARTA,JAKARTA TIMUR,PULO GADUNG,PULO GADUNG,3175021001,2020-10-24,924,56,868,10,-13,23
DKI JAKARTA,JAKARTA TIMUR,PULO GADUNG,PULO GADUNG,3175021001,2020-10-25,931,59,872,7,3,4
DKI JAKARTA,JAKARTA TIMUR,PULO GADUNG,PULO GADUNG,3175021001,2020-10-26,935,50,885,4,-9,13
DKI JAKARTA,JAKARTA TIMUR,PULO GADUNG,PULO GADUNG,3175021001,2020-10-27,938,49,889,3,-1,4
DKI JAKARTA,JAKARTA TIMUR,PULO GADUNG,PULO GADUNG,3175021001,2020-10-28,940,43,897,2,-6,8
DKI JAKARTA,JAKARTA TIMUR,PULO GADUNG,PULO GADUNG,3175021001,2020-10-29,946,39,907,6,-4,10
DKI JAKARTA,JAKARTA TIMUR,PULO GADUNG,PULO GADUNG,3175021001,2020-10-30,949,34,915,3,-5,8
DKI JAKARTA,JAKARTA TIMUR,PULO GADUNG,PULO GADUNG,3175021001,2020-10-31,951,35,916,2,1,1
DKI JAKARTA,JAKARTA TIMUR,PULO GADUNG,RAWAMANGUN,3175021005,2020-10-01,713,61,652,0,0,0
DKI JAKARTA,JAKARTA TIMUR,PULO GADUNG,RAWAMANGUN,3175021005,2020-10-02,721,63,658,8,2,6
DKI JAKARTA,JAKARTA TIMUR,PULO GADUNG,RAWAMANGUN,3175021005,2020-10-03,726,66,660,5,3,2
DKI JAKARTA,JAKARTA TIMUR,PULO GADUNG,RAWAMANGUN,3175021005,2020-10-04,734,69,665,8,3,5
DKI JAKARTA,JAKARTA TIMUR,PULO GADUNG,RAWAMANGUN,3175021005,2020-10-05,746,74,672,12,5,7
DKI JAKARTA,JAKARTA TIMUR,PULO GADUNG,RAWAMANGUN,3175021005,2020-10-06,757,80,677,11,6,5
DKI JAKARTA,JAKARTA TIMUR,PULO GADUNG,RAWAMANGUN,3175021005,2020-10-07,773,88,685,16,8,8
DKI JAKARTA,JAKARTA TIMUR,PULO GADUNG,RAWAMANGUN,3175021005,2020-10-08,790,98,692,17,10,7
DKI JAKARTA,JAKARTA TIMUR,PULO GADUNG,RAWAMANGUN,3175021005,2020-10-09,796,103,693,6,5,1
DKI JAKARTA,JAKARTA TIMUR,PULO GADUNG,RAWAMANGUN,3175021005,2020-10-10,798,96,702,2,-7,9
DKI JAKARTA,JAKARTA TIMUR,PULO GADUNG,RAWAMANGUN,3175021005,2020-10-11,805,100,705,7,4,3
DKI JAKARTA,JAKARTA TIMUR,PULO GADUNG,RAWAMANGUN,3175021005,2020-10-12,814,95,719,9,-5,14
DKI JAKARTA,JAKARTA TIMUR,PULO GADUNG,RAWAMANGUN,3175021005,2020-10-13,822,95,727,8,0,8
DKI JAKARTA,JAKARTA TIMUR,PULO GADUNG,RAWAMANGUN,3175021005,2020-10-14,836,93,743,14,-2,16
DKI JAKARTA,JAKARTA TIMUR,PULO GADUNG,RAWAMANGUN,3175021005,2020-10-15,843,83,760,7,-10,17
DKI JAKARTA,JAKARTA TIMUR,PULO GADUNG,RAWAMANGUN,3175021005,2020-10-16,847,54,793,4,-29,33
DKI JAKARTA,JAKARTA TIMUR,PULO GADUNG,RAWAMANGUN,3175021005,2020-10-17,864,71,793,17,17,0
DKI JAKARTA,JAKARTA TIMUR,PULO GADUNG,RAWAMANGUN,3175021005,2020-10-18,873,79,794,9,8,1
DKI JAKARTA,JAKARTA TIMUR,PULO GADUNG,RAWAMANGUN,3175021005,2020-10-19,874,68,806,1,-11,12
DKI JAKARTA,JAKARTA TIMUR,PULO GADUNG,RAWAMANGUN,3175021005,2020-10-20,879,70,809,5,2,3
DKI JAKARTA,JAKARTA TIMUR,PULO GADUNG,RAWAMANGUN,3175021005,2020-10-21,882,69,813,3,-1,4
DKI JAKARTA,JAKARTA TIMUR,PULO GADUNG,RAWAMANGUN,3175021005,2020-10-22,886,58,828,4,-11,15
DKI JAKARTA,JAKARTA TIMUR,PULO GADUNG,RAWAMANGUN,3175021005,2020-10-23,892,63,829,6,5,1
DKI JAKARTA,JAKARTA TIMUR,PULO GADUNG,RAWAMANGUN,3175021005,2020-10-24,900,54,846,8,-9,17
DKI JAKARTA,JAKARTA TIMUR,PULO GADUNG,RAWAMANGUN,3175021005,2020-10-25,910,61,849,10,7,3
DKI JAKARTA,JAKARTA TIMUR,PULO GADUNG,RAWAMANGUN,3175021005,2020-10-26,916,51,865,6,-10,16
DKI JAKARTA,JAKARTA TIMUR,PULO GADUNG,RAWAMANGUN,3175021005,2020-10-27,920,53,867,4,2,2
DKI JAKARTA,JAKARTA TIMUR,PULO GADUNG,RAWAMANGUN,3175021005,2020-10-28,923,47,876,3,-6,9
DKI JAKARTA,JAKARTA TIMUR,PULO GADUNG,RAWAMANGUN,3175021005,2020-10-29,927,41,886,4,-6,10
DKI JAKARTA,JAKARTA TIMUR,PULO GADUNG,RAWAMANGUN,3175021005,2020-10-30,949,53,896,22,12,10
DKI JAKARTA,JAKARTA TIMUR,PULO GADUNG,RAWAMANGUN,3175021005,2020-10-31,963,65,898,14,12,2
DKI JAKARTA,JAKARTA UTARA,CILINCING,CILINCING,3172041001,2020-10-01,1050,42,1008,0,0,0
DKI JAKARTA,JAKARTA UTARA,CILINCING,CILINCING,3172041001,2020-10-02,1054,39,1015,4,-3,7
DKI JAKARTA,JAKARTA UTARA,CILINCING,CILINCING,3172041001,2020-10-03,1054,39,1015,0,0,0
DKI JAKARTA,JAKARTA UTARA,CILINCING,CILINCING,3172041001,2020-10-04,1056,41,1015,2,2,0
DKI JAKARTA,JAKARTA UTARA,CILINCING,CILINCING,3172041001,2020-10-05,1060,32,1028,4,-9,13
DKI JAKARTA,JAKARTA UTARA,CILINCING,CILINCING,3172041001,2020-10-06,1066,37,1029,6,5,1
DKI JAKARTA,JAKARTA UTARA,CILINCING,CILINCING,3172041001,2020-10-07,1072,38,1034,6,1,5
DKI JAKARTA,JAKARTA UTARA,CILINCING,CILINCING,3172041001,2020-10-08,1085,47,1038,13,9,4
DKI JAKARTA,JAKARTA UTARA,CILINCING,CILINCING,3172041001,2020-10-09,1086,48,1038,1,1,0
DKI JAKARTA,JAKARTA UTARA,CILINCING,CILINCING,3172041001,2020-10-10,1088,49,1039,2,1,1
DKI JAKARTA,JAKARTA UTARA,CILINCING,CILINCING,3172041001,2020-10-11,1095,51,1044,7,2,5
DKI JAKARTA,JAKARTA UTARA,CILINCING,CILINCING,3172041001,2020-10-12,1099,41,1058,4,-10,14
DKI JAKARTA,JAKARTA UTARA,CILINCING,CILINCING,3172041001,2020-10-13,1102,43,1059,3,2,1
DKI JAKARTA,JAKARTA UTARA,CILINCING,CILINCING,3172041001,2020-10-14,1103,37,1066,1,-6,7
DKI JAKARTA,JAKARTA UTARA,CILINCING,CILINCING,3172041001,2020-10-15,1106,31,1075,3,-6,9
DKI JAKARTA,JAKARTA UTARA,CILINCING,CILINCING,3172041001,2020-10-16,1111,32,1079,5,1,4
DKI JAKARTA,JAKARTA UTARA,CILINCING,CILINCING,3172041001,2020-10-17,1119,39,1080,8,7,1
DKI JAKARTA,JAKARTA UTARA,CILINCING,CILINCING,3172041001,2020-10-18,1127,44,1083,8,5,3
DKI JAKARTA,JAKARTA UTARA,CILINCING,CILINCING,3172041001,2020-10-19,1127,37,1090,0,-7,7
DKI JAKARTA,JAKARTA UTARA,CILINCING,CILINCING,3172041001,2020-10-20,1130,36,1094,3,-1,4
DKI JAKARTA,JAKARTA UTARA,CILINCING,CILINCING,3172041001,2020-10-21,1131,33,1098,1,-3,4
DKI JAKARTA,JAKARTA UTARA,CILINCING,CILINCING,3172041001,2020-10-22,1134,29,1105,3,-4,7
DKI JAKARTA,JAKARTA UTARA,CILINCING,CILINCING,3172041001,2020-10-23,1135,30,1105,1,1,0
DKI JAKARTA,JAKARTA UTARA,CILINCING,CILINCING,3172041001,2020-10-24,1138,27,1111,3,-3,6
DKI JAKARTA,JAKARTA UTARA,CILINCING,CILINCING,3172041001,2020-10-25,1140,27,1113,2,0,2
DKI JAKARTA,JAKARTA UTARA,CILINCING,CILINCING,3172041001,2020-10-26,1140,25,1115,0,-2,2
DKI JAKARTA,JAKARTA UTARA,CILINCING,CILINCING,3172041001,2020-10-27,1143,21,1122,3,-4,7
DKI JAKARTA,JAKARTA UTARA,CILINCING,CILINCING,3172041001,2020-10-28,1144,20,1124,1,-1,2
DKI JAKARTA,JAKARTA UTARA,CILINCING,CILINCING,3172041001,2020-10-29,1148,16,1132,4,-4,8
DKI JAKARTA,JAKARTA UTARA,CILINCING,CILINCING,3172041001,2020-10-30,1154,18,1136,6,2,4
DKI JAKARTA,JAKARTA UTARA,CILINCING,CILINCING,3172041001,2020-10-31,1157,21,1136,3,3,0
DKI JAKARTA,JAKARTA UTARA,CILINCING,KALI BARU,3172041004,2020-10-01,595,21,574,0,0,0
DKI JAKARTA,JAKARTA UTARA,CILINCING,KALI BARU,3172041004,2020-10-02,598,20,578,3,-1,4
DKI JAKARTA,JAKARTA UTARA,CILINCING,KALI BARU,3172041004,2020-10-03,599,19,580,1,-1,2
DKI JAKARTA,JAKARTA UTARA,CILINCING,KALI BARU,3172041004,2020-10-04,601,21,580,2,2,0
DKI JAKARTA,JAKARTA UTARA,CILINCING,KALI BARU,3172041004,2020-10-05,602,19,583,1,-2,3
DKI JAKARTA,JAKARTA UTARA,CILINCING,KALI BARU,3172041004,2020-10-06,606,22,584,4,3,1
DKI JAKARTA,JAKARTA UTARA,CILINCING,KALI BARU,3172041004,2020-10-07,608,23,585,2,1,1
DKI JAKARTA,JAKARTA UTARA,CILINCING,KALI BARU,3172041004,2020-10-08,614,26,588,6,3,3
DKI JAKARTA,JAKARTA UTARA,CILINCING,KALI BARU,3172041004,2020-10-09,615,27,588,1,1,0
DKI JAKARTA,JAKARTA UTARA,CILINCING,KALI BARU,3172041004,2020-10-10,618,26,592,3,-1,4
DKI JAKARTA,JAKARTA UTARA,CILINCING,KALI BARU,3172041004,2020-10-11,618,24,594,0,-2,2
DKI JAKARTA,JAKARTA UTARA,CILINCING,KALI BARU,3172041004,2020-10-12,620,21,599,2,-3,5
DKI JAKARTA,JAKARTA UTARA,CILINCING,KALI BARU,3172041004,2020-10-13,623,23,600,3,2,1
DKI JAKARTA,JAKARTA UTARA,CILINCING,KALI BARU,3172041004,2020-10-14,624,20,604,1,-3,4
DKI JAKARTA,JAKARTA UTARA,CILINCING,KALI BARU,3172041004,2020-10-15,630,21,609,6,1,5
DKI JAKARTA,JAKARTA UTARA,CILINCING,KALI BARU,3172041004,2020-10-16,635,23,612,5,2,3
DKI JAKARTA,JAKARTA UTARA,CILINCING,KALI BARU,3172041004,2020-10-17,645,32,613,10,9,1
DKI JAKARTA,JAKARTA UTARA,CILINCING,KALI BARU,3172041004,2020-10-18,650,37,613,5,5,0
DKI JAKARTA,JAKARTA UTARA,CILINCING,KALI BARU,3172041004,2020-10-19,650,34,616,0,-3,3
DKI JAKARTA,JAKARTA UTARA,CILINCING,KALI BARU,3172041004,2020-10-20,653,33,620,3,-1,4
DKI JAKARTA,JAKARTA UTARA,CILINCING,KALI BARU,3172041004,2020-10-21,690,34,656,37,1,36
DKI JAKARTA,JAKARTA UTARA,CILINCING,KALI BARU,3172041004,2020-10-22,653,27,626,-37,-7,-30
DKI JAKARTA,JAKARTA UTARA,CILINCING,KALI BARU,3172041004,2020-10-23,657,31,626,4,4,0
DKI JAKARTA,JAKARTA UTARA,CILINCING,KALI BARU,3172041004,2020-10-24,659,33,626,2,2,0
DKI JAKARTA,JAKARTA UTARA,CILINCING,KALI BARU,3172041004,2020-10-25,662,35,627,3,2,1
DKI JAKARTA,JAKARTA UTARA,CILINCING,KALI BARU,3172041004,2020-10-26,665,32,633,3,-3,6
DKI JAKARTA,JAKARTA UTARA,CILINCING,KALI BARU,3172041004,2020-10-27,671,31,640,6,-1,7
DKI JAKARTA,JAKARTA UTARA,CILINCING,KALI BARU,3172041004,2020-10-28,671,28,643,0,-3,3
DKI JAKARTA,JAKARTA UTARA,CILINCING,KALI BARU,3172041004,2020-10-29,677,25,652,6,-3,9
DKI JAKARTA,JAKARTA UTARA,CILINCING,KALI BARU,3172041004,2020-10-30,682,25,657,5,0,5
DKI JAKARTA,JAKARTA UTARA,CILINCING,KALI BARU,3172041004,2020-10-31,686,27,659,4,2,2
DKI JAKARTA,JAKARTA UTARA,CILINCING,MARUNDA,3172041003,2020-10-01,320,17,303,0,0,0
DKI JAKARTA,JAKARTA UTARA,CILINCING,MARUNDA,3172041003,2020-10-02,324,19,305,4,2,2
DKI JAKARTA,JAKARTA UTARA,CILINCING,MARUNDA,3172041003,2020-10-03,326,21,305,2,2,0
DKI JAKARTA,JAKARTA UTARA,CILINCING,MARUNDA,3172041003,2020-10-04,327,22,305,1,1,0
DKI JAKARTA,JAKARTA UTARA,CILINCING,MARUNDA,3172041003,2020-10-05,330,16,314,3,-6,9
DKI JAKARTA,JAKARTA UTARA,CILINCING,MARUNDA,3172041003,2020-10-06,331,15,316,1,-1,2
DKI JAKARTA,JAKARTA UTARA,CILINCING,MARUNDA,3172041003,2020-10-07,333,17,316,2,2,0
DKI JAKARTA,JAKARTA UTARA,CILINCING,MARUNDA,3172041003,2020-10-08,336,19,317,3,2,1
DKI JAKARTA,JAKARTA UTARA,CILINCING,MARUNDA,3172041003,2020-10-09,339,21,318,3,2,1
DKI JAKARTA,JAKARTA UTARA,CILINCING,MARUNDA,3172041003,2020-10-10,340,19,321,1,-2,3
DKI JAKARTA,JAKARTA UTARA,CILINCING,MARUNDA,3172041003,2020-10-11,341,18,323,1,-1,2
DKI JAKARTA,JAKARTA UTARA,CILINCING,MARUNDA,3172041003,2020-10-12,342,16,326,1,-2,3
DKI JAKARTA,JAKARTA UTARA,CILINCING,MARUNDA,3172041003,2020-10-13,342,13,329,0,-3,3
DKI JAKARTA,JAKARTA UTARA,CILINCING,MARUNDA,3172041003,2020-10-14,345,12,333,3,-1,4
DKI JAKARTA,JAKARTA UTARA,CILINCING,MARUNDA,3172041003,2020-10-15,348,14,334,3,2,1
DKI JAKARTA,JAKARTA UTARA,CILINCING,MARUNDA,3172041003,2020-10-16,349,11,338,1,-3,4
DKI JAKARTA,JAKARTA UTARA,CILINCING,MARUNDA,3172041003,2020-10-17,352,12,340,3,1,2
DKI JAKARTA,JAKARTA UTARA,CILINCING,MARUNDA,3172041003,2020-10-18,352,12,340,0,0,0
DKI JAKARTA,JAKARTA UTARA,CILINCING,MARUNDA,3172041003,2020-10-19,353,12,341,1,0,1
DKI JAKARTA,JAKARTA UTARA,CILINCING,MARUNDA,3172041003,2020-10-20,356,15,341,3,3,0
DKI JAKARTA,JAKARTA UTARA,CILINCING,MARUNDA,3172041003,2020-10-21,356,13,343,0,-2,2
DKI JAKARTA,JAKARTA UTARA,CILINCING,MARUNDA,3172041003,2020-10-22,357,12,345,1,-1,2
DKI JAKARTA,JAKARTA UTARA,CILINCING,MARUNDA,3172041003,2020-10-23,357,12,345,0,0,0
DKI JAKARTA,JAKARTA UTARA,CILINCING,MARUNDA,3172041003,2020-10-24,357,11,346,0,-1,1
DKI JAKARTA,JAKARTA UTARA,CILINCING,MARUNDA,3172041003,2020-10-25,360,14,346,3,3,0
DKI JAKARTA,JAKARTA UTARA,CILINCING,MARUNDA,3172041003,2020-10-26,360,11,349,0,-3,3
DKI JAKARTA,JAKARTA UTARA,CILINCING,MARUNDA,3172041003,2020-10-27,360,9,351,0,-2,2
DKI JAKARTA,JAKARTA UTARA,CILINCING,MARUNDA,3172041003,2020-10-28,362,10,352,2,1,1
DKI JAKARTA,JAKARTA UTARA,CILINCING,MARUNDA,3172041003,2020-10-29,364,8,356,2,-2,4
DKI JAKARTA,JAKARTA UTARA,CILINCING,MARUNDA,3172041003,2020-10-30,370,9,361,6,1,5
DKI JAKARTA,JAKARTA UTARA,CILINCING,MARUNDA,3172041003,2020-10-31,372,11,361,2,2,0
DKI JAKARTA,JAKARTA UTARA,CILINCING,ROROTAN,3172041006,2020-10-01,556,40,516,0,0,0
DKI JAKARTA,JAKARTA UTARA,CILINCING,ROROTAN,3172041006,2020-10-02,556,33,523,0,-7,7
DKI JAKARTA,JAKARTA UTARA,CILINCING,ROROTAN,3172041006,2020-10-03,558,34,524,2,1,1
DKI JAKARTA,JAKARTA UTARA,CILINCING,ROROTAN,3172041006,2020-10-04,561,36,525,3,2,1
DKI JAKARTA,JAKARTA UTARA,CILINCING,ROROTAN,3172041006,2020-10-05,563,27,536,2,-9,11
DKI JAKARTA,JAKARTA UTARA,CILINCING,ROROTAN,3172041006,2020-10-06,567,27,540,4,0,4
DKI JAKARTA,JAKARTA UTARA,CILINCING,ROROTAN,3172041006,2020-10-07,571,26,545,4,-1,5
DKI JAKARTA,JAKARTA UTARA,CILINCING,ROROTAN,3172041006,2020-10-08,587,38,549,16,12,4
DKI JAKARTA,JAKARTA UTARA,CILINCING,ROROTAN,3172041006,2020-10-09,587,38,549,0,0,0
DKI JAKARTA,JAKARTA UTARA,CILINCING,ROROTAN,3172041006,2020-10-10,590,36,554,3,-2,5
DKI JAKARTA,JAKARTA UTARA,CILINCING,ROROTAN,3172041006,2020-10-11,598,43,555,8,7,1
DKI JAKARTA,JAKARTA UTARA,CILINCING,ROROTAN,3172041006,2020-10-12,599,37,562,1,-6,7
DKI JAKARTA,JAKARTA UTARA,CILINCING,ROROTAN,3172041006,2020-10-13,599,35,564,0,-2,2
DKI JAKARTA,JAKARTA UTARA,CILINCING,ROROTAN,3172041006,2020-10-14,613,48,565,14,13,1
DKI JAKARTA,JAKARTA UTARA,CILINCING,ROROTAN,3172041006,2020-10-15,615,44,571,2,-4,6
DKI JAKARTA,JAKARTA UTARA,CILINCING,ROROTAN,3172041006,2020-10-16,619,45,574,4,1,3
DKI JAKARTA,JAKARTA UTARA,CILINCING,ROROTAN,3172041006,2020-10-17,624,48,576,5,3,2
DKI JAKARTA,JAKARTA UTARA,CILINCING,ROROTAN,3172041006,2020-10-18,627,50,577,3,2,1
DKI JAKARTA,JAKARTA UTARA,CILINCING,ROROTAN,3172041006,2020-10-19,628,40,588,1,-10,11
DKI JAKARTA,JAKARTA UTARA,CILINCING,ROROTAN,3172041006,2020-10-20,631,36,595,3,-4,7
DKI JAKARTA,JAKARTA UTARA,CILINCING,ROROTAN,3172041006,2020-10-21,632,30,602,1,-6,7
DKI JAKARTA,JAKARTA UTARA,CILINCING,ROROTAN,3172041006,2020-10-22,632,27,605,0,-3,3
DKI JAKARTA,JAKARTA UTARA,CILINCING,ROROTAN,3172041006,2020-10-23,634,29,605,2,2,0
DKI JAKARTA,JAKARTA UTARA,CILINCING,ROROTAN,3172041006,2020-10-24,635,21,614,1,-8,9
DKI JAKARTA,JAKARTA UTARA,CILINCING,ROROTAN,3172041006,2020-10-25,637,22,615,2,1,1
DKI JAKARTA,JAKARTA UTARA,CILINCING,ROROTAN,3172041006,2020-10-26,637,13,624,0,-9,9
DKI JAKARTA,JAKARTA UTARA,CILINCING,ROROTAN,3172041006,2020-10-27,638,11,627,1,-2,3
DKI JAKARTA,JAKARTA UTARA,CILINCING,ROROTAN,3172041006,2020-10-28,641,11,630,3,0,3
DKI JAKARTA,JAKARTA UTARA,CILINCING,ROROTAN,3172041006,2020-10-29,645,10,635,4,-1,5
DKI JAKARTA,JAKARTA UTARA,CILINCING,ROROTAN,3172041006,2020-10-30,648,10,638,3,0,3
DKI JAKARTA,JAKARTA UTARA,CILINCING,ROROTAN,3172041006,2020-10-31,651,12,639,3,2,1
DKI JAKARTA,JAKARTA UTARA,CILINCING,SEMPER BARAT,3172041007,2020-10-01,1040,62,978,0,0,0
DKI JAKARTA,JAKARTA UTARA,CILINCING,SEMPER BARAT,3172041007,2020-10-02,1044,56,988,4,-6,10
DKI JAKARTA,JAKARTA UTARA,CILINCING,SEMPER BARAT,3172041007,2020-10-03,1049,57,992,5,1,4
DKI JAKARTA,JAKARTA UTARA,CILINCING,SEMPER BARAT,3172041007,2020-10-04,1052,58,994,3,1,2
DKI JAKARTA,JAKARTA UTARA,CILINCING,SEMPER BARAT,3172041007,2020-10-05,1056,55,1001,4,-3,7
DKI JAKARTA,JAKARTA UTARA,CILINCING,SEMPER BARAT,3172041007,2020-10-06,1070,62,1008,14,7,7
DKI JAKARTA,JAKARTA UTARA,CILINCING,SEMPER BARAT,3172041007,2020-10-07,1081,71,1010,11,9,2
DKI JAKARTA,JAKARTA UTARA,CILINCING,SEMPER BARAT,3172041007,2020-10-08,1096,81,1015,15,10,5
DKI JAKARTA,JAKARTA UTARA,CILINCING,SEMPER BARAT,3172041007,2020-10-09,1098,82,1016,2,1,1
DKI JAKARTA,JAKARTA UTARA,CILINCING,SEMPER BARAT,3172041007,2020-10-10,1100,79,1021,2,-3,5
DKI JAKARTA,JAKARTA UTARA,CILINCING,SEMPER BARAT,3172041007,2020-10-11,1106,79,1027,6,0,6
DKI JAKARTA,JAKARTA UTARA,CILINCING,SEMPER BARAT,3172041007,2020-10-12,1110,69,1041,4,-10,14
DKI JAKARTA,JAKARTA UTARA,CILINCING,SEMPER BARAT,3172041007,2020-10-13,1113,58,1055,3,-11,14
DKI JAKARTA,JAKARTA UTARA,CILINCING,SEMPER BARAT,3172041007,2020-10-14,1116,58,1058,3,0,3
DKI JAKARTA,JAKARTA UTARA,CILINCING,SEMPER BARAT,3172041007,2020-10-15,1129,64,1065,13,6,7
DKI JAKARTA,JAKARTA UTARA,CILINCING,SEMPER BARAT,3172041007,2020-10-16,1138,61,1077,9,-3,12
DKI JAKARTA,JAKARTA UTARA,CILINCING,SEMPER BARAT,3172041007,2020-10-17,1156,75,1081,18,14,4
DKI JAKARTA,JAKARTA UTARA,CILINCING,SEMPER BARAT,3172041007,2020-10-18,1163,81,1082,7,6,1
DKI JAKARTA,JAKARTA UTARA,CILINCING,SEMPER BARAT,3172041007,2020-10-19,1168,82,1086,5,1,4
DKI JAKARTA,JAKARTA UTARA,CILINCING,SEMPER BARAT,3172041007,2020-10-20,1181,81,1100,13,-1,14
DKI JAKARTA,JAKARTA UTARA,CILINCING,SEMPER BARAT,3172041007,2020-10-21,1186,85,1101,5,4,1
DKI JAKARTA,JAKARTA UTARA,CILINCING,SEMPER BARAT,3172041007,2020-10-22,1190,86,1104,4,1,3
DKI JAKARTA,JAKARTA UTARA,CILINCING,SEMPER BARAT,3172041007,2020-10-23,1193,88,1105,3,2,1
DKI JAKARTA,JAKARTA UTARA,CILINCING,SEMPER BARAT,3172041007,2020-10-24,1196,83,1113,3,-5,8
DKI JAKARTA,JAKARTA UTARA,CILINCING,SEMPER BARAT,3172041007,2020-10-25,1199,83,1116,3,0,3
DKI JAKARTA,JAKARTA UTARA,CILINCING,SEMPER BARAT,3172041007,2020-10-26,1202,77,1125,3,-6,9
DKI JAKARTA,JAKARTA UTARA,CILINCING,SEMPER BARAT,3172041007,2020-10-27,1208,61,1147,6,-16,22
DKI JAKARTA,JAKARTA UTARA,CILINCING,SEMPER BARAT,3172041007,2020-10-28,1211,53,1158,3,-8,11
DKI JAKARTA,JAKARTA UTARA,CILINCING,SEMPER BARAT,3172041007,2020-10-29,1222,40,1183,11,-13,25
DKI JAKARTA,JAKARTA UTARA,CILINCING,SEMPER BARAT,3172041007,2020-10-30,1236,43,1194,14,3,11
DKI JAKARTA,JAKARTA UTARA,CILINCING,SEMPER BARAT,3172041007,2020-10-31,1242,45,1198,6,2,4
DKI JAKARTA,JAKARTA UTARA,CILINCING,SEMPER TIMUR,3172041005,2020-10-01,613,24,589,0,0,0
DKI JAKARTA,JAKARTA UTARA,CILINCING,SEMPER TIMUR,3172041005,2020-10-02,620,26,594,7,2,5
DKI JAKARTA,JAKARTA UTARA,CILINCING,SEMPER TIMUR,3172041005,2020-10-03,622,27,595,2,1,1
DKI JAKARTA,JAKARTA UTARA,CILINCING,SEMPER TIMUR,3172041005,2020-10-04,627,32,595,5,5,0
DKI JAKARTA,JAKARTA UTARA,CILINCING,SEMPER TIMUR,3172041005,2020-10-05,627,28,599,0,-4,4
DKI JAKARTA,JAKARTA UTARA,CILINCING,SEMPER TIMUR,3172041005,2020-10-06,632,32,600,5,4,1
DKI JAKARTA,JAKARTA UTARA,CILINCING,SEMPER TIMUR,3172041005,2020-10-07,637,35,602,5,3,2
DKI JAKARTA,JAKARTA UTARA,CILINCING,SEMPER TIMUR,3172041005,2020-10-08,645,35,610,8,0,8
DKI JAKARTA,JAKARTA UTARA,CILINCING,SEMPER TIMUR,3172041005,2020-10-09,647,36,611,2,1,1
DKI JAKARTA,JAKARTA UTARA,CILINCING,SEMPER TIMUR,3172041005,2020-10-10,651,38,613,4,2,2
DKI JAKARTA,JAKARTA UTARA,CILINCING,SEMPER TIMUR,3172041005,2020-10-11,651,38,613,0,0,0
DKI JAKARTA,JAKARTA UTARA,CILINCING,SEMPER TIMUR,3172041005,2020-10-12,655,33,622,4,-5,9
DKI JAKARTA,JAKARTA UTARA,CILINCING,SEMPER TIMUR,3172041005,2020-10-13,658,31,627,3,-2,5
DKI JAKARTA,JAKARTA UTARA,CILINCING,SEMPER TIMUR,3172041005,2020-10-14,660,25,635,2,-6,8
DKI JAKARTA,JAKARTA UTARA,CILINCING,SEMPER TIMUR,3172041005,2020-10-15,667,24,643,7,-1,8
DKI JAKARTA,JAKARTA UTARA,CILINCING,SEMPER TIMUR,3172041005,2020-10-16,670,23,647,3,-1,4
DKI JAKARTA,JAKARTA UTARA,CILINCING,SEMPER TIMUR,3172041005,2020-10-17,678,27,651,8,4,4
DKI JAKARTA,JAKARTA UTARA,CILINCING,SEMPER TIMUR,3172041005,2020-10-18,678,26,652,0,-1,1
DKI JAKARTA,JAKARTA UTARA,CILINCING,SEMPER TIMUR,3172041005,2020-10-19,678,24,654,0,-2,2
DKI JAKARTA,JAKARTA UTARA,CILINCING,SEMPER TIMUR,3172041005,2020-10-20,679,24,655,1,0,1
DKI JAKARTA,JAKARTA UTARA,CILINCING,SEMPER TIMUR,3172041005,2020-10-21,680,24,656,1,0,1
DKI JAKARTA,JAKARTA UTARA,CILINCING,SEMPER TIMUR,3172041005,2020-10-22,680,18,662,0,-6,6
DKI JAKARTA,JAKARTA UTARA,CILINCING,SEMPER TIMUR,3172041005,2020-10-23,680,18,662,0,0,0
DKI JAKARTA,JAKARTA UTARA,CILINCING,SEMPER TIMUR,3172041005,2020-10-24,719,55,664,39,37,2
DKI JAKARTA,JAKARTA UTARA,CILINCING,SEMPER TIMUR,3172041005,2020-10-25,723,58,665,4,3,1
DKI JAKARTA,JAKARTA UTARA,CILINCING,SEMPER TIMUR,3172041005,2020-10-26,726,56,670,3,-2,5
DKI JAKARTA,JAKARTA UTARA,CILINCING,SEMPER TIMUR,3172041005,2020-10-27,734,60,674,8,4,4
DKI JAKARTA,JAKARTA UTARA,CILINCING,SEMPER TIMUR,3172041005,2020-10-28,741,66,675,7,6,1
DKI JAKARTA,JAKARTA UTARA,CILINCING,SEMPER TIMUR,3172041005,2020-10-29,743,61,682,2,-5,7
DKI JAKARTA,JAKARTA UTARA,CILINCING,SEMPER TIMUR,3172041005,2020-10-30,747,63,684,4,2,2
DKI JAKARTA,JAKARTA UTARA,CILINCING,SEMPER TIMUR,3172041005,2020-10-31,751,65,686,4,2,2
DKI JAKARTA,JAKARTA UTARA,CILINCING,SUKAPURA,3172041002,2020-10-01,811,38,773,0,0,0
DKI JAKARTA,JAKARTA UTARA,CILINCING,SUKAPURA,3172041002,2020-10-02,817,40,777,6,2,4
DKI JAKARTA,JAKARTA UTARA,CILINCING,SUKAPURA,3172041002,2020-10-03,818,41,777,1,1,0
DKI JAKARTA,JAKARTA UTARA,CILINCING,SUKAPURA,3172041002,2020-10-04,827,42,785,9,1,8
DKI JAKARTA,JAKARTA UTARA,CILINCING,SUKAPURA,3172041002,2020-10-05,830,37,793,3,-5,8
DKI JAKARTA,JAKARTA UTARA,CILINCING,SUKAPURA,3172041002,2020-10-06,836,41,795,6,4,2
DKI JAKARTA,JAKARTA UTARA,CILINCING,SUKAPURA,3172041002,2020-10-07,841,37,804,5,-4,9
DKI JAKARTA,JAKARTA UTARA,CILINCING,SUKAPURA,3172041002,2020-10-08,847,39,808,6,2,4
DKI JAKARTA,JAKARTA UTARA,CILINCING,SUKAPURA,3172041002,2020-10-09,849,41,808,2,2,0
DKI JAKARTA,JAKARTA UTARA,CILINCING,SUKAPURA,3172041002,2020-10-10,854,34,820,5,-7,12
DKI JAKARTA,JAKARTA UTARA,CILINCING,SUKAPURA,3172041002,2020-10-11,859,38,821,5,4,1
DKI JAKARTA,JAKARTA UTARA,CILINCING,SUKAPURA,3172041002,2020-10-12,860,35,825,1,-3,4
DKI JAKARTA,JAKARTA UTARA,CILINCING,SUKAPURA,3172041002,2020-10-13,864,35,829,4,0,4
DKI JAKARTA,JAKARTA UTARA,CILINCING,SUKAPURA,3172041002,2020-10-14,865,25,840,1,-10,11
DKI JAKARTA,JAKARTA UTARA,CILINCING,SUKAPURA,3172041002,2020-10-15,867,24,843,2,-1,3
DKI JAKARTA,JAKARTA UTARA,CILINCING,SUKAPURA,3172041002,2020-10-16,872,27,845,5,3,2
DKI JAKARTA,JAKARTA UTARA,CILINCING,SUKAPURA,3172041002,2020-10-17,891,43,848,19,16,3
DKI JAKARTA,JAKARTA UTARA,CILINCING,SUKAPURA,3172041002,2020-10-18,895,47,848,4,4,0
DKI JAKARTA,JAKARTA UTARA,CILINCING,SUKAPURA,3172041002,2020-10-19,895,44,851,0,-3,3
DKI JAKARTA,JAKARTA UTARA,CILINCING,SUKAPURA,3172041002,2020-10-20,898,43,855,3,-1,4
DKI JAKARTA,JAKARTA UTARA,CILINCING,SUKAPURA,3172041002,2020-10-21,923,55,868,25,12,13
DKI JAKARTA,JAKARTA UTARA,CILINCING,SUKAPURA,3172041002,2020-10-22,917,52,865,-6,-3,-3
DKI JAKARTA,JAKARTA UTARA,CILINCING,SUKAPURA,3172041002,2020-10-23,922,52,870,5,0,5
DKI JAKARTA,JAKARTA UTARA,CILINCING,SUKAPURA,3172041002,2020-10-24,923,51,872,1,-1,2
DKI JAKARTA,JAKARTA UTARA,CILINCING,SUKAPURA,3172041002,2020-10-25,930,57,873,7,6,1
DKI JAKARTA,JAKARTA UTARA,CILINCING,SUKAPURA,3172041002,2020-10-26,932,56,876,2,-1,3
DKI JAKARTA,JAKARTA UTARA,CILINCING,SUKAPURA,3172041002,2020-10-27,936,58,878,4,2,2
DKI JAKARTA,JAKARTA UTARA,CILINCING,SUKAPURA,3172041002,2020-10-28,949,66,883,13,8,5
DKI JAKARTA,JAKARTA UTARA,CILINCING,SUKAPURA,3172041002,2020-10-29,952,47,905,3,-19,22
DKI JAKARTA,JAKARTA UTARA,CILINCING,SUKAPURA,3172041002,2020-10-30,966,45,921,14,-2,16
DKI JAKARTA,JAKARTA UTARA,CILINCING,SUKAPURA,3172041002,2020-10-31,970,48,922,4,3,1
DKI JAKARTA,JAKARTA UTARA,KELAPA GADING,KELAPA GADING BARAT,3172061003,2020-10-01,1128,51,1077,0,0,0
DKI JAKARTA,JAKARTA UTARA,KELAPA GADING,KELAPA GADING BARAT,3172061003,2020-10-02,1141,58,1083,13,7,6
DKI JAKARTA,JAKARTA UTARA,KELAPA GADING,KELAPA GADING BARAT,3172061003,2020-10-03,1148,61,1087,7,3,4
DKI JAKARTA,JAKARTA UTARA,KELAPA GADING,KELAPA GADING BARAT,3172061003,2020-10-04,1154,66,1088,6,5,1
DKI JAKARTA,JAKARTA UTARA,KELAPA GADING,KELAPA GADING BARAT,3172061003,2020-10-05,1157,58,1099,3,-8,11
DKI JAKARTA,JAKARTA UTARA,KELAPA GADING,KELAPA GADING BARAT,3172061003,2020-10-06,1164,61,1103,7,3,4
DKI JAKARTA,JAKARTA UTARA,KELAPA GADING,KELAPA GADING BARAT,3172061003,2020-10-07,1173,63,1110,9,2,7
DKI JAKARTA,JAKARTA UTARA,KELAPA GADING,KELAPA GADING BARAT,3172061003,2020-10-08,1192,73,1119,19,10,9
DKI JAKARTA,JAKARTA UTARA,KELAPA GADING,KELAPA GADING BARAT,3172061003,2020-10-09,1194,75,1119,2,2,0
DKI JAKARTA,JAKARTA UTARA,KELAPA GADING,KELAPA GADING BARAT,3172061003,2020-10-10,1201,72,1129,7,-3,10
DKI JAKARTA,JAKARTA UTARA,KELAPA GADING,KELAPA GADING BARAT,3172061003,2020-10-11,1211,79,1132,10,7,3
DKI JAKARTA,JAKARTA UTARA,KELAPA GADING,KELAPA GADING BARAT,3172061003,2020-10-12,1214,68,1146,3,-11,14
DKI JAKARTA,JAKARTA UTARA,KELAPA GADING,KELAPA GADING BARAT,3172061003,2020-10-13,1219,67,1152,5,-1,6
DKI JAKARTA,JAKARTA UTARA,KELAPA GADING,KELAPA GADING BARAT,3172061003,2020-10-14,1221,64,1157,2,-3,5
DKI JAKARTA,JAKARTA UTARA,KELAPA GADING,KELAPA GADING BARAT,3172061003,2020-10-15,1227,60,1167,6,-4,10
DKI JAKARTA,JAKARTA UTARA,KELAPA GADING,KELAPA GADING BARAT,3172061003,2020-10-16,1237,62,1175,10,2,8
DKI JAKARTA,JAKARTA UTARA,KELAPA GADING,KELAPA GADING BARAT,3172061003,2020-10-17,1251,68,1183,14,6,8
DKI JAKARTA,JAKARTA UTARA,KELAPA GADING,KELAPA GADING BARAT,3172061003,2020-10-18,1255,70,1185,4,2,2
DKI JAKARTA,JAKARTA UTARA,KELAPA GADING,KELAPA GADING BARAT,3172061003,2020-10-19,1260,63,1197,5,-7,12
DKI JAKARTA,JAKARTA UTARA,KELAPA GADING,KELAPA GADING BARAT,3172061003,2020-10-20,1261,62,1199,1,-1,2
DKI JAKARTA,JAKARTA UTARA,KELAPA GADING,KELAPA GADING BARAT,3172061003,2020-10-21,1270,55,1215,9,-7,16
DKI JAKARTA,JAKARTA UTARA,KELAPA GADING,KELAPA GADING BARAT,3172061003,2020-10-22,1275,49,1226,5,-6,11
DKI JAKARTA,JAKARTA UTARA,KELAPA GADING,KELAPA GADING BARAT,3172061003,2020-10-23,1276,50,1226,1,1,0
DKI JAKARTA,JAKARTA UTARA,KELAPA GADING,KELAPA GADING BARAT,3172061003,2020-10-24,1282,44,1238,6,-6,12
DKI JAKARTA,JAKARTA UTARA,KELAPA GADING,KELAPA GADING BARAT,3172061003,2020-10-25,1311,59,1252,29,15,14
DKI JAKARTA,JAKARTA UTARA,KELAPA GADING,KELAPA GADING BARAT,3172061003,2020-10-26,1315,57,1258,4,-2,6
DKI JAKARTA,JAKARTA UTARA,KELAPA GADING,KELAPA GADING BARAT,3172061003,2020-10-27,1320,60,1260,5,3,2
DKI JAKARTA,JAKARTA UTARA,KELAPA GADING,KELAPA GADING BARAT,3172061003,2020-10-28,1322,55,1267,2,-5,7
DKI JAKARTA,JAKARTA UTARA,KELAPA GADING,KELAPA GADING BARAT,3172061003,2020-10-29,1329,47,1283,7,-8,16
DKI JAKARTA,JAKARTA UTARA,KELAPA GADING,KELAPA GADING BARAT,3172061003,2020-10-30,1353,65,1289,24,18,6
DKI JAKARTA,JAKARTA UTARA,KELAPA GADING,KELAPA GADING BARAT,3172061003,2020-10-31,1363,73,1291,10,8,2
DKI JAKARTA,JAKARTA UTARA,KELAPA GADING,KELAPA GADING TIMUR,3172061001,2020-10-01,1113,73,1040,0,0,0
DKI JAKARTA,JAKARTA UTARA,KELAPA GADING,KELAPA GADING TIMUR,3172061001,2020-10-02,1125,69,1056,12,-4,16
DKI JAKARTA,JAKARTA UTARA,KELAPA GADING,KELAPA GADING TIMUR,3172061001,2020-10-03,1131,70,1061,6,1,5
DKI JAKARTA,JAKARTA UTARA,KELAPA GADING,KELAPA GADING TIMUR,3172061001,2020-10-04,1137,72,1065,6,2,4
DKI JAKARTA,JAKARTA UTARA,KELAPA GADING,KELAPA GADING TIMUR,3172061001,2020-10-05,1139,63,1076,2,-9,11
DKI JAKARTA,JAKARTA UTARA,KELAPA GADING,KELAPA GADING TIMUR,3172061001,2020-10-06,1141,58,1083,2,-5,7
DKI JAKARTA,JAKARTA UTARA,KELAPA GADING,KELAPA GADING TIMUR,3172061001,2020-10-07,1166,60,1106,25,2,23
DKI JAKARTA,JAKARTA UTARA,KELAPA GADING,KELAPA GADING TIMUR,3172061001,2020-10-08,1181,68,1113,15,8,7
DKI JAKARTA,JAKARTA UTARA,KELAPA GADING,KELAPA GADING TIMUR,3172061001,2020-10-09,1186,71,1115,5,3,2
DKI JAKARTA,JAKARTA UTARA,KELAPA GADING,KELAPA GADING TIMUR,3172061001,2020-10-10,1195,59,1136,9,-12,21
DKI JAKARTA,JAKARTA UTARA,KELAPA GADING,KELAPA GADING TIMUR,3172061001,2020-10-11,1200,60,1140,5,1,4
DKI JAKARTA,JAKARTA UTARA,KELAPA GADING,KELAPA GADING TIMUR,3172061001,2020-10-12,1203,54,1149,3,-6,9
DKI JAKARTA,JAKARTA UTARA,KELAPA GADING,KELAPA GADING TIMUR,3172061001,2020-10-13,1205,48,1157,2,-6,8
DKI JAKARTA,JAKARTA UTARA,KELAPA GADING,KELAPA GADING TIMUR,3172061001,2020-10-14,1212,46,1166,7,-2,9
DKI JAKARTA,JAKARTA UTARA,KELAPA GADING,KELAPA GADING TIMUR,3172061001,2020-10-15,1224,51,1173,12,5,7
DKI JAKARTA,JAKARTA UTARA,KELAPA GADING,KELAPA GADING TIMUR,3172061001,2020-10-16,1231,52,1179,7,1,6
DKI JAKARTA,JAKARTA UTARA,KELAPA GADING,KELAPA GADING TIMUR,3172061001,2020-10-17,1240,56,1184,9,4,5
DKI JAKARTA,JAKARTA UTARA,KELAPA GADING,KELAPA GADING TIMUR,3172061001,2020-10-18,1245,60,1185,5,4,1
DKI JAKARTA,JAKARTA UTARA,KELAPA GADING,KELAPA GADING TIMUR,3172061001,2020-10-19,1246,53,1193,1,-7,8
DKI JAKARTA,JAKARTA UTARA,KELAPA GADING,KELAPA GADING TIMUR,3172061001,2020-10-20,1258,56,1202,12,3,9
DKI JAKARTA,JAKARTA UTARA,KELAPA GADING,KELAPA GADING TIMUR,3172061001,2020-10-21,1264,55,1209,6,-1,7
DKI JAKARTA,JAKARTA UTARA,KELAPA GADING,KELAPA GADING TIMUR,3172061001,2020-10-22,1266,49,1217,2,-6,8
DKI JAKARTA,JAKARTA UTARA,KELAPA GADING,KELAPA GADING TIMUR,3172061001,2020-10-23,1269,51,1218,3,2,1
DKI JAKARTA,JAKARTA UTARA,KELAPA GADING,KELAPA GADING TIMUR,3172061001,2020-10-24,1273,43,1230,4,-8,12
DKI JAKARTA,JAKARTA UTARA,KELAPA GADING,KELAPA GADING TIMUR,3172061001,2020-10-25,1278,44,1234,5,1,4
DKI JAKARTA,JAKARTA UTARA,KELAPA GADING,KELAPA GADING TIMUR,3172061001,2020-10-26,1280,35,1245,2,-9,11
DKI JAKARTA,JAKARTA UTARA,KELAPA GADING,KELAPA GADING TIMUR,3172061001,2020-10-27,1289,39,1250,9,4,5
DKI JAKARTA,JAKARTA UTARA,KELAPA GADING,KELAPA GADING TIMUR,3172061001,2020-10-28,1292,37,1255,3,-2,5
DKI JAKARTA,JAKARTA UTARA,KELAPA GADING,KELAPA GADING TIMUR,3172061001,2020-10-29,1299,33,1266,7,-4,11
DKI JAKARTA,JAKARTA UTARA,KELAPA GADING,KELAPA GADING TIMUR,3172061001,2020-10-30,1307,31,1276,8,-2,10
DKI JAKARTA,JAKARTA UTARA,KELAPA GADING,KELAPA GADING TIMUR,3172061001,2020-10-31,1312,35,1277,5,4,1
DKI JAKARTA,JAKARTA UTARA,KELAPA GADING,PEGANGSAAN DUA,3172061002,2020-10-01,1467,70,1397,0,0,0
DKI JAKARTA,JAKARTA UTARA,KELAPA GADING,PEGANGSAAN DUA,3172061002,2020-10-02,1476,68,1408,9,-2,11
DKI JAKARTA,JAKARTA UTARA,KELAPA GADING,PEGANGSAAN DUA,3172061002,2020-10-03,1482,69,1413,6,1,5
DKI JAKARTA,JAKARTA UTARA,KELAPA GADING,PEGANGSAAN DUA,3172061002,2020-10-04,1489,75,1414,7,6,1
DKI JAKARTA,JAKARTA UTARA,KELAPA GADING,PEGANGSAAN DUA,3172061002,2020-10-05,1490,54,1436,1,-21,22
DKI JAKARTA,JAKARTA UTARA,KELAPA GADING,PEGANGSAAN DUA,3172061002,2020-10-06,1514,75,1439,24,21,3
DKI JAKARTA,JAKARTA UTARA,KELAPA GADING,PEGANGSAAN DUA,3172061002,2020-10-07,1528,80,1448,14,5,9
DKI JAKARTA,JAKARTA UTARA,KELAPA GADING,PEGANGSAAN DUA,3172061002,2020-10-08,1545,93,1452,17,13,4
DKI JAKARTA,JAKARTA UTARA,KELAPA GADING,PEGANGSAAN DUA,3172061002,2020-10-09,1548,95,1453,3,2,1
DKI JAKARTA,JAKARTA UTARA,KELAPA GADING,PEGANGSAAN DUA,3172061002,2020-10-10,1557,90,1467,9,-5,14
DKI JAKARTA,JAKARTA UTARA,KELAPA GADING,PEGANGSAAN DUA,3172061002,2020-10-11,1573,95,1478,16,5,11
DKI JAKARTA,JAKARTA UTARA,KELAPA GADING,PEGANGSAAN DUA,3172061002,2020-10-12,1579,87,1492,6,-8,14
DKI JAKARTA,JAKARTA UTARA,KELAPA GADING,PEGANGSAAN DUA,3172061002,2020-10-13,1584,82,1502,5,-5,10
DKI JAKARTA,JAKARTA UTARA,KELAPA GADING,PEGANGSAAN DUA,3172061002,2020-10-14,1590,77,1513,6,-5,11
DKI JAKARTA,JAKARTA UTARA,KELAPA GADING,PEGANGSAAN DUA,3172061002,2020-10-15,1634,108,1526,44,31,13
DKI JAKARTA,JAKARTA UTARA,KELAPA GADING,PEGANGSAAN DUA,3172061002,2020-10-16,1641,98,1543,7,-10,17
DKI JAKARTA,JAKARTA UTARA,KELAPA GADING,PEGANGSAAN DUA,3172061002,2020-10-17,1665,116,1549,24,18,6
DKI JAKARTA,JAKARTA UTARA,KELAPA GADING,PEGANGSAAN DUA,3172061002,2020-10-18,1667,115,1552,2,-1,3
DKI JAKARTA,JAKARTA UTARA,KELAPA GADING,PEGANGSAAN DUA,3172061002,2020-10-19,1671,115,1556,4,0,4
DKI JAKARTA,JAKARTA UTARA,KELAPA GADING,PEGANGSAAN DUA,3172061002,2020-10-20,1704,137,1567,33,22,11
DKI JAKARTA,JAKARTA UTARA,KELAPA GADING,PEGANGSAAN DUA,3172061002,2020-10-21,1733,158,1575,29,21,8
DKI JAKARTA,JAKARTA UTARA,KELAPA GADING,PEGANGSAAN DUA,3172061002,2020-10-22,1779,194,1585,46,36,10
DKI JAKARTA,JAKARTA UTARA,KELAPA GADING,PEGANGSAAN DUA,3172061002,2020-10-23,1782,197,1585,3,3,0
DKI JAKARTA,JAKARTA UTARA,KELAPA GADING,PEGANGSAAN DUA,3172061002,2020-10-24,1788,193,1595,6,-4,10
DKI JAKARTA,JAKARTA UTARA,KELAPA GADING,PEGANGSAAN DUA,3172061002,2020-10-25,1791,191,1600,3,-2,5
DKI JAKARTA,JAKARTA UTARA,KELAPA GADING,PEGANGSAAN DUA,3172061002,2020-10-26,1794,185,1609,3,-6,9
DKI JAKARTA,JAKARTA UTARA,KELAPA GADING,PEGANGSAAN DUA,3172061002,2020-10-27,1795,172,1623,1,-13,14
DKI JAKARTA,JAKARTA UTARA,KELAPA GADING,PEGANGSAAN DUA,3172061002,2020-10-28,1801,142,1659,6,-30,36
DKI JAKARTA,JAKARTA UTARA,KELAPA GADING,PEGANGSAAN DUA,3172061002,2020-10-29,1824,129,1696,23,-13,37
DKI JAKARTA,JAKARTA UTARA,KELAPA GADING,PEGANGSAAN DUA,3172061002,2020-10-30,1858,153,1706,34,24,10
DKI JAKARTA,JAKARTA UTARA,KELAPA GADING,PEGANGSAAN DUA,3172061002,2020-10-31,1864,154,1711,6,1,5
DKI JAKARTA,JAKARTA UTARA,KOJA,KOJA,3172031001,2020-10-01,386,6,380,0,0,0
DKI JAKARTA,JAKARTA UTARA,KOJA,KOJA,3172031001,2020-10-02,389,8,381,3,2,1
DKI JAKARTA,JAKARTA UTARA,KOJA,KOJA,3172031001,2020-10-03,389,8,381,0,0,0
DKI JAKARTA,JAKARTA UTARA,KOJA,KOJA,3172031001,2020-10-04,393,9,384,4,1,3
DKI JAKARTA,JAKARTA UTARA,KOJA,KOJA,3172031001,2020-10-05,396,7,389,3,-2,5
DKI JAKARTA,JAKARTA UTARA,KOJA,KOJA,3172031001,2020-10-06,400,9,391,4,2,2
DKI JAKARTA,JAKARTA UTARA,KOJA,KOJA,3172031001,2020-10-07,406,15,391,6,6,0
DKI JAKARTA,JAKARTA UTARA,KOJA,KOJA,3172031001,2020-10-08,409,17,392,3,2,1
DKI JAKARTA,JAKARTA UTARA,KOJA,KOJA,3172031001,2020-10-09,412,19,393,3,2,1
DKI JAKARTA,JAKARTA UTARA,KOJA,KOJA,3172031001,2020-10-10,413,18,395,1,-1,2
DKI JAKARTA,JAKARTA UTARA,KOJA,KOJA,3172031001,2020-10-11,414,18,396,1,0,1
DKI JAKARTA,JAKARTA UTARA,KOJA,KOJA,3172031001,2020-10-12,414,15,399,0,-3,3
DKI JAKARTA,JAKARTA UTARA,KOJA,KOJA,3172031001,2020-10-13,415,15,400,1,0,1
DKI JAKARTA,JAKARTA UTARA,KOJA,KOJA,3172031001,2020-10-14,415,12,403,0,-3,3
DKI JAKARTA,JAKARTA UTARA,KOJA,KOJA,3172031001,2020-10-15,418,12,406,3,0,3
DKI JAKARTA,JAKARTA UTARA,KOJA,KOJA,3172031001,2020-10-16,420,11,409,2,-1,3
DKI JAKARTA,JAKARTA UTARA,KOJA,KOJA,3172031001,2020-10-17,429,17,412,9,6,3
DKI JAKARTA,JAKARTA UTARA,KOJA,KOJA,3172031001,2020-10-18,433,20,413,4,3,1
DKI JAKARTA,JAKARTA UTARA,KOJA,KOJA,3172031001,2020-10-19,435,19,416,2,-1,3
DKI JAKARTA,JAKARTA UTARA,KOJA,KOJA,3172031001,2020-10-20,440,19,421,5,0,5
DKI JAKARTA,JAKARTA UTARA,KOJA,KOJA,3172031001,2020-10-21,444,20,424,4,1,3
DKI JAKARTA,JAKARTA UTARA,KOJA,KOJA,3172031001,2020-10-22,446,22,424,2,2,0
DKI JAKARTA,JAKARTA UTARA,KOJA,KOJA,3172031001,2020-10-23,447,23,424,1,1,0
DKI JAKARTA,JAKARTA UTARA,KOJA,KOJA,3172031001,2020-10-24,448,22,426,1,-1,2
DKI JAKARTA,JAKARTA UTARA,KOJA,KOJA,3172031001,2020-10-25,449,22,427,1,0,1
DKI JAKARTA,JAKARTA UTARA,KOJA,KOJA,3172031001,2020-10-26,451,23,428,2,1,1
DKI JAKARTA,JAKARTA UTARA,KOJA,KOJA,3172031001,2020-10-27,453,24,429,2,1,1
DKI JAKARTA,JAKARTA UTARA,KOJA,KOJA,3172031001,2020-10-28,455,18,437,2,-6,8
DKI JAKARTA,JAKARTA UTARA,KOJA,KOJA,3172031001,2020-10-29,458,10,448,3,-8,11
DKI JAKARTA,JAKARTA UTARA,KOJA,KOJA,3172031001,2020-10-30,459,11,448,1,1,0
DKI JAKARTA,JAKARTA UTARA,KOJA,KOJA,3172031001,2020-10-31,459,11,448,0,0,0
DKI JAKARTA,JAKARTA UTARA,KOJA,LAGOA,3172031003,2020-10-01,590,53,537,0,0,0
DKI JAKARTA,JAKARTA UTARA,KOJA,LAGOA,3172031003,2020-10-02,594,52,542,4,-1,5
DKI JAKARTA,JAKARTA UTARA,KOJA,LAGOA,3172031003,2020-10-03,597,51,546,3,-1,4
DKI JAKARTA,JAKARTA UTARA,KOJA,LAGOA,3172031003,2020-10-04,617,53,564,20,2,18
DKI JAKARTA,JAKARTA UTARA,KOJA,LAGOA,3172031003,2020-10-05,620,42,578,3,-11,14
DKI JAKARTA,JAKARTA UTARA,KOJA,LAGOA,3172031003,2020-10-06,625,38,587,5,-4,9
DKI JAKARTA,JAKARTA UTARA,KOJA,LAGOA,3172031003,2020-10-07,628,36,592,3,-2,5
DKI JAKARTA,JAKARTA UTARA,KOJA,LAGOA,3172031003,2020-10-08,632,30,602,4,-6,10
DKI JAKARTA,JAKARTA UTARA,KOJA,LAGOA,3172031003,2020-10-09,634,31,603,2,1,1
DKI JAKARTA,JAKARTA UTARA,KOJA,LAGOA,3172031003,2020-10-10,637,28,609,3,-3,6
DKI JAKARTA,JAKARTA UTARA,KOJA,LAGOA,3172031003,2020-10-11,642,28,614,5,0,5
DKI JAKARTA,JAKARTA UTARA,KOJA,LAGOA,3172031003,2020-10-12,647,28,619,5,0,5
DKI JAKARTA,JAKARTA UTARA,KOJA,LAGOA,3172031003,2020-10-13,649,28,621,2,0,2
DKI JAKARTA,JAKARTA UTARA,KOJA,LAGOA,3172031003,2020-10-14,651,23,628,2,-5,7
DKI JAKARTA,JAKARTA UTARA,KOJA,LAGOA,3172031003,2020-10-15,655,21,634,4,-2,6
DKI JAKARTA,JAKARTA UTARA,KOJA,LAGOA,3172031003,2020-10-16,661,25,636,6,4,2
DKI JAKARTA,JAKARTA UTARA,KOJA,LAGOA,3172031003,2020-10-17,672,33,639,11,8,3
DKI JAKARTA,JAKARTA UTARA,KOJA,LAGOA,3172031003,2020-10-18,676,36,640,4,3,1
DKI JAKARTA,JAKARTA UTARA,KOJA,LAGOA,3172031003,2020-10-19,677,33,644,1,-3,4
DKI JAKARTA,JAKARTA UTARA,KOJA,LAGOA,3172031003,2020-10-20,687,37,650,10,4,6
DKI JAKARTA,JAKARTA UTARA,KOJA,LAGOA,3172031003,2020-10-21,695,34,661,8,-3,11
DKI JAKARTA,JAKARTA UTARA,KOJA,LAGOA,3172031003,2020-10-22,700,32,668,5,-2,7
DKI JAKARTA,JAKARTA UTARA,KOJA,LAGOA,3172031003,2020-10-23,702,34,668,2,2,0
DKI JAKARTA,JAKARTA UTARA,KOJA,LAGOA,3172031003,2020-10-24,707,28,679,5,-6,11
DKI JAKARTA,JAKARTA UTARA,KOJA,LAGOA,3172031003,2020-10-25,708,25,683,1,-3,4
DKI JAKARTA,JAKARTA UTARA,KOJA,LAGOA,3172031003,2020-10-26,710,21,689,2,-4,6
DKI JAKARTA,JAKARTA UTARA,KOJA,LAGOA,3172031003,2020-10-27,712,21,691,2,0,2
DKI JAKARTA,JAKARTA UTARA,KOJA,LAGOA,3172031003,2020-10-28,722,22,700,10,1,9
DKI JAKARTA,JAKARTA UTARA,KOJA,LAGOA,3172031003,2020-10-29,730,18,713,8,-4,13
DKI JAKARTA,JAKARTA UTARA,KOJA,LAGOA,3172031003,2020-10-30,739,21,719,9,3,6
DKI JAKARTA,JAKARTA UTARA,KOJA,LAGOA,3172031003,2020-10-31,750,30,721,11,9,2
DKI JAKARTA,JAKARTA UTARA,KOJA,RAWA BADAK SELATAN,3172031006,2020-10-01,501,45,456,0,0,0
DKI JAKARTA,JAKARTA UTARA,KOJA,RAWA BADAK SELATAN,3172031006,2020-10-02,503,39,464,2,-6,8
DKI JAKARTA,JAKARTA UTARA,KOJA,RAWA BADAK SELATAN,3172031006,2020-10-03,505,37,468,2,-2,4
DKI JAKARTA,JAKARTA UTARA,KOJA,RAWA BADAK SELATAN,3172031006,2020-10-04,508,37,471,3,0,3
DKI JAKARTA,JAKARTA UTARA,KOJA,RAWA BADAK SELATAN,3172031006,2020-10-05,510,38,472,2,1,1
DKI JAKARTA,JAKARTA UTARA,KOJA,RAWA BADAK SELATAN,3172031006,2020-10-06,519,36,483,9,-2,11
DKI JAKARTA,JAKARTA UTARA,KOJA,RAWA BADAK SELATAN,3172031006,2020-10-07,520,33,487,1,-3,4
DKI JAKARTA,JAKARTA UTARA,KOJA,RAWA BADAK SELATAN,3172031006,2020-10-08,526,30,496,6,-3,9
DKI JAKARTA,JAKARTA UTARA,KOJA,RAWA BADAK SELATAN,3172031006,2020-10-09,528,30,498,2,0,2
DKI JAKARTA,JAKARTA UTARA,KOJA,RAWA BADAK SELATAN,3172031006,2020-10-10,529,12,517,1,-18,19
DKI JAKARTA,JAKARTA UTARA,KOJA,RAWA BADAK SELATAN,3172031006,2020-10-11,531,14,517,2,2,0
DKI JAKARTA,JAKARTA UTARA,KOJA,RAWA BADAK SELATAN,3172031006,2020-10-12,532,13,519,1,-1,2
DKI JAKARTA,JAKARTA UTARA,KOJA,RAWA BADAK SELATAN,3172031006,2020-10-13,533,13,520,1,0,1
DKI JAKARTA,JAKARTA UTARA,KOJA,RAWA BADAK SELATAN,3172031006,2020-10-14,535,12,523,2,-1,3
DKI JAKARTA,JAKARTA UTARA,KOJA,RAWA BADAK SELATAN,3172031006,2020-10-15,537,13,524,2,1,1
DKI JAKARTA,JAKARTA UTARA,KOJA,RAWA BADAK SELATAN,3172031006,2020-10-16,539,12,527,2,-1,3
DKI JAKARTA,JAKARTA UTARA,KOJA,RAWA BADAK SELATAN,3172031006,2020-10-17,555,24,531,16,12,4
DKI JAKARTA,JAKARTA UTARA,KOJA,RAWA BADAK SELATAN,3172031006,2020-10-18,559,28,531,4,4,0
DKI JAKARTA,JAKARTA UTARA,KOJA,RAWA BADAK SELATAN,3172031006,2020-10-19,561,29,532,2,1,1
DKI JAKARTA,JAKARTA UTARA,KOJA,RAWA BADAK SELATAN,3172031006,2020-10-20,563,29,534,2,0,2
DKI JAKARTA,JAKARTA UTARA,KOJA,RAWA BADAK SELATAN,3172031006,2020-10-21,563,26,537,0,-3,3
DKI JAKARTA,JAKARTA UTARA,KOJA,RAWA BADAK SELATAN,3172031006,2020-10-22,576,29,547,13,3,10
DKI JAKARTA,JAKARTA UTARA,KOJA,RAWA BADAK SELATAN,3172031006,2020-10-23,578,30,548,2,1,1
DKI JAKARTA,JAKARTA UTARA,KOJA,RAWA BADAK SELATAN,3172031006,2020-10-24,581,30,551,3,0,3
DKI JAKARTA,JAKARTA UTARA,KOJA,RAWA BADAK SELATAN,3172031006,2020-10-25,582,31,551,1,1,0
DKI JAKARTA,JAKARTA UTARA,KOJA,RAWA BADAK SELATAN,3172031006,2020-10-26,582,29,553,0,-2,2
DKI JAKARTA,JAKARTA UTARA,KOJA,RAWA BADAK SELATAN,3172031006,2020-10-27,586,32,554,4,3,1
DKI JAKARTA,JAKARTA UTARA,KOJA,RAWA BADAK SELATAN,3172031006,2020-10-28,590,29,561,4,-3,7
DKI JAKARTA,JAKARTA UTARA,KOJA,RAWA BADAK SELATAN,3172031006,2020-10-29,595,18,578,5,-11,17
DKI JAKARTA,JAKARTA UTARA,KOJA,RAWA BADAK SELATAN,3172031006,2020-10-30,609,25,585,14,7,7
DKI JAKARTA,JAKARTA UTARA,KOJA,RAWA BADAK SELATAN,3172031006,2020-10-31,616,30,587,7,5,2
DKI JAKARTA,JAKARTA UTARA,KOJA,RAWA BADAK UTARA,3172031004,2020-10-01,438,36,402,0,0,0
DKI JAKARTA,JAKARTA UTARA,KOJA,RAWA BADAK UTARA,3172031004,2020-10-02,444,37,407,6,1,5
DKI JAKARTA,JAKARTA UTARA,KOJA,RAWA BADAK UTARA,3172031004,2020-10-03,445,36,409,1,-1,2
DKI JAKARTA,JAKARTA UTARA,KOJA,RAWA BADAK UTARA,3172031004,2020-10-04,448,37,411,3,1,2
DKI JAKARTA,JAKARTA UTARA,KOJA,RAWA BADAK UTARA,3172031004,2020-10-05,450,28,422,2,-9,11
DKI JAKARTA,JAKARTA UTARA,KOJA,RAWA BADAK UTARA,3172031004,2020-10-06,457,29,428,7,1,6
DKI JAKARTA,JAKARTA UTARA,KOJA,RAWA BADAK UTARA,3172031004,2020-10-07,462,31,431,5,2,3
DKI JAKARTA,JAKARTA UTARA,KOJA,RAWA BADAK UTARA,3172031004,2020-10-08,470,29,441,8,-2,10
DKI JAKARTA,JAKARTA UTARA,KOJA,RAWA BADAK UTARA,3172031004,2020-10-09,471,30,441,1,1,0
DKI JAKARTA,JAKARTA UTARA,KOJA,RAWA BADAK UTARA,3172031004,2020-10-10,473,25,448,2,-5,7
DKI JAKARTA,JAKARTA UTARA,KOJA,RAWA BADAK UTARA,3172031004,2020-10-11,473,22,451,0,-3,3
DKI JAKARTA,JAKARTA UTARA,KOJA,RAWA BADAK UTARA,3172031004,2020-10-12,477,20,457,4,-2,6
DKI JAKARTA,JAKARTA UTARA,KOJA,RAWA BADAK UTARA,3172031004,2020-10-13,482,23,459,5,3,2
DKI JAKARTA,JAKARTA UTARA,KOJA,RAWA BADAK UTARA,3172031004,2020-10-14,483,21,462,1,-2,3
DKI JAKARTA,JAKARTA UTARA,KOJA,RAWA BADAK UTARA,3172031004,2020-10-15,486,22,464,3,1,2
DKI JAKARTA,JAKARTA UTARA,KOJA,RAWA BADAK UTARA,3172031004,2020-10-16,492,25,467,6,3,3
DKI JAKARTA,JAKARTA UTARA,KOJA,RAWA BADAK UTARA,3172031004,2020-10-17,496,24,472,4,-1,5
DKI JAKARTA,JAKARTA UTARA,KOJA,RAWA BADAK UTARA,3172031004,2020-10-18,500,26,474,4,2,2
DKI JAKARTA,JAKARTA UTARA,KOJA,RAWA BADAK UTARA,3172031004,2020-10-19,506,23,483,6,-3,9
DKI JAKARTA,JAKARTA UTARA,KOJA,RAWA BADAK UTARA,3172031004,2020-10-20,508,21,487,2,-2,4
DKI JAKARTA,JAKARTA UTARA,KOJA,RAWA BADAK UTARA,3172031004,2020-10-21,522,29,493,14,8,6
DKI JAKARTA,JAKARTA UTARA,KOJA,RAWA BADAK UTARA,3172031004,2020-10-22,522,24,498,0,-5,5
DKI JAKARTA,JAKARTA UTARA,KOJA,RAWA BADAK UTARA,3172031004,2020-10-23,524,26,498,2,2,0
DKI JAKARTA,JAKARTA UTARA,KOJA,RAWA BADAK UTARA,3172031004,2020-10-24,530,26,504,6,0,6
DKI JAKARTA,JAKARTA UTARA,KOJA,RAWA BADAK UTARA,3172031004,2020-10-25,533,26,507,3,0,3
DKI JAKARTA,JAKARTA UTARA,KOJA,RAWA BADAK UTARA,3172031004,2020-10-26,533,22,511,0,-4,4
DKI JAKARTA,JAKARTA UTARA,KOJA,RAWA BADAK UTARA,3172031004,2020-10-27,535,19,516,2,-3,5
DKI JAKARTA,JAKARTA UTARA,KOJA,RAWA BADAK UTARA,3172031004,2020-10-28,549,18,531,14,-1,15
DKI JAKARTA,JAKARTA UTARA,KOJA,RAWA BADAK UTARA,3172031004,2020-10-29,555,18,537,6,0,6
DKI JAKARTA,JAKARTA UTARA,KOJA,RAWA BADAK UTARA,3172031004,2020-10-30,565,24,541,10,6,4
DKI JAKARTA,JAKARTA UTARA,KOJA,RAWA BADAK UTARA,3172031004,2020-10-31,570,27,543,5,3,2
DKI JAKARTA,JAKARTA UTARA,KOJA,TUGU SELATAN,3172031005,2020-10-01,387,29,358,0,0,0
DKI JAKARTA,JAKARTA UTARA,KOJA,TUGU SELATAN,3172031005,2020-10-02,389,28,361,2,-1,3
DKI JAKARTA,JAKARTA UTARA,KOJA,TUGU SELATAN,3172031005,2020-10-03,393,29,364,4,1,3
DKI JAKARTA,JAKARTA UTARA,KOJA,TUGU SELATAN,3172031005,2020-10-04,394,29,365,1,0,1
DKI JAKARTA,JAKARTA UTARA,KOJA,TUGU SELATAN,3172031005,2020-10-05,395,25,370,1,-4,5
DKI JAKARTA,JAKARTA UTARA,KOJA,TUGU SELATAN,3172031005,2020-10-06,400,25,375,5,0,5
DKI JAKARTA,JAKARTA UTARA,KOJA,TUGU SELATAN,3172031005,2020-10-07,404,25,379,4,0,4
DKI JAKARTA,JAKARTA UTARA,KOJA,TUGU SELATAN,3172031005,2020-10-08,409,23,386,5,-2,7
DKI JAKARTA,JAKARTA UTARA,KOJA,TUGU SELATAN,3172031005,2020-10-09,410,24,386,1,1,0
DKI JAKARTA,JAKARTA UTARA,KOJA,TUGU SELATAN,3172031005,2020-10-10,413,18,395,3,-6,9
DKI JAKARTA,JAKARTA UTARA,KOJA,TUGU SELATAN,3172031005,2020-10-11,417,19,398,4,1,3
DKI JAKARTA,JAKARTA UTARA,KOJA,TUGU SELATAN,3172031005,2020-10-12,421,17,404,4,-2,6
DKI JAKARTA,JAKARTA UTARA,KOJA,TUGU SELATAN,3172031005,2020-10-13,424,16,408,3,-1,4
DKI JAKARTA,JAKARTA UTARA,KOJA,TUGU SELATAN,3172031005,2020-10-14,427,15,412,3,-1,4
DKI JAKARTA,JAKARTA UTARA,KOJA,TUGU SELATAN,3172031005,2020-10-15,434,16,418,7,1,6
DKI JAKARTA,JAKARTA UTARA,KOJA,TUGU SELATAN,3172031005,2020-10-16,438,20,418,4,4,0
DKI JAKARTA,JAKARTA UTARA,KOJA,TUGU SELATAN,3172031005,2020-10-17,453,31,422,15,11,4
DKI JAKARTA,JAKARTA UTARA,KOJA,TUGU SELATAN,3172031005,2020-10-18,456,33,423,3,2,1
DKI JAKARTA,JAKARTA UTARA,KOJA,TUGU SELATAN,3172031005,2020-10-19,456,29,427,0,-4,4
DKI JAKARTA,JAKARTA UTARA,KOJA,TUGU SELATAN,3172031005,2020-10-20,462,30,432,6,1,5
DKI JAKARTA,JAKARTA UTARA,KOJA,TUGU SELATAN,3172031005,2020-10-21,463,28,435,1,-2,3
DKI JAKARTA,JAKARTA UTARA,KOJA,TUGU SELATAN,3172031005,2020-10-22,465,28,437,2,0,2
DKI JAKARTA,JAKARTA UTARA,KOJA,TUGU SELATAN,3172031005,2020-10-23,466,29,437,1,1,0
DKI JAKARTA,JAKARTA UTARA,KOJA,TUGU SELATAN,3172031005,2020-10-24,470,29,441,4,0,4
DKI JAKARTA,JAKARTA UTARA,KOJA,TUGU SELATAN,3172031005,2020-10-25,472,29,443,2,0,2
DKI JAKARTA,JAKARTA UTARA,KOJA,TUGU SELATAN,3172031005,2020-10-26,473,27,446,1,-2,3
DKI JAKARTA,JAKARTA UTARA,KOJA,TUGU SELATAN,3172031005,2020-10-27,477,31,446,4,4,0
DKI JAKARTA,JAKARTA UTARA,KOJA,TUGU SELATAN,3172031005,2020-10-28,478,29,449,1,-2,3
DKI JAKARTA,JAKARTA UTARA,KOJA,TUGU SELATAN,3172031005,2020-10-29,480,16,465,2,-13,16
DKI JAKARTA,JAKARTA UTARA,KOJA,TUGU SELATAN,3172031005,2020-10-30,485,19,467,5,3,2
DKI JAKARTA,JAKARTA UTARA,KOJA,TUGU SELATAN,3172031005,2020-10-31,489,21,469,4,2,2
DKI JAKARTA,JAKARTA UTARA,KOJA,TUGU UTARA,3172031002,2020-10-01,738,63,675,0,0,0
DKI JAKARTA,JAKARTA UTARA,KOJA,TUGU UTARA,3172031002,2020-10-02,744,64,680,6,1,5
DKI JAKARTA,JAKARTA UTARA,KOJA,TUGU UTARA,3172031002,2020-10-03,745,62,683,1,-2,3
DKI JAKARTA,JAKARTA UTARA,KOJA,TUGU UTARA,3172031002,2020-10-04,756,66,690,11,4,7
DKI JAKARTA,JAKARTA UTARA,KOJA,TUGU UTARA,3172031002,2020-10-05,757,49,708,1,-17,18
DKI JAKARTA,JAKARTA UTARA,KOJA,TUGU UTARA,3172031002,2020-10-06,764,49,715,7,0,7
DKI JAKARTA,JAKARTA UTARA,KOJA,TUGU UTARA,3172031002,2020-10-07,772,54,718,8,5,3
DKI JAKARTA,JAKARTA UTARA,KOJA,TUGU UTARA,3172031002,2020-10-08,772,44,728,0,-10,10
DKI JAKARTA,JAKARTA UTARA,KOJA,TUGU UTARA,3172031002,2020-10-09,776,48,728,4,4,0
DKI JAKARTA,JAKARTA UTARA,KOJA,TUGU UTARA,3172031002,2020-10-10,782,41,741,6,-7,13
DKI JAKARTA,JAKARTA UTARA,KOJA,TUGU UTARA,3172031002,2020-10-11,784,38,746,2,-3,5
DKI JAKARTA,JAKARTA UTARA,KOJA,TUGU UTARA,3172031002,2020-10-12,785,29,756,1,-9,10
DKI JAKARTA,JAKARTA UTARA,KOJA,TUGU UTARA,3172031002,2020-10-13,791,31,760,6,2,4
DKI JAKARTA,JAKARTA UTARA,KOJA,TUGU UTARA,3172031002,2020-10-14,802,29,773,11,-2,13
DKI JAKARTA,JAKARTA UTARA,KOJA,TUGU UTARA,3172031002,2020-10-15,809,32,777,7,3,4
DKI JAKARTA,JAKARTA UTARA,KOJA,TUGU UTARA,3172031002,2020-10-16,817,38,779,8,6,2
DKI JAKARTA,JAKARTA UTARA,KOJA,TUGU UTARA,3172031002,2020-10-17,833,48,785,16,10,6
DKI JAKARTA,JAKARTA UTARA,KOJA,TUGU UTARA,3172031002,2020-10-18,840,54,786,7,6,1
DKI JAKARTA,JAKARTA UTARA,KOJA,TUGU UTARA,3172031002,2020-10-19,843,51,792,3,-3,6
DKI JAKARTA,JAKARTA UTARA,KOJA,TUGU UTARA,3172031002,2020-10-20,849,49,800,6,-2,8
DKI JAKARTA,JAKARTA UTARA,KOJA,TUGU UTARA,3172031002,2020-10-21,855,45,810,6,-4,10
DKI JAKARTA,JAKARTA UTARA,KOJA,TUGU UTARA,3172031002,2020-10-22,862,46,816,7,1,6
DKI JAKARTA,JAKARTA UTARA,KOJA,TUGU UTARA,3172031002,2020-10-23,863,47,816,1,1,0
DKI JAKARTA,JAKARTA UTARA,KOJA,TUGU UTARA,3172031002,2020-10-24,867,46,821,4,-1,5
DKI JAKARTA,JAKARTA UTARA,KOJA,TUGU UTARA,3172031002,2020-10-25,869,45,824,2,-1,3
DKI JAKARTA,JAKARTA UTARA,KOJA,TUGU UTARA,3172031002,2020-10-26,873,41,832,4,-4,8
DKI JAKARTA,JAKARTA UTARA,KOJA,TUGU UTARA,3172031002,2020-10-27,882,42,840,9,1,8
DKI JAKARTA,JAKARTA UTARA,KOJA,TUGU UTARA,3172031002,2020-10-28,886,41,845,4,-1,5
DKI JAKARTA,JAKARTA UTARA,KOJA,TUGU UTARA,3172031002,2020-10-29,894,32,862,8,-9,17
DKI JAKARTA,JAKARTA UTARA,KOJA,TUGU UTARA,3172031002,2020-10-30,907,39,868,13,7,6
DKI JAKARTA,JAKARTA UTARA,KOJA,TUGU UTARA,3172031002,2020-10-31,917,42,875,10,3,7
DKI JAKARTA,JAKARTA UTARA,PADEMANGAN,ANCOL,3172051003,2020-10-01,540,29,511,0,0,0
DKI JAKARTA,JAKARTA UTARA,PADEMANGAN,ANCOL,3172051003,2020-10-02,549,32,517,9,3,6
DKI JAKARTA,JAKARTA UTARA,PADEMANGAN,ANCOL,3172051003,2020-10-03,550,32,518,1,0,1
DKI JAKARTA,JAKARTA UTARA,PADEMANGAN,ANCOL,3172051003,2020-10-04,553,32,521,3,0,3
DKI JAKARTA,JAKARTA UTARA,PADEMANGAN,ANCOL,3172051003,2020-10-05,555,23,532,2,-9,11
DKI JAKARTA,JAKARTA UTARA,PADEMANGAN,ANCOL,3172051003,2020-10-06,556,22,534,1,-1,2
DKI JAKARTA,JAKARTA UTARA,PADEMANGAN,ANCOL,3172051003,2020-10-07,557,19,538,1,-3,4
DKI JAKARTA,JAKARTA UTARA,PADEMANGAN,ANCOL,3172051003,2020-10-08,567,24,543,10,5,5
DKI JAKARTA,JAKARTA UTARA,PADEMANGAN,ANCOL,3172051003,2020-10-09,572,26,546,5,2,3
DKI JAKARTA,JAKARTA UTARA,PADEMANGAN,ANCOL,3172051003,2020-10-10,575,23,552,3,-3,6
DKI JAKARTA,JAKARTA UTARA,PADEMANGAN,ANCOL,3172051003,2020-10-11,578,24,554,3,1,2
DKI JAKARTA,JAKARTA UTARA,PADEMANGAN,ANCOL,3172051003,2020-10-12,578,21,557,0,-3,3
DKI JAKARTA,JAKARTA UTARA,PADEMANGAN,ANCOL,3172051003,2020-10-13,580,22,558,2,1,1
DKI JAKARTA,JAKARTA UTARA,PADEMANGAN,ANCOL,3172051003,2020-10-14,583,23,560,3,1,2
DKI JAKARTA,JAKARTA UTARA,PADEMANGAN,ANCOL,3172051003,2020-10-15,589,25,564,6,2,4
DKI JAKARTA,JAKARTA UTARA,PADEMANGAN,ANCOL,3172051003,2020-10-16,600,34,566,11,9,2
DKI JAKARTA,JAKARTA UTARA,PADEMANGAN,ANCOL,3172051003,2020-10-17,603,36,567,3,2,1
DKI JAKARTA,JAKARTA UTARA,PADEMANGAN,ANCOL,3172051003,2020-10-18,607,38,569,4,2,2
DKI JAKARTA,JAKARTA UTARA,PADEMANGAN,ANCOL,3172051003,2020-10-19,607,34,573,0,-4,4
DKI JAKARTA,JAKARTA UTARA,PADEMANGAN,ANCOL,3172051003,2020-10-20,608,34,574,1,0,1
DKI JAKARTA,JAKARTA UTARA,PADEMANGAN,ANCOL,3172051003,2020-10-21,608,26,582,0,-8,8
DKI JAKARTA,JAKARTA UTARA,PADEMANGAN,ANCOL,3172051003,2020-10-22,610,24,586,2,-2,4
DKI JAKARTA,JAKARTA UTARA,PADEMANGAN,ANCOL,3172051003,2020-10-23,612,26,586,2,2,0
DKI JAKARTA,JAKARTA UTARA,PADEMANGAN,ANCOL,3172051003,2020-10-24,614,25,589,2,-1,3
DKI JAKARTA,JAKARTA UTARA,PADEMANGAN,ANCOL,3172051003,2020-10-25,616,26,590,2,1,1
DKI JAKARTA,JAKARTA UTARA,PADEMANGAN,ANCOL,3172051003,2020-10-26,617,14,603,1,-12,13
DKI JAKARTA,JAKARTA UTARA,PADEMANGAN,ANCOL,3172051003,2020-10-27,621,13,608,4,-1,5
DKI JAKARTA,JAKARTA UTARA,PADEMANGAN,ANCOL,3172051003,2020-10-28,621,12,609,0,-1,1
DKI JAKARTA,JAKARTA UTARA,PADEMANGAN,ANCOL,3172051003,2020-10-29,627,15,612,6,3,3
DKI JAKARTA,JAKARTA UTARA,PADEMANGAN,ANCOL,3172051003,2020-10-30,629,15,614,2,0,2
DKI JAKARTA,JAKARTA UTARA,PADEMANGAN,ANCOL,3172051003,2020-10-31,633,18,615,4,3,1
DKI JAKARTA,JAKARTA UTARA,PADEMANGAN,PADEMANGAN BARAT,3172051002,2020-10-01,2282,66,2216,0,0,0
DKI JAKARTA,JAKARTA UTARA,PADEMANGAN,PADEMANGAN BARAT,3172051002,2020-10-02,2289,59,2230,7,-7,14
DKI JAKARTA,JAKARTA UTARA,PADEMANGAN,PADEMANGAN BARAT,3172051002,2020-10-03,2299,65,2234,10,6,4
DKI JAKARTA,JAKARTA UTARA,PADEMANGAN,PADEMANGAN BARAT,3172051002,2020-10-04,2301,66,2235,2,1,1
DKI JAKARTA,JAKARTA UTARA,PADEMANGAN,PADEMANGAN BARAT,3172051002,2020-10-05,2302,52,2250,1,-14,15
DKI JAKARTA,JAKARTA UTARA,PADEMANGAN,PADEMANGAN BARAT,3172051002,2020-10-06,2311,52,2259,9,0,9
DKI JAKARTA,JAKARTA UTARA,PADEMANGAN,PADEMANGAN BARAT,3172051002,2020-10-07,2313,48,2265,2,-4,6
DKI JAKARTA,JAKARTA UTARA,PADEMANGAN,PADEMANGAN BARAT,3172051002,2020-10-08,2358,89,2269,45,41,4
DKI JAKARTA,JAKARTA UTARA,PADEMANGAN,PADEMANGAN BARAT,3172051002,2020-10-09,2364,95,2269,6,6,0
DKI JAKARTA,JAKARTA UTARA,PADEMANGAN,PADEMANGAN BARAT,3172051002,2020-10-10,2374,95,2279,10,0,10
DKI JAKARTA,JAKARTA UTARA,PADEMANGAN,PADEMANGAN BARAT,3172051002,2020-10-11,2380,96,2284,6,1,5
DKI JAKARTA,JAKARTA UTARA,PADEMANGAN,PADEMANGAN BARAT,3172051002,2020-10-12,2384,88,2296,4,-8,12
DKI JAKARTA,JAKARTA UTARA,PADEMANGAN,PADEMANGAN BARAT,3172051002,2020-10-13,2385,79,2306,1,-9,10
DKI JAKARTA,JAKARTA UTARA,PADEMANGAN,PADEMANGAN BARAT,3172051002,2020-10-14,2392,82,2310,7,3,4
DKI JAKARTA,JAKARTA UTARA,PADEMANGAN,PADEMANGAN BARAT,3172051002,2020-10-15,2406,78,2328,14,-4,18
DKI JAKARTA,JAKARTA UTARA,PADEMANGAN,PADEMANGAN BARAT,3172051002,2020-10-16,2412,68,2344,6,-10,16
DKI JAKARTA,JAKARTA UTARA,PADEMANGAN,PADEMANGAN BARAT,3172051002,2020-10-17,2423,73,2350,11,5,6
DKI JAKARTA,JAKARTA UTARA,PADEMANGAN,PADEMANGAN BARAT,3172051002,2020-10-18,2434,80,2354,11,7,4
DKI JAKARTA,JAKARTA UTARA,PADEMANGAN,PADEMANGAN BARAT,3172051002,2020-10-19,2437,59,2378,3,-21,24
DKI JAKARTA,JAKARTA UTARA,PADEMANGAN,PADEMANGAN BARAT,3172051002,2020-10-20,2443,63,2380,6,4,2
DKI JAKARTA,JAKARTA UTARA,PADEMANGAN,PADEMANGAN BARAT,3172051002,2020-10-21,2446,64,2382,3,1,2
DKI JAKARTA,JAKARTA UTARA,PADEMANGAN,PADEMANGAN BARAT,3172051002,2020-10-22,2448,57,2391,2,-7,9
DKI JAKARTA,JAKARTA UTARA,PADEMANGAN,PADEMANGAN BARAT,3172051002,2020-10-23,2451,58,2393,3,1,2
DKI JAKARTA,JAKARTA UTARA,PADEMANGAN,PADEMANGAN BARAT,3172051002,2020-10-24,2454,55,2399,3,-3,6
DKI JAKARTA,JAKARTA UTARA,PADEMANGAN,PADEMANGAN BARAT,3172051002,2020-10-25,2458,58,2400,4,3,1
DKI JAKARTA,JAKARTA UTARA,PADEMANGAN,PADEMANGAN BARAT,3172051002,2020-10-26,2460,39,2421,2,-19,21
DKI JAKARTA,JAKARTA UTARA,PADEMANGAN,PADEMANGAN BARAT,3172051002,2020-10-27,2471,41,2430,11,2,9
DKI JAKARTA,JAKARTA UTARA,PADEMANGAN,PADEMANGAN BARAT,3172051002,2020-10-28,2478,38,2440,7,-3,10
DKI JAKARTA,JAKARTA UTARA,PADEMANGAN,PADEMANGAN BARAT,3172051002,2020-10-29,2491,41,2450,13,3,10
DKI JAKARTA,JAKARTA UTARA,PADEMANGAN,PADEMANGAN BARAT,3172051002,2020-10-30,2527,68,2459,36,27,9
DKI JAKARTA,JAKARTA UTARA,PADEMANGAN,PADEMANGAN BARAT,3172051002,2020-10-31,2539,79,2460,12,11,1
DKI JAKARTA,JAKARTA UTARA,PADEMANGAN,PADEMANGAN TIMUR,3172051001,2020-10-01,776,64,712,0,0,0
DKI JAKARTA,JAKARTA UTARA,PADEMANGAN,PADEMANGAN TIMUR,3172051001,2020-10-02,783,60,723,7,-4,11
DKI JAKARTA,JAKARTA UTARA,PADEMANGAN,PADEMANGAN TIMUR,3172051001,2020-10-03,785,63,722,2,3,-1
DKI JAKARTA,JAKARTA UTARA,PADEMANGAN,PADEMANGAN TIMUR,3172051001,2020-10-04,793,69,724,8,6,2
DKI JAKARTA,JAKARTA UTARA,PADEMANGAN,PADEMANGAN TIMUR,3172051001,2020-10-05,794,70,724,1,1,0
DKI JAKARTA,JAKARTA UTARA,PADEMANGAN,PADEMANGAN TIMUR,3172051001,2020-10-06,802,53,749,8,-17,25
DKI JAKARTA,JAKARTA UTARA,PADEMANGAN,PADEMANGAN TIMUR,3172051001,2020-10-07,809,57,752,7,4,3
DKI JAKARTA,JAKARTA UTARA,PADEMANGAN,PADEMANGAN TIMUR,3172051001,2020-10-08,815,51,764,6,-6,12
DKI JAKARTA,JAKARTA UTARA,PADEMANGAN,PADEMANGAN TIMUR,3172051001,2020-10-09,817,51,766,2,0,2
DKI JAKARTA,JAKARTA UTARA,PADEMANGAN,PADEMANGAN TIMUR,3172051001,2020-10-10,833,46,787,16,-5,21
DKI JAKARTA,JAKARTA UTARA,PADEMANGAN,PADEMANGAN TIMUR,3172051001,2020-10-11,841,52,789,8,6,2
DKI JAKARTA,JAKARTA UTARA,PADEMANGAN,PADEMANGAN TIMUR,3172051001,2020-10-12,845,49,796,4,-3,7
DKI JAKARTA,JAKARTA UTARA,PADEMANGAN,PADEMANGAN TIMUR,3172051001,2020-10-13,847,47,800,2,-2,4
DKI JAKARTA,JAKARTA UTARA,PADEMANGAN,PADEMANGAN TIMUR,3172051001,2020-10-14,848,44,804,1,-3,4
DKI JAKARTA,JAKARTA UTARA,PADEMANGAN,PADEMANGAN TIMUR,3172051001,2020-10-15,854,42,812,6,-2,8
DKI JAKARTA,JAKARTA UTARA,PADEMANGAN,PADEMANGAN TIMUR,3172051001,2020-10-16,864,40,824,10,-2,12
DKI JAKARTA,JAKARTA UTARA,PADEMANGAN,PADEMANGAN TIMUR,3172051001,2020-10-17,877,50,827,13,10,3
DKI JAKARTA,JAKARTA UTARA,PADEMANGAN,PADEMANGAN TIMUR,3172051001,2020-10-18,882,50,832,5,0,5
DKI JAKARTA,JAKARTA UTARA,PADEMANGAN,PADEMANGAN TIMUR,3172051001,2020-10-19,882,48,834,0,-2,2
DKI JAKARTA,JAKARTA UTARA,PADEMANGAN,PADEMANGAN TIMUR,3172051001,2020-10-20,885,47,838,3,-1,4
DKI JAKARTA,JAKARTA UTARA,PADEMANGAN,PADEMANGAN TIMUR,3172051001,2020-10-21,886,43,843,1,-4,5
DKI JAKARTA,JAKARTA UTARA,PADEMANGAN,PADEMANGAN TIMUR,3172051001,2020-10-22,888,39,849,2,-4,6
DKI JAKARTA,JAKARTA UTARA,PADEMANGAN,PADEMANGAN TIMUR,3172051001,2020-10-23,890,40,850,2,1,1
DKI JAKARTA,JAKARTA UTARA,PADEMANGAN,PADEMANGAN TIMUR,3172051001,2020-10-24,893,36,857,3,-4,7
DKI JAKARTA,JAKARTA UTARA,PADEMANGAN,PADEMANGAN TIMUR,3172051001,2020-10-25,897,37,860,4,1,3
DKI JAKARTA,JAKARTA UTARA,PADEMANGAN,PADEMANGAN TIMUR,3172051001,2020-10-26,901,32,869,4,-5,9
DKI JAKARTA,JAKARTA UTARA,PADEMANGAN,PADEMANGAN TIMUR,3172051001,2020-10-27,902,23,879,1,-9,10
DKI JAKARTA,JAKARTA UTARA,PADEMANGAN,PADEMANGAN TIMUR,3172051001,2020-10-28,906,19,887,4,-4,8
DKI JAKARTA,JAKARTA UTARA,PADEMANGAN,PADEMANGAN TIMUR,3172051001,2020-10-29,908,16,893,2,-3,6
DKI JAKARTA,JAKARTA UTARA,PADEMANGAN,PADEMANGAN TIMUR,3172051001,2020-10-30,914,19,896,6,3,3
DKI JAKARTA,JAKARTA UTARA,PADEMANGAN,PADEMANGAN TIMUR,3172051001,2020-10-31,917,21,897,3,2,1
DKI JAKARTA,JAKARTA UTARA,PENJARINGAN,KAMAL MUARA,3172011002,2020-10-01,141,11,130,0,0,0
DKI JAKARTA,JAKARTA UTARA,PENJARINGAN,KAMAL MUARA,3172011002,2020-10-02,148,14,134,7,3,4
DKI JAKARTA,JAKARTA UTARA,PENJARINGAN,KAMAL MUARA,3172011002,2020-10-03,148,11,137,0,-3,3
DKI JAKARTA,JAKARTA UTARA,PENJARINGAN,KAMAL MUARA,3172011002,2020-10-04,153,14,139,5,3,2
DKI JAKARTA,JAKARTA UTARA,PENJARINGAN,KAMAL MUARA,3172011002,2020-10-05,153,13,140,0,-1,1
DKI JAKARTA,JAKARTA UTARA,PENJARINGAN,KAMAL MUARA,3172011002,2020-10-06,154,11,143,1,-2,3
DKI JAKARTA,JAKARTA UTARA,PENJARINGAN,KAMAL MUARA,3172011002,2020-10-07,165,17,148,11,6,5
DKI JAKARTA,JAKARTA UTARA,PENJARINGAN,KAMAL MUARA,3172011002,2020-10-08,165,17,148,0,0,0
DKI JAKARTA,JAKARTA UTARA,PENJARINGAN,KAMAL MUARA,3172011002,2020-10-09,168,20,148,3,3,0
DKI JAKARTA,JAKARTA UTARA,PENJARINGAN,KAMAL MUARA,3172011002,2020-10-10,176,24,152,8,4,4
DKI JAKARTA,JAKARTA UTARA,PENJARINGAN,KAMAL MUARA,3172011002,2020-10-11,181,26,155,5,2,3
DKI JAKARTA,JAKARTA UTARA,PENJARINGAN,KAMAL MUARA,3172011002,2020-10-12,195,39,156,14,13,1
DKI JAKARTA,JAKARTA UTARA,PENJARINGAN,KAMAL MUARA,3172011002,2020-10-13,197,37,160,2,-2,4
DKI JAKARTA,JAKARTA UTARA,PENJARINGAN,KAMAL MUARA,3172011002,2020-10-14,198,36,162,1,-1,2
DKI JAKARTA,JAKARTA UTARA,PENJARINGAN,KAMAL MUARA,3172011002,2020-10-15,204,35,169,6,-1,7
DKI JAKARTA,JAKARTA UTARA,PENJARINGAN,KAMAL MUARA,3172011002,2020-10-16,206,32,174,2,-3,5
DKI JAKARTA,JAKARTA UTARA,PENJARINGAN,KAMAL MUARA,3172011002,2020-10-17,207,28,179,1,-4,5
DKI JAKARTA,JAKARTA UTARA,PENJARINGAN,KAMAL MUARA,3172011002,2020-10-18,207,28,179,0,0,0
DKI JAKARTA,JAKARTA UTARA,PENJARINGAN,KAMAL MUARA,3172011002,2020-10-19,208,28,180,1,0,1
DKI JAKARTA,JAKARTA UTARA,PENJARINGAN,KAMAL MUARA,3172011002,2020-10-20,208,24,184,0,-4,4
DKI JAKARTA,JAKARTA UTARA,PENJARINGAN,KAMAL MUARA,3172011002,2020-10-21,208,12,196,0,-12,12
DKI JAKARTA,JAKARTA UTARA,PENJARINGAN,KAMAL MUARA,3172011002,2020-10-22,208,5,203,0,-7,7
DKI JAKARTA,JAKARTA UTARA,PENJARINGAN,KAMAL MUARA,3172011002,2020-10-23,208,5,203,0,0,0
DKI JAKARTA,JAKARTA UTARA,PENJARINGAN,KAMAL MUARA,3172011002,2020-10-24,208,3,205,0,-2,2
DKI JAKARTA,JAKARTA UTARA,PENJARINGAN,KAMAL MUARA,3172011002,2020-10-25,209,4,205,1,1,0
DKI JAKARTA,JAKARTA UTARA,PENJARINGAN,KAMAL MUARA,3172011002,2020-10-26,209,3,206,0,-1,1
DKI JAKARTA,JAKARTA UTARA,PENJARINGAN,KAMAL MUARA,3172011002,2020-10-27,211,4,207,2,1,1
DKI JAKARTA,JAKARTA UTARA,PENJARINGAN,KAMAL MUARA,3172011002,2020-10-28,211,3,208,0,-1,1
DKI JAKARTA,JAKARTA UTARA,PENJARINGAN,KAMAL MUARA,3172011002,2020-10-29,214,5,209,3,2,1
DKI JAKARTA,JAKARTA UTARA,PENJARINGAN,KAMAL MUARA,3172011002,2020-10-30,217,8,209,3,3,0
DKI JAKARTA,JAKARTA UTARA,PENJARINGAN,KAMAL MUARA,3172011002,2020-10-31,224,13,211,7,5,2
DKI JAKARTA,JAKARTA UTARA,PENJARINGAN,KAPUK MUARA,3172011003,2020-10-01,427,52,375,0,0,0
DKI JAKARTA,JAKARTA UTARA,PENJARINGAN,KAPUK MUARA,3172011003,2020-10-02,440,54,386,13,2,11
DKI JAKARTA,JAKARTA UTARA,PENJARINGAN,KAPUK MUARA,3172011003,2020-10-03,442,54,388,2,0,2
DKI JAKARTA,JAKARTA UTARA,PENJARINGAN,KAPUK MUARA,3172011003,2020-10-04,447,58,389,5,4,1
DKI JAKARTA,JAKARTA UTARA,PENJARINGAN,KAPUK MUARA,3172011003,2020-10-05,451,52,399,4,-6,10
DKI JAKARTA,JAKARTA UTARA,PENJARINGAN,KAPUK MUARA,3172011003,2020-10-06,460,54,406,9,2,7
DKI JAKARTA,JAKARTA UTARA,PENJARINGAN,KAPUK MUARA,3172011003,2020-10-07,479,64,415,19,10,9
DKI JAKARTA,JAKARTA UTARA,PENJARINGAN,KAPUK MUARA,3172011003,2020-10-08,494,68,426,15,4,11
DKI JAKARTA,JAKARTA UTARA,PENJARINGAN,KAPUK MUARA,3172011003,2020-10-09,501,70,431,7,2,5
DKI JAKARTA,JAKARTA UTARA,PENJARINGAN,KAPUK MUARA,3172011003,2020-10-10,512,70,442,11,0,11
DKI JAKARTA,JAKARTA UTARA,PENJARINGAN,KAPUK MUARA,3172011003,2020-10-11,513,67,446,1,-3,4
DKI JAKARTA,JAKARTA UTARA,PENJARINGAN,KAPUK MUARA,3172011003,2020-10-12,527,67,460,14,0,14
DKI JAKARTA,JAKARTA UTARA,PENJARINGAN,KAPUK MUARA,3172011003,2020-10-13,531,67,464,4,0,4
DKI JAKARTA,JAKARTA UTARA,PENJARINGAN,KAPUK MUARA,3172011003,2020-10-14,531,56,475,0,-11,11
DKI JAKARTA,JAKARTA UTARA,PENJARINGAN,KAPUK MUARA,3172011003,2020-10-15,540,51,489,9,-5,14
DKI JAKARTA,JAKARTA UTARA,PENJARINGAN,KAPUK MUARA,3172011003,2020-10-16,562,68,494,22,17,5
DKI JAKARTA,JAKARTA UTARA,PENJARINGAN,KAPUK MUARA,3172011003,2020-10-17,572,70,502,10,2,8
DKI JAKARTA,JAKARTA UTARA,PENJARINGAN,KAPUK MUARA,3172011003,2020-10-18,578,74,504,6,4,2
DKI JAKARTA,JAKARTA UTARA,PENJARINGAN,KAPUK MUARA,3172011003,2020-10-19,582,64,518,4,-10,14
DKI JAKARTA,JAKARTA UTARA,PENJARINGAN,KAPUK MUARA,3172011003,2020-10-20,590,63,527,8,-1,9
DKI JAKARTA,JAKARTA UTARA,PENJARINGAN,KAPUK MUARA,3172011003,2020-10-21,590,59,531,0,-4,4
DKI JAKARTA,JAKARTA UTARA,PENJARINGAN,KAPUK MUARA,3172011003,2020-10-22,591,55,536,1,-4,5
DKI JAKARTA,JAKARTA UTARA,PENJARINGAN,KAPUK MUARA,3172011003,2020-10-23,591,55,536,0,0,0
DKI JAKARTA,JAKARTA UTARA,PENJARINGAN,KAPUK MUARA,3172011003,2020-10-24,595,47,548,4,-8,12
DKI JAKARTA,JAKARTA UTARA,PENJARINGAN,KAPUK MUARA,3172011003,2020-10-25,604,47,557,9,0,9
DKI JAKARTA,JAKARTA UTARA,PENJARINGAN,KAPUK MUARA,3172011003,2020-10-26,604,43,561,0,-4,4
DKI JAKARTA,JAKARTA UTARA,PENJARINGAN,KAPUK MUARA,3172011003,2020-10-27,612,42,570,8,-1,9
DKI JAKARTA,JAKARTA UTARA,PENJARINGAN,KAPUK MUARA,3172011003,2020-10-28,612,33,579,0,-9,9
DKI JAKARTA,JAKARTA UTARA,PENJARINGAN,KAPUK MUARA,3172011003,2020-10-29,620,22,598,8,-11,19
DKI JAKARTA,JAKARTA UTARA,PENJARINGAN,KAPUK MUARA,3172011003,2020-10-30,630,28,602,10,6,4
DKI JAKARTA,JAKARTA UTARA,PENJARINGAN,KAPUK MUARA,3172011003,2020-10-31,640,35,605,10,7,3
DKI JAKARTA,JAKARTA UTARA,PENJARINGAN,PEJAGALAN,3172011004,2020-10-01,776,53,723,0,0,0
DKI JAKARTA,JAKARTA UTARA,PENJARINGAN,PEJAGALAN,3172011004,2020-10-02,791,65,726,15,12,3
DKI JAKARTA,JAKARTA UTARA,PENJARINGAN,PEJAGALAN,3172011004,2020-10-03,796,69,727,5,4,1
DKI JAKARTA,JAKARTA UTARA,PENJARINGAN,PEJAGALAN,3172011004,2020-10-04,801,72,729,5,3,2
DKI JAKARTA,JAKARTA UTARA,PENJARINGAN,PEJAGALAN,3172011004,2020-10-05,815,73,742,14,1,13
DKI JAKARTA,JAKARTA UTARA,PENJARINGAN,PEJAGALAN,3172011004,2020-10-06,824,75,749,9,2,7
DKI JAKARTA,JAKARTA UTARA,PENJARINGAN,PEJAGALAN,3172011004,2020-10-07,839,85,754,15,10,5
DKI JAKARTA,JAKARTA UTARA,PENJARINGAN,PEJAGALAN,3172011004,2020-10-08,852,86,766,13,1,12
DKI JAKARTA,JAKARTA UTARA,PENJARINGAN,PEJAGALAN,3172011004,2020-10-09,855,88,767,3,2,1
DKI JAKARTA,JAKARTA UTARA,PENJARINGAN,PEJAGALAN,3172011004,2020-10-10,877,97,780,22,9,13
DKI JAKARTA,JAKARTA UTARA,PENJARINGAN,PEJAGALAN,3172011004,2020-10-11,893,111,782,16,14,2
DKI JAKARTA,JAKARTA UTARA,PENJARINGAN,PEJAGALAN,3172011004,2020-10-12,909,112,797,16,1,15
DKI JAKARTA,JAKARTA UTARA,PENJARINGAN,PEJAGALAN,3172011004,2020-10-13,915,112,803,6,0,6
DKI JAKARTA,JAKARTA UTARA,PENJARINGAN,PEJAGALAN,3172011004,2020-10-14,924,91,833,9,-21,30
DKI JAKARTA,JAKARTA UTARA,PENJARINGAN,PEJAGALAN,3172011004,2020-10-15,932,90,842,8,-1,9
DKI JAKARTA,JAKARTA UTARA,PENJARINGAN,PEJAGALAN,3172011004,2020-10-16,950,105,845,18,15,3
DKI JAKARTA,JAKARTA UTARA,PENJARINGAN,PEJAGALAN,3172011004,2020-10-17,974,127,847,24,22,2
DKI JAKARTA,JAKARTA UTARA,PENJARINGAN,PEJAGALAN,3172011004,2020-10-18,985,135,850,11,8,3
DKI JAKARTA,JAKARTA UTARA,PENJARINGAN,PEJAGALAN,3172011004,2020-10-19,990,124,866,5,-11,16
DKI JAKARTA,JAKARTA UTARA,PENJARINGAN,PEJAGALAN,3172011004,2020-10-20,1005,126,879,15,2,13
DKI JAKARTA,JAKARTA UTARA,PENJARINGAN,PEJAGALAN,3172011004,2020-10-21,1010,103,907,5,-23,28
DKI JAKARTA,JAKARTA UTARA,PENJARINGAN,PEJAGALAN,3172011004,2020-10-22,1012,94,918,2,-9,11
DKI JAKARTA,JAKARTA UTARA,PENJARINGAN,PEJAGALAN,3172011004,2020-10-23,1016,98,918,4,4,0
DKI JAKARTA,JAKARTA UTARA,PENJARINGAN,PEJAGALAN,3172011004,2020-10-24,1018,91,927,2,-7,9
DKI JAKARTA,JAKARTA UTARA,PENJARINGAN,PEJAGALAN,3172011004,2020-10-25,1030,90,940,12,-1,13
DKI JAKARTA,JAKARTA UTARA,PENJARINGAN,PEJAGALAN,3172011004,2020-10-26,1031,77,954,1,-13,14
DKI JAKARTA,JAKARTA UTARA,PENJARINGAN,PEJAGALAN,3172011004,2020-10-27,1042,83,959,11,6,5
DKI JAKARTA,JAKARTA UTARA,PENJARINGAN,PEJAGALAN,3172011004,2020-10-28,1050,77,973,8,-6,14
DKI JAKARTA,JAKARTA UTARA,PENJARINGAN,PEJAGALAN,3172011004,2020-10-29,1056,58,998,6,-19,25
DKI JAKARTA,JAKARTA UTARA,PENJARINGAN,PEJAGALAN,3172011004,2020-10-30,1072,67,1005,16,9,7
DKI JAKARTA,JAKARTA UTARA,PENJARINGAN,PEJAGALAN,3172011004,2020-10-31,1076,71,1005,4,4,0
DKI JAKARTA,JAKARTA UTARA,PENJARINGAN,PENJARINGAN,3172011001,2020-10-01,2655,116,2539,0,0,0
DKI JAKARTA,JAKARTA UTARA,PENJARINGAN,PENJARINGAN,3172011001,2020-10-02,2690,126,2564,35,10,25
DKI JAKARTA,JAKARTA UTARA,PENJARINGAN,PENJARINGAN,3172011001,2020-10-03,2706,130,2576,16,4,12
DKI JAKARTA,JAKARTA UTARA,PENJARINGAN,PENJARINGAN,3172011001,2020-10-04,2711,133,2578,5,3,2
DKI JAKARTA,JAKARTA UTARA,PENJARINGAN,PENJARINGAN,3172011001,2020-10-05,2726,112,2614,15,-21,36
DKI JAKARTA,JAKARTA UTARA,PENJARINGAN,PENJARINGAN,3172011001,2020-10-06,2740,116,2624,14,4,10
DKI JAKARTA,JAKARTA UTARA,PENJARINGAN,PENJARINGAN,3172011001,2020-10-07,2763,124,2639,23,8,15
DKI JAKARTA,JAKARTA UTARA,PENJARINGAN,PENJARINGAN,3172011001,2020-10-08,2791,135,2656,28,11,17
DKI JAKARTA,JAKARTA UTARA,PENJARINGAN,PENJARINGAN,3172011001,2020-10-09,2802,143,2659,11,8,3
DKI JAKARTA,JAKARTA UTARA,PENJARINGAN,PENJARINGAN,3172011001,2020-10-10,2821,150,2671,19,7,12
DKI JAKARTA,JAKARTA UTARA,PENJARINGAN,PENJARINGAN,3172011001,2020-10-11,2838,158,2680,17,8,9
DKI JAKARTA,JAKARTA UTARA,PENJARINGAN,PENJARINGAN,3172011001,2020-10-12,2851,119,2732,13,-39,52
DKI JAKARTA,JAKARTA UTARA,PENJARINGAN,PENJARINGAN,3172011001,2020-10-13,2860,116,2744,9,-3,12
DKI JAKARTA,JAKARTA UTARA,PENJARINGAN,PENJARINGAN,3172011001,2020-10-14,2877,122,2755,17,6,11
DKI JAKARTA,JAKARTA UTARA,PENJARINGAN,PENJARINGAN,3172011001,2020-10-15,2886,108,2778,9,-14,23
DKI JAKARTA,JAKARTA UTARA,PENJARINGAN,PENJARINGAN,3172011001,2020-10-16,2896,106,2790,10,-2,12
DKI JAKARTA,JAKARTA UTARA,PENJARINGAN,PENJARINGAN,3172011001,2020-10-17,2928,130,2798,32,24,8
DKI JAKARTA,JAKARTA UTARA,PENJARINGAN,PENJARINGAN,3172011001,2020-10-18,2939,135,2804,11,5,6
DKI JAKARTA,JAKARTA UTARA,PENJARINGAN,PENJARINGAN,3172011001,2020-10-19,2947,125,2822,8,-10,18
DKI JAKARTA,JAKARTA UTARA,PENJARINGAN,PENJARINGAN,3172011001,2020-10-20,2955,124,2831,8,-1,9
DKI JAKARTA,JAKARTA UTARA,PENJARINGAN,PENJARINGAN,3172011001,2020-10-21,2964,121,2843,9,-3,12
DKI JAKARTA,JAKARTA UTARA,PENJARINGAN,PENJARINGAN,3172011001,2020-10-22,2967,109,2858,3,-12,15
DKI JAKARTA,JAKARTA UTARA,PENJARINGAN,PENJARINGAN,3172011001,2020-10-23,2972,112,2860,5,3,2
DKI JAKARTA,JAKARTA UTARA,PENJARINGAN,PENJARINGAN,3172011001,2020-10-24,2984,112,2872,12,0,12
DKI JAKARTA,JAKARTA UTARA,PENJARINGAN,PENJARINGAN,3172011001,2020-10-25,2988,109,2879,4,-3,7
DKI JAKARTA,JAKARTA UTARA,PENJARINGAN,PENJARINGAN,3172011001,2020-10-26,2995,94,2901,7,-15,22
DKI JAKARTA,JAKARTA UTARA,PENJARINGAN,PENJARINGAN,3172011001,2020-10-27,3014,109,2905,19,15,4
DKI JAKARTA,JAKARTA UTARA,PENJARINGAN,PENJARINGAN,3172011001,2020-10-28,3027,89,2938,13,-20,33
DKI JAKARTA,JAKARTA UTARA,PENJARINGAN,PENJARINGAN,3172011001,2020-10-29,3036,81,2955,9,-8,17
DKI JAKARTA,JAKARTA UTARA,PENJARINGAN,PENJARINGAN,3172011001,2020-10-30,3053,82,2971,17,1,16
DKI JAKARTA,JAKARTA UTARA,PENJARINGAN,PENJARINGAN,3172011001,2020-10-31,3067,93,2974,14,11,3
DKI JAKARTA,JAKARTA UTARA,PENJARINGAN,PLUIT,3172011005,2020-10-01,1042,78,964,0,0,0
DKI JAKARTA,JAKARTA UTARA,PENJARINGAN,PLUIT,3172011005,2020-10-02,1075,81,994,33,3,30
DKI JAKARTA,JAKARTA UTARA,PENJARINGAN,PLUIT,3172011005,2020-10-03,1089,83,1006,14,2,12
DKI JAKARTA,JAKARTA UTARA,PENJARINGAN,PLUIT,3172011005,2020-10-04,1100,90,1010,11,7,4
DKI JAKARTA,JAKARTA UTARA,PENJARINGAN,PLUIT,3172011005,2020-10-05,1112,86,1026,12,-4,16
DKI JAKARTA,JAKARTA UTARA,PENJARINGAN,PLUIT,3172011005,2020-10-06,1122,88,1034,10,2,8
DKI JAKARTA,JAKARTA UTARA,PENJARINGAN,PLUIT,3172011005,2020-10-07,1142,96,1046,20,8,12
DKI JAKARTA,JAKARTA UTARA,PENJARINGAN,PLUIT,3172011005,2020-10-08,1160,104,1056,18,8,10
DKI JAKARTA,JAKARTA UTARA,PENJARINGAN,PLUIT,3172011005,2020-10-09,1170,108,1062,10,4,6
DKI JAKARTA,JAKARTA UTARA,PENJARINGAN,PLUIT,3172011005,2020-10-10,1197,111,1086,27,3,24
DKI JAKARTA,JAKARTA UTARA,PENJARINGAN,PLUIT,3172011005,2020-10-11,1202,113,1089,5,2,3
DKI JAKARTA,JAKARTA UTARA,PENJARINGAN,PLUIT,3172011005,2020-10-12,1217,94,1123,15,-19,34
DKI JAKARTA,JAKARTA UTARA,PENJARINGAN,PLUIT,3172011005,2020-10-13,1226,95,1131,9,1,8
DKI JAKARTA,JAKARTA UTARA,PENJARINGAN,PLUIT,3172011005,2020-10-14,1230,84,1146,4,-11,15
DKI JAKARTA,JAKARTA UTARA,PENJARINGAN,PLUIT,3172011005,2020-10-15,1243,80,1163,13,-4,17
DKI JAKARTA,JAKARTA UTARA,PENJARINGAN,PLUIT,3172011005,2020-10-16,1257,90,1167,14,10,4
DKI JAKARTA,JAKARTA UTARA,PENJARINGAN,PLUIT,3172011005,2020-10-17,1275,101,1174,18,11,7
DKI JAKARTA,JAKARTA UTARA,PENJARINGAN,PLUIT,3172011005,2020-10-18,1286,102,1184,11,1,10
DKI JAKARTA,JAKARTA UTARA,PENJARINGAN,PLUIT,3172011005,2020-10-19,1288,90,1198,2,-12,14
DKI JAKARTA,JAKARTA UTARA,PENJARINGAN,PLUIT,3172011005,2020-10-20,1304,90,1214,16,0,16
DKI JAKARTA,JAKARTA UTARA,PENJARINGAN,PLUIT,3172011005,2020-10-21,1308,86,1222,4,-4,8
DKI JAKARTA,JAKARTA UTARA,PENJARINGAN,PLUIT,3172011005,2020-10-22,1309,79,1230,1,-7,8
DKI JAKARTA,JAKARTA UTARA,PENJARINGAN,PLUIT,3172011005,2020-10-23,1311,79,1232,2,0,2
DKI JAKARTA,JAKARTA UTARA,PENJARINGAN,PLUIT,3172011005,2020-10-24,1314,74,1240,3,-5,8
DKI JAKARTA,JAKARTA UTARA,PENJARINGAN,PLUIT,3172011005,2020-10-25,1329,77,1252,15,3,12
DKI JAKARTA,JAKARTA UTARA,PENJARINGAN,PLUIT,3172011005,2020-10-26,1332,71,1261,3,-6,9
DKI JAKARTA,JAKARTA UTARA,PENJARINGAN,PLUIT,3172011005,2020-10-27,1342,76,1266,10,5,5
DKI JAKARTA,JAKARTA UTARA,PENJARINGAN,PLUIT,3172011005,2020-10-28,1343,66,1277,1,-10,11
DKI JAKARTA,JAKARTA UTARA,PENJARINGAN,PLUIT,3172011005,2020-10-29,1367,58,1309,24,-8,32
DKI JAKARTA,JAKARTA UTARA,PENJARINGAN,PLUIT,3172011005,2020-10-30,1380,61,1319,13,3,10
DKI JAKARTA,JAKARTA UTARA,PENJARINGAN,PLUIT,3172011005,2020-10-31,1396,71,1325,16,10,6
DKI JAKARTA,JAKARTA UTARA,TANJUNG PRIOK,KEBON BAWANG,3172021005,2020-10-01,1035,92,943,0,0,0
DKI JAKARTA,JAKARTA UTARA,TANJUNG PRIOK,KEBON BAWANG,3172021005,2020-10-02,1044,80,964,9,-12,21
DKI JAKARTA,JAKARTA UTARA,TANJUNG PRIOK,KEBON BAWANG,3172021005,2020-10-03,1045,81,964,1,1,0
DKI JAKARTA,JAKARTA UTARA,TANJUNG PRIOK,KEBON BAWANG,3172021005,2020-10-04,1047,81,966,2,0,2
DKI JAKARTA,JAKARTA UTARA,TANJUNG PRIOK,KEBON BAWANG,3172021005,2020-10-05,1051,72,979,4,-9,13
DKI JAKARTA,JAKARTA UTARA,TANJUNG PRIOK,KEBON BAWANG,3172021005,2020-10-06,1056,73,983,5,1,4
DKI JAKARTA,JAKARTA UTARA,TANJUNG PRIOK,KEBON BAWANG,3172021005,2020-10-07,1066,58,1008,10,-15,25
DKI JAKARTA,JAKARTA UTARA,TANJUNG PRIOK,KEBON BAWANG,3172021005,2020-10-08,1082,59,1023,16,1,15
DKI JAKARTA,JAKARTA UTARA,TANJUNG PRIOK,KEBON BAWANG,3172021005,2020-10-09,1087,63,1024,5,4,1
DKI JAKARTA,JAKARTA UTARA,TANJUNG PRIOK,KEBON BAWANG,3172021005,2020-10-10,1099,69,1030,12,6,6
DKI JAKARTA,JAKARTA UTARA,TANJUNG PRIOK,KEBON BAWANG,3172021005,2020-10-11,1106,75,1031,7,6,1
DKI JAKARTA,JAKARTA UTARA,TANJUNG PRIOK,KEBON BAWANG,3172021005,2020-10-12,1110,68,1042,4,-7,11
DKI JAKARTA,JAKARTA UTARA,TANJUNG PRIOK,KEBON BAWANG,3172021005,2020-10-13,1113,60,1053,3,-8,11
DKI JAKARTA,JAKARTA UTARA,TANJUNG PRIOK,KEBON BAWANG,3172021005,2020-10-14,1130,74,1056,17,14,3
DKI JAKARTA,JAKARTA UTARA,TANJUNG PRIOK,KEBON BAWANG,3172021005,2020-10-15,1161,102,1059,31,28,3
DKI JAKARTA,JAKARTA UTARA,TANJUNG PRIOK,KEBON BAWANG,3172021005,2020-10-16,1169,103,1066,8,1,7
DKI JAKARTA,JAKARTA UTARA,TANJUNG PRIOK,KEBON BAWANG,3172021005,2020-10-17,1188,113,1075,19,10,9
DKI JAKARTA,JAKARTA UTARA,TANJUNG PRIOK,KEBON BAWANG,3172021005,2020-10-18,1202,127,1075,14,14,0
DKI JAKARTA,JAKARTA UTARA,TANJUNG PRIOK,KEBON BAWANG,3172021005,2020-10-19,1203,119,1084,1,-8,9
DKI JAKARTA,JAKARTA UTARA,TANJUNG PRIOK,KEBON BAWANG,3172021005,2020-10-20,1222,127,1095,19,8,11
DKI JAKARTA,JAKARTA UTARA,TANJUNG PRIOK,KEBON BAWANG,3172021005,2020-10-21,1229,129,1100,7,2,5
DKI JAKARTA,JAKARTA UTARA,TANJUNG PRIOK,KEBON BAWANG,3172021005,2020-10-22,1239,128,1111,10,-1,11
DKI JAKARTA,JAKARTA UTARA,TANJUNG PRIOK,KEBON BAWANG,3172021005,2020-10-23,1252,138,1114,13,10,3
DKI JAKARTA,JAKARTA UTARA,TANJUNG PRIOK,KEBON BAWANG,3172021005,2020-10-24,1259,126,1133,7,-12,19
DKI JAKARTA,JAKARTA UTARA,TANJUNG PRIOK,KEBON BAWANG,3172021005,2020-10-25,1262,109,1153,3,-17,20
DKI JAKARTA,JAKARTA UTARA,TANJUNG PRIOK,KEBON BAWANG,3172021005,2020-10-26,1266,99,1167,4,-10,14
DKI JAKARTA,JAKARTA UTARA,TANJUNG PRIOK,KEBON BAWANG,3172021005,2020-10-27,1271,90,1181,5,-9,14
DKI JAKARTA,JAKARTA UTARA,TANJUNG PRIOK,KEBON BAWANG,3172021005,2020-10-28,1275,80,1195,4,-10,14
DKI JAKARTA,JAKARTA UTARA,TANJUNG PRIOK,KEBON BAWANG,3172021005,2020-10-29,1286,77,1209,11,-3,14
DKI JAKARTA,JAKARTA UTARA,TANJUNG PRIOK,KEBON BAWANG,3172021005,2020-10-30,1303,82,1221,17,5,12
DKI JAKARTA,JAKARTA UTARA,TANJUNG PRIOK,KEBON BAWANG,3172021005,2020-10-31,1313,88,1225,10,6,4
DKI JAKARTA,JAKARTA UTARA,TANJUNG PRIOK,PAPANGGO,3172021003,2020-10-01,712,42,670,0,0,0
DKI JAKARTA,JAKARTA UTARA,TANJUNG PRIOK,PAPANGGO,3172021003,2020-10-02,721,42,679,9,0,9
DKI JAKARTA,JAKARTA UTARA,TANJUNG PRIOK,PAPANGGO,3172021003,2020-10-03,724,45,679,3,3,0
DKI JAKARTA,JAKARTA UTARA,TANJUNG PRIOK,PAPANGGO,3172021003,2020-10-04,728,47,681,4,2,2
DKI JAKARTA,JAKARTA UTARA,TANJUNG PRIOK,PAPANGGO,3172021003,2020-10-05,731,41,690,3,-6,9
DKI JAKARTA,JAKARTA UTARA,TANJUNG PRIOK,PAPANGGO,3172021003,2020-10-06,744,52,692,13,11,2
DKI JAKARTA,JAKARTA UTARA,TANJUNG PRIOK,PAPANGGO,3172021003,2020-10-07,759,66,693,15,14,1
DKI JAKARTA,JAKARTA UTARA,TANJUNG PRIOK,PAPANGGO,3172021003,2020-10-08,783,85,698,24,19,5
DKI JAKARTA,JAKARTA UTARA,TANJUNG PRIOK,PAPANGGO,3172021003,2020-10-09,786,88,698,3,3,0
DKI JAKARTA,JAKARTA UTARA,TANJUNG PRIOK,PAPANGGO,3172021003,2020-10-10,791,85,706,5,-3,8
DKI JAKARTA,JAKARTA UTARA,TANJUNG PRIOK,PAPANGGO,3172021003,2020-10-11,793,85,708,2,0,2
DKI JAKARTA,JAKARTA UTARA,TANJUNG PRIOK,PAPANGGO,3172021003,2020-10-12,798,78,720,5,-7,12
DKI JAKARTA,JAKARTA UTARA,TANJUNG PRIOK,PAPANGGO,3172021003,2020-10-13,799,72,727,1,-6,7
DKI JAKARTA,JAKARTA UTARA,TANJUNG PRIOK,PAPANGGO,3172021003,2020-10-14,801,71,730,2,-1,3
DKI JAKARTA,JAKARTA UTARA,TANJUNG PRIOK,PAPANGGO,3172021003,2020-10-15,807,75,732,6,4,2
DKI JAKARTA,JAKARTA UTARA,TANJUNG PRIOK,PAPANGGO,3172021003,2020-10-16,831,72,759,24,-3,27
DKI JAKARTA,JAKARTA UTARA,TANJUNG PRIOK,PAPANGGO,3172021003,2020-10-17,846,81,765,15,9,6
DKI JAKARTA,JAKARTA UTARA,TANJUNG PRIOK,PAPANGGO,3172021003,2020-10-18,850,84,766,4,3,1
DKI JAKARTA,JAKARTA UTARA,TANJUNG PRIOK,PAPANGGO,3172021003,2020-10-19,850,68,782,0,-16,16
DKI JAKARTA,JAKARTA UTARA,TANJUNG PRIOK,PAPANGGO,3172021003,2020-10-20,852,56,796,2,-12,14
DKI JAKARTA,JAKARTA UTARA,TANJUNG PRIOK,PAPANGGO,3172021003,2020-10-21,854,55,799,2,-1,3
DKI JAKARTA,JAKARTA UTARA,TANJUNG PRIOK,PAPANGGO,3172021003,2020-10-22,859,55,804,5,0,5
DKI JAKARTA,JAKARTA UTARA,TANJUNG PRIOK,PAPANGGO,3172021003,2020-10-23,865,60,805,6,5,1
DKI JAKARTA,JAKARTA UTARA,TANJUNG PRIOK,PAPANGGO,3172021003,2020-10-24,870,61,809,5,1,4
DKI JAKARTA,JAKARTA UTARA,TANJUNG PRIOK,PAPANGGO,3172021003,2020-10-25,872,62,810,2,1,1
DKI JAKARTA,JAKARTA UTARA,TANJUNG PRIOK,PAPANGGO,3172021003,2020-10-26,875,59,816,3,-3,6
DKI JAKARTA,JAKARTA UTARA,TANJUNG PRIOK,PAPANGGO,3172021003,2020-10-27,876,58,818,1,-1,2
DKI JAKARTA,JAKARTA UTARA,TANJUNG PRIOK,PAPANGGO,3172021003,2020-10-28,878,56,822,2,-2,4
DKI JAKARTA,JAKARTA UTARA,TANJUNG PRIOK,PAPANGGO,3172021003,2020-10-29,885,53,832,7,-3,10
DKI JAKARTA,JAKARTA UTARA,TANJUNG PRIOK,PAPANGGO,3172021003,2020-10-30,896,61,835,11,8,3
DKI JAKARTA,JAKARTA UTARA,TANJUNG PRIOK,PAPANGGO,3172021003,2020-10-31,900,64,836,4,3,1
DKI JAKARTA,JAKARTA UTARA,TANJUNG PRIOK,SUNGAI BAMBU,3172021004,2020-10-01,542,55,487,0,0,0
DKI JAKARTA,JAKARTA UTARA,TANJUNG PRIOK,SUNGAI BAMBU,3172021004,2020-10-02,547,56,491,5,1,4
DKI JAKARTA,JAKARTA UTARA,TANJUNG PRIOK,SUNGAI BAMBU,3172021004,2020-10-03,547,52,495,0,-4,4
DKI JAKARTA,JAKARTA UTARA,TANJUNG PRIOK,SUNGAI BAMBU,3172021004,2020-10-04,552,52,500,5,0,5
DKI JAKARTA,JAKARTA UTARA,TANJUNG PRIOK,SUNGAI BAMBU,3172021004,2020-10-05,556,49,507,4,-3,7
DKI JAKARTA,JAKARTA UTARA,TANJUNG PRIOK,SUNGAI BAMBU,3172021004,2020-10-06,561,51,510,5,2,3
DKI JAKARTA,JAKARTA UTARA,TANJUNG PRIOK,SUNGAI BAMBU,3172021004,2020-10-07,567,50,517,6,-1,7
DKI JAKARTA,JAKARTA UTARA,TANJUNG PRIOK,SUNGAI BAMBU,3172021004,2020-10-08,578,58,520,11,8,3
DKI JAKARTA,JAKARTA UTARA,TANJUNG PRIOK,SUNGAI BAMBU,3172021004,2020-10-09,580,60,520,2,2,0
DKI JAKARTA,JAKARTA UTARA,TANJUNG PRIOK,SUNGAI BAMBU,3172021004,2020-10-10,583,59,524,3,-1,4
DKI JAKARTA,JAKARTA UTARA,TANJUNG PRIOK,SUNGAI BAMBU,3172021004,2020-10-11,591,66,525,8,7,1
DKI JAKARTA,JAKARTA UTARA,TANJUNG PRIOK,SUNGAI BAMBU,3172021004,2020-10-12,595,51,544,4,-15,19
DKI JAKARTA,JAKARTA UTARA,TANJUNG PRIOK,SUNGAI BAMBU,3172021004,2020-10-13,597,48,549,2,-3,5
DKI JAKARTA,JAKARTA UTARA,TANJUNG PRIOK,SUNGAI BAMBU,3172021004,2020-10-14,605,54,551,8,6,2
DKI JAKARTA,JAKARTA UTARA,TANJUNG PRIOK,SUNGAI BAMBU,3172021004,2020-10-15,634,73,561,29,19,10
DKI JAKARTA,JAKARTA UTARA,TANJUNG PRIOK,SUNGAI BAMBU,3172021004,2020-10-16,644,80,564,10,7,3
DKI JAKARTA,JAKARTA UTARA,TANJUNG PRIOK,SUNGAI BAMBU,3172021004,2020-10-17,648,81,567,4,1,3
DKI JAKARTA,JAKARTA UTARA,TANJUNG PRIOK,SUNGAI BAMBU,3172021004,2020-10-18,651,84,567,3,3,0
DKI JAKARTA,JAKARTA UTARA,TANJUNG PRIOK,SUNGAI BAMBU,3172021004,2020-10-19,653,80,573,2,-4,6
DKI JAKARTA,JAKARTA UTARA,TANJUNG PRIOK,SUNGAI BAMBU,3172021004,2020-10-20,662,81,581,9,1,8
DKI JAKARTA,JAKARTA UTARA,TANJUNG PRIOK,SUNGAI BAMBU,3172021004,2020-10-21,663,72,591,1,-9,10
DKI JAKARTA,JAKARTA UTARA,TANJUNG PRIOK,SUNGAI BAMBU,3172021004,2020-10-22,671,78,593,8,6,2
DKI JAKARTA,JAKARTA UTARA,TANJUNG PRIOK,SUNGAI BAMBU,3172021004,2020-10-23,672,79,593,1,1,0
DKI JAKARTA,JAKARTA UTARA,TANJUNG PRIOK,SUNGAI BAMBU,3172021004,2020-10-24,678,83,595,6,4,2
DKI JAKARTA,JAKARTA UTARA,TANJUNG PRIOK,SUNGAI BAMBU,3172021004,2020-10-25,683,83,600,5,0,5
DKI JAKARTA,JAKARTA UTARA,TANJUNG PRIOK,SUNGAI BAMBU,3172021004,2020-10-26,688,66,622,5,-17,22
DKI JAKARTA,JAKARTA UTARA,TANJUNG PRIOK,SUNGAI BAMBU,3172021004,2020-10-27,691,58,633,3,-8,11
DKI JAKARTA,JAKARTA UTARA,TANJUNG PRIOK,SUNGAI BAMBU,3172021004,2020-10-28,692,44,648,1,-14,15
DKI JAKARTA,JAKARTA UTARA,TANJUNG PRIOK,SUNGAI BAMBU,3172021004,2020-10-29,695,41,654,3,-3,6
DKI JAKARTA,JAKARTA UTARA,TANJUNG PRIOK,SUNGAI BAMBU,3172021004,2020-10-30,702,39,663,7,-2,9
DKI JAKARTA,JAKARTA UTARA,TANJUNG PRIOK,SUNGAI BAMBU,3172021004,2020-10-31,707,42,665,5,3,2
DKI JAKARTA,JAKARTA UTARA,TANJUNG PRIOK,SUNTER AGUNG,3172021006,2020-10-01,1687,103,1584,0,0,0
DKI JAKARTA,JAKARTA UTARA,TANJUNG PRIOK,SUNTER AGUNG,3172021006,2020-10-02,1703,104,1599,16,1,15
DKI JAKARTA,JAKARTA UTARA,TANJUNG PRIOK,SUNTER AGUNG,3172021006,2020-10-03,1707,97,1610,4,-7,11
DKI JAKARTA,JAKARTA UTARA,TANJUNG PRIOK,SUNTER AGUNG,3172021006,2020-10-04,1711,98,1613,4,1,3
DKI JAKARTA,JAKARTA UTARA,TANJUNG PRIOK,SUNTER AGUNG,3172021006,2020-10-05,1716,86,1630,5,-12,17
DKI JAKARTA,JAKARTA UTARA,TANJUNG PRIOK,SUNTER AGUNG,3172021006,2020-10-06,1736,100,1636,20,14,6
DKI JAKARTA,JAKARTA UTARA,TANJUNG PRIOK,SUNTER AGUNG,3172021006,2020-10-07,1753,105,1648,17,5,12
DKI JAKARTA,JAKARTA UTARA,TANJUNG PRIOK,SUNTER AGUNG,3172021006,2020-10-08,1793,135,1658,40,30,10
DKI JAKARTA,JAKARTA UTARA,TANJUNG PRIOK,SUNTER AGUNG,3172021006,2020-10-09,1801,143,1658,8,8,0
DKI JAKARTA,JAKARTA UTARA,TANJUNG PRIOK,SUNTER AGUNG,3172021006,2020-10-10,1810,139,1671,9,-4,13
DKI JAKARTA,JAKARTA UTARA,TANJUNG PRIOK,SUNTER AGUNG,3172021006,2020-10-11,1831,144,1687,21,5,16
DKI JAKARTA,JAKARTA UTARA,TANJUNG PRIOK,SUNTER AGUNG,3172021006,2020-10-12,1841,139,1702,10,-5,15
DKI JAKARTA,JAKARTA UTARA,TANJUNG PRIOK,SUNTER AGUNG,3172021006,2020-10-13,1849,121,1728,8,-18,26
DKI JAKARTA,JAKARTA UTARA,TANJUNG PRIOK,SUNTER AGUNG,3172021006,2020-10-14,1867,132,1735,18,11,7
DKI JAKARTA,JAKARTA UTARA,TANJUNG PRIOK,SUNTER AGUNG,3172021006,2020-10-15,1890,138,1752,23,6,17
DKI JAKARTA,JAKARTA UTARA,TANJUNG PRIOK,SUNTER AGUNG,3172021006,2020-10-16,1916,144,1772,26,6,20
DKI JAKARTA,JAKARTA UTARA,TANJUNG PRIOK,SUNTER AGUNG,3172021006,2020-10-17,1937,162,1775,21,18,3
DKI JAKARTA,JAKARTA UTARA,TANJUNG PRIOK,SUNTER AGUNG,3172021006,2020-10-18,1941,164,1777,4,2,2
DKI JAKARTA,JAKARTA UTARA,TANJUNG PRIOK,SUNTER AGUNG,3172021006,2020-10-19,1948,153,1795,7,-11,18
DKI JAKARTA,JAKARTA UTARA,TANJUNG PRIOK,SUNTER AGUNG,3172021006,2020-10-20,1971,160,1811,23,7,16
DKI JAKARTA,JAKARTA UTARA,TANJUNG PRIOK,SUNTER AGUNG,3172021006,2020-10-21,1981,159,1822,10,-1,11
DKI JAKARTA,JAKARTA UTARA,TANJUNG PRIOK,SUNTER AGUNG,3172021006,2020-10-22,1996,155,1841,15,-4,19
DKI JAKARTA,JAKARTA UTARA,TANJUNG PRIOK,SUNTER AGUNG,3172021006,2020-10-23,2007,165,1842,11,10,1
DKI JAKARTA,JAKARTA UTARA,TANJUNG PRIOK,SUNTER AGUNG,3172021006,2020-10-24,2022,158,1864,15,-7,22
DKI JAKARTA,JAKARTA UTARA,TANJUNG PRIOK,SUNTER AGUNG,3172021006,2020-10-25,2032,160,1872,10,2,8
DKI JAKARTA,JAKARTA UTARA,TANJUNG PRIOK,SUNTER AGUNG,3172021006,2020-10-26,2040,148,1892,8,-12,20
DKI JAKARTA,JAKARTA UTARA,TANJUNG PRIOK,SUNTER AGUNG,3172021006,2020-10-27,2047,134,1913,7,-14,21
DKI JAKARTA,JAKARTA UTARA,TANJUNG PRIOK,SUNTER AGUNG,3172021006,2020-10-28,2060,131,1929,13,-3,16
DKI JAKARTA,JAKARTA UTARA,TANJUNG PRIOK,SUNTER AGUNG,3172021006,2020-10-29,2067,115,1953,7,-16,24
DKI JAKARTA,JAKARTA UTARA,TANJUNG PRIOK,SUNTER AGUNG,3172021006,2020-10-30,2093,121,1973,26,6,20
DKI JAKARTA,JAKARTA UTARA,TANJUNG PRIOK,SUNTER AGUNG,3172021006,2020-10-31,2112,124,1989,19,3,16
DKI JAKARTA,JAKARTA UTARA,TANJUNG PRIOK,SUNTER JAYA,3172021002,2020-10-01,1352,119,1233,0,0,0
DKI JAKARTA,JAKARTA UTARA,TANJUNG PRIOK,SUNTER JAYA,3172021002,2020-10-02,1368,123,1245,16,4,12
DKI JAKARTA,JAKARTA UTARA,TANJUNG PRIOK,SUNTER JAYA,3172021002,2020-10-03,1380,128,1252,12,5,7
DKI JAKARTA,JAKARTA UTARA,TANJUNG PRIOK,SUNTER JAYA,3172021002,2020-10-04,1393,137,1256,13,9,4
DKI JAKARTA,JAKARTA UTARA,TANJUNG PRIOK,SUNTER JAYA,3172021002,2020-10-05,1394,111,1283,1,-26,27
DKI JAKARTA,JAKARTA UTARA,TANJUNG PRIOK,SUNTER JAYA,3172021002,2020-10-06,1419,127,1292,25,16,9
DKI JAKARTA,JAKARTA UTARA,TANJUNG PRIOK,SUNTER JAYA,3172021002,2020-10-07,1438,133,1305,19,6,13
DKI JAKARTA,JAKARTA UTARA,TANJUNG PRIOK,SUNTER JAYA,3172021002,2020-10-08,1470,159,1311,32,26,6
DKI JAKARTA,JAKARTA UTARA,TANJUNG PRIOK,SUNTER JAYA,3172021002,2020-10-09,1477,166,1311,7,7,0
DKI JAKARTA,JAKARTA UTARA,TANJUNG PRIOK,SUNTER JAYA,3172021002,2020-10-10,1491,163,1328,14,-3,17
DKI JAKARTA,JAKARTA UTARA,TANJUNG PRIOK,SUNTER JAYA,3172021002,2020-10-11,1515,181,1334,24,18,6
DKI JAKARTA,JAKARTA UTARA,TANJUNG PRIOK,SUNTER JAYA,3172021002,2020-10-12,1528,158,1370,13,-23,36
DKI JAKARTA,JAKARTA UTARA,TANJUNG PRIOK,SUNTER JAYA,3172021002,2020-10-13,1532,137,1395,4,-21,25
DKI JAKARTA,JAKARTA UTARA,TANJUNG PRIOK,SUNTER JAYA,3172021002,2020-10-14,1553,144,1409,21,7,14
DKI JAKARTA,JAKARTA UTARA,TANJUNG PRIOK,SUNTER JAYA,3172021002,2020-10-15,1608,180,1428,55,36,19
DKI JAKARTA,JAKARTA UTARA,TANJUNG PRIOK,SUNTER JAYA,3172021002,2020-10-16,1629,182,1447,21,2,19
DKI JAKARTA,JAKARTA UTARA,TANJUNG PRIOK,SUNTER JAYA,3172021002,2020-10-17,1656,203,1453,27,21,6
DKI JAKARTA,JAKARTA UTARA,TANJUNG PRIOK,SUNTER JAYA,3172021002,2020-10-18,1662,205,1457,6,2,4
DKI JAKARTA,JAKARTA UTARA,TANJUNG PRIOK,SUNTER JAYA,3172021002,2020-10-19,1663,192,1471,1,-13,14
DKI JAKARTA,JAKARTA UTARA,TANJUNG PRIOK,SUNTER JAYA,3172021002,2020-10-20,1673,188,1485,10,-4,14
DKI JAKARTA,JAKARTA UTARA,TANJUNG PRIOK,SUNTER JAYA,3172021002,2020-10-21,1689,184,1505,16,-4,20
DKI JAKARTA,JAKARTA UTARA,TANJUNG PRIOK,SUNTER JAYA,3172021002,2020-10-22,1727,206,1521,38,22,16
DKI JAKARTA,JAKARTA UTARA,TANJUNG PRIOK,SUNTER JAYA,3172021002,2020-10-23,1749,227,1522,22,21,1
DKI JAKARTA,JAKARTA UTARA,TANJUNG PRIOK,SUNTER JAYA,3172021002,2020-10-24,1760,217,1543,11,-10,21
DKI JAKARTA,JAKARTA UTARA,TANJUNG PRIOK,SUNTER JAYA,3172021002,2020-10-25,1761,218,1543,1,1,0
DKI JAKARTA,JAKARTA UTARA,TANJUNG PRIOK,SUNTER JAYA,3172021002,2020-10-26,1765,189,1576,4,-29,33
DKI JAKARTA,JAKARTA UTARA,TANJUNG PRIOK,SUNTER JAYA,3172021002,2020-10-27,1773,174,1599,8,-15,23
DKI JAKARTA,JAKARTA UTARA,TANJUNG PRIOK,SUNTER JAYA,3172021002,2020-10-28,1779,161,1618,6,-13,19
DKI JAKARTA,JAKARTA UTARA,TANJUNG PRIOK,SUNTER JAYA,3172021002,2020-10-29,1788,140,1648,9,-21,30
DKI JAKARTA,JAKARTA UTARA,TANJUNG PRIOK,SUNTER JAYA,3172021002,2020-10-30,1804,149,1655,16,9,7
DKI JAKARTA,JAKARTA UTARA,TANJUNG PRIOK,SUNTER JAYA,3172021002,2020-10-31,1814,157,1657,10,8,2
DKI JAKARTA,JAKARTA UTARA,TANJUNG PRIOK,TANJUNG PRIOK,3172021001,2020-10-01,648,54,594,0,0,0
DKI JAKARTA,JAKARTA UTARA,TANJUNG PRIOK,TANJUNG PRIOK,3172021001,2020-10-02,650,50,600,2,-4,6
DKI JAKARTA,JAKARTA UTARA,TANJUNG PRIOK,TANJUNG PRIOK,3172021001,2020-10-03,653,53,600,3,3,0
DKI JAKARTA,JAKARTA UTARA,TANJUNG PRIOK,TANJUNG PRIOK,3172021001,2020-10-04,655,54,601,2,1,1
DKI JAKARTA,JAKARTA UTARA,TANJUNG PRIOK,TANJUNG PRIOK,3172021001,2020-10-05,657,40,617,2,-14,16
DKI JAKARTA,JAKARTA UTARA,TANJUNG PRIOK,TANJUNG PRIOK,3172021001,2020-10-06,663,40,623,6,0,6
DKI JAKARTA,JAKARTA UTARA,TANJUNG PRIOK,TANJUNG PRIOK,3172021001,2020-10-07,681,55,626,18,15,3
DKI JAKARTA,JAKARTA UTARA,TANJUNG PRIOK,TANJUNG PRIOK,3172021001,2020-10-08,698,67,631,17,12,5
DKI JAKARTA,JAKARTA UTARA,TANJUNG PRIOK,TANJUNG PRIOK,3172021001,2020-10-09,701,69,632,3,2,1
DKI JAKARTA,JAKARTA UTARA,TANJUNG PRIOK,TANJUNG PRIOK,3172021001,2020-10-10,706,70,636,5,1,4
DKI JAKARTA,JAKARTA UTARA,TANJUNG PRIOK,TANJUNG PRIOK,3172021001,2020-10-11,716,77,639,10,7,3
DKI JAKARTA,JAKARTA UTARA,TANJUNG PRIOK,TANJUNG PRIOK,3172021001,2020-10-12,719,65,654,3,-12,15
DKI JAKARTA,JAKARTA UTARA,TANJUNG PRIOK,TANJUNG PRIOK,3172021001,2020-10-13,721,66,655,2,1,1
DKI JAKARTA,JAKARTA UTARA,TANJUNG PRIOK,TANJUNG PRIOK,3172021001,2020-10-14,726,64,662,5,-2,7
DKI JAKARTA,JAKARTA UTARA,TANJUNG PRIOK,TANJUNG PRIOK,3172021001,2020-10-15,738,69,669,12,5,7
DKI JAKARTA,JAKARTA UTARA,TANJUNG PRIOK,TANJUNG PRIOK,3172021001,2020-10-16,743,65,678,5,-4,9
DKI JAKARTA,JAKARTA UTARA,TANJUNG PRIOK,TANJUNG PRIOK,3172021001,2020-10-17,758,74,684,15,9,6
DKI JAKARTA,JAKARTA UTARA,TANJUNG PRIOK,TANJUNG PRIOK,3172021001,2020-10-18,765,76,689,7,2,5
DKI JAKARTA,JAKARTA UTARA,TANJUNG PRIOK,TANJUNG PRIOK,3172021001,2020-10-19,765,64,701,0,-12,12
DKI JAKARTA,JAKARTA UTARA,TANJUNG PRIOK,TANJUNG PRIOK,3172021001,2020-10-20,771,60,711,6,-4,10
DKI JAKARTA,JAKARTA UTARA,TANJUNG PRIOK,TANJUNG PRIOK,3172021001,2020-10-21,779,67,712,8,7,1
DKI JAKARTA,JAKARTA UTARA,TANJUNG PRIOK,TANJUNG PRIOK,3172021001,2020-10-22,781,55,726,2,-12,14
DKI JAKARTA,JAKARTA UTARA,TANJUNG PRIOK,TANJUNG PRIOK,3172021001,2020-10-23,783,56,727,2,1,1
DKI JAKARTA,JAKARTA UTARA,TANJUNG PRIOK,TANJUNG PRIOK,3172021001,2020-10-24,786,54,732,3,-2,5
DKI JAKARTA,JAKARTA UTARA,TANJUNG PRIOK,TANJUNG PRIOK,3172021001,2020-10-25,789,57,732,3,3,0
DKI JAKARTA,JAKARTA UTARA,TANJUNG PRIOK,TANJUNG PRIOK,3172021001,2020-10-26,796,49,747,7,-8,15
DKI JAKARTA,JAKARTA UTARA,TANJUNG PRIOK,TANJUNG PRIOK,3172021001,2020-10-27,800,46,754,4,-3,7
DKI JAKARTA,JAKARTA UTARA,TANJUNG PRIOK,TANJUNG PRIOK,3172021001,2020-10-28,801,44,757,1,-2,3
DKI JAKARTA,JAKARTA UTARA,TANJUNG PRIOK,TANJUNG PRIOK,3172021001,2020-10-29,806,32,774,5,-12,17
DKI JAKARTA,JAKARTA UTARA,TANJUNG PRIOK,TANJUNG PRIOK,3172021001,2020-10-30,821,43,778,15,11,4
DKI JAKARTA,JAKARTA UTARA,TANJUNG PRIOK,TANJUNG PRIOK,3172021001,2020-10-31,825,39,786,4,-4,8
DKI JAKARTA,JAKARTA UTARA,TANJUNG PRIOK,WARAKAS,3172021007,2020-10-01,764,76,688,0,0,0
DKI JAKARTA,JAKARTA UTARA,TANJUNG PRIOK,WARAKAS,3172021007,2020-10-02,767,65,702,3,-11,14
DKI JAKARTA,JAKARTA UTARA,TANJUNG PRIOK,WARAKAS,3172021007,2020-10-03,773,68,705,6,3,3
DKI JAKARTA,JAKARTA UTARA,TANJUNG PRIOK,WARAKAS,3172021007,2020-10-04,773,65,708,0,-3,3
DKI JAKARTA,JAKARTA UTARA,TANJUNG PRIOK,WARAKAS,3172021007,2020-10-05,781,49,732,8,-16,24
DKI JAKARTA,JAKARTA UTARA,TANJUNG PRIOK,WARAKAS,3172021007,2020-10-06,795,53,742,14,4,10
DKI JAKARTA,JAKARTA UTARA,TANJUNG PRIOK,WARAKAS,3172021007,2020-10-07,805,49,756,10,-4,14
DKI JAKARTA,JAKARTA UTARA,TANJUNG PRIOK,WARAKAS,3172021007,2020-10-08,814,55,759,9,6,3
DKI JAKARTA,JAKARTA UTARA,TANJUNG PRIOK,WARAKAS,3172021007,2020-10-09,814,55,759,0,0,0
DKI JAKARTA,JAKARTA UTARA,TANJUNG PRIOK,WARAKAS,3172021007,2020-10-10,820,56,764,6,1,5
DKI JAKARTA,JAKARTA UTARA,TANJUNG PRIOK,WARAKAS,3172021007,2020-10-11,827,60,767,7,4,3
DKI JAKARTA,JAKARTA UTARA,TANJUNG PRIOK,WARAKAS,3172021007,2020-10-12,835,61,774,8,1,7
DKI JAKARTA,JAKARTA UTARA,TANJUNG PRIOK,WARAKAS,3172021007,2020-10-13,838,59,779,3,-2,5
DKI JAKARTA,JAKARTA UTARA,TANJUNG PRIOK,WARAKAS,3172021007,2020-10-14,840,51,789,2,-8,10
DKI JAKARTA,JAKARTA UTARA,TANJUNG PRIOK,WARAKAS,3172021007,2020-10-15,860,63,797,20,12,8
DKI JAKARTA,JAKARTA UTARA,TANJUNG PRIOK,WARAKAS,3172021007,2020-10-16,929,76,853,69,13,56
DKI JAKARTA,JAKARTA UTARA,TANJUNG PRIOK,WARAKAS,3172021007,2020-10-17,948,91,857,19,15,4
DKI JAKARTA,JAKARTA UTARA,TANJUNG PRIOK,WARAKAS,3172021007,2020-10-18,952,94,858,4,3,1
DKI JAKARTA,JAKARTA UTARA,TANJUNG PRIOK,WARAKAS,3172021007,2020-10-19,953,86,867,1,-8,9
DKI JAKARTA,JAKARTA UTARA,TANJUNG PRIOK,WARAKAS,3172021007,2020-10-20,963,88,875,10,2,8
DKI JAKARTA,JAKARTA UTARA,TANJUNG PRIOK,WARAKAS,3172021007,2020-10-21,967,87,880,4,-1,5
DKI JAKARTA,JAKARTA UTARA,TANJUNG PRIOK,WARAKAS,3172021007,2020-10-22,972,82,890,5,-5,10
DKI JAKARTA,JAKARTA UTARA,TANJUNG PRIOK,WARAKAS,3172021007,2020-10-23,985,94,891,13,12,1
DKI JAKARTA,JAKARTA UTARA,TANJUNG PRIOK,WARAKAS,3172021007,2020-10-24,988,87,901,3,-7,10
DKI JAKARTA,JAKARTA UTARA,TANJUNG PRIOK,WARAKAS,3172021007,2020-10-25,992,89,903,4,2,2
DKI JAKARTA,JAKARTA UTARA,TANJUNG PRIOK,WARAKAS,3172021007,2020-10-26,994,80,914,2,-9,11
DKI JAKARTA,JAKARTA UTARA,TANJUNG PRIOK,WARAKAS,3172021007,2020-10-27,994,75,919,0,-5,5
DKI JAKARTA,JAKARTA UTARA,TANJUNG PRIOK,WARAKAS,3172021007,2020-10-28,996,74,922,2,-1,3
DKI JAKARTA,JAKARTA UTARA,TANJUNG PRIOK,WARAKAS,3172021007,2020-10-29,1002,60,942,6,-14,20
DKI JAKARTA,JAKARTA UTARA,TANJUNG PRIOK,WARAKAS,3172021007,2020-10-30,1016,62,954,14,2,12
DKI JAKARTA,JAKARTA UTARA,TANJUNG PRIOK,WARAKAS,3172021007,2020-10-31,1018,63,955,2,1,1
DKI JAKARTA,KAB.ADM.KEP.SERIBU,KEP. SERIBU SELATAN,PULAU PARI,3101021003,2020-10-01,171,3,168,0,0,0
DKI JAKARTA,KAB.ADM.KEP.SERIBU,KEP. SERIBU SELATAN,PULAU PARI,3101021003,2020-10-02,171,3,168,0,0,0
DKI JAKARTA,KAB.ADM.KEP.SERIBU,KEP. SERIBU SELATAN,PULAU PARI,3101021003,2020-10-03,171,3,168,0,0,0
DKI JAKARTA,KAB.ADM.KEP.SERIBU,KEP. SERIBU SELATAN,PULAU PARI,3101021003,2020-10-04,171,3,168,0,0,0
DKI JAKARTA,KAB.ADM.KEP.SERIBU,KEP. SERIBU SELATAN,PULAU PARI,3101021003,2020-10-05,171,3,168,0,0,0
DKI JAKARTA,KAB.ADM.KEP.SERIBU,KEP. SERIBU SELATAN,PULAU PARI,3101021003,2020-10-06,171,3,168,0,0,0
DKI JAKARTA,KAB.ADM.KEP.SERIBU,KEP. SERIBU SELATAN,PULAU PARI,3101021003,2020-10-07,171,3,168,0,0,0
DKI JAKARTA,KAB.ADM.KEP.SERIBU,KEP. SERIBU SELATAN,PULAU PARI,3101021003,2020-10-08,172,2,170,1,-1,2
DKI JAKARTA,KAB.ADM.KEP.SERIBU,KEP. SERIBU SELATAN,PULAU PARI,3101021003,2020-10-09,173,2,171,1,0,1
DKI JAKARTA,KAB.ADM.KEP.SERIBU,KEP. SERIBU SELATAN,PULAU PARI,3101021003,2020-10-10,173,0,173,0,-2,2
DKI JAKARTA,KAB.ADM.KEP.SERIBU,KEP. SERIBU SELATAN,PULAU PARI,3101021003,2020-10-11,173,0,173,0,0,0
DKI JAKARTA,KAB.ADM.KEP.SERIBU,KEP. SERIBU SELATAN,PULAU PARI,3101021003,2020-10-12,173,0,173,0,0,0
DKI JAKARTA,KAB.ADM.KEP.SERIBU,KEP. SERIBU SELATAN,PULAU PARI,3101021003,2020-10-13,173,0,173,0,0,0
DKI JAKARTA,KAB.ADM.KEP.SERIBU,KEP. SERIBU SELATAN,PULAU PARI,3101021003,2020-10-14,173,0,173,0,0,0
DKI JAKARTA,KAB.ADM.KEP.SERIBU,KEP. SERIBU SELATAN,PULAU PARI,3101021003,2020-10-15,173,0,173,0,0,0
DKI JAKARTA,KAB.ADM.KEP.SERIBU,KEP. SERIBU SELATAN,PULAU PARI,3101021003,2020-10-16,173,0,173,0,0,0
DKI JAKARTA,KAB.ADM.KEP.SERIBU,KEP. SERIBU SELATAN,PULAU PARI,3101021003,2020-10-17,175,0,175,2,0,2
DKI JAKARTA,KAB.ADM.KEP.SERIBU,KEP. SERIBU SELATAN,PULAU PARI,3101021003,2020-10-18,175,0,175,0,0,0
DKI JAKARTA,KAB.ADM.KEP.SERIBU,KEP. SERIBU SELATAN,PULAU PARI,3101021003,2020-10-19,175,0,175,0,0,0
DKI JAKARTA,KAB.ADM.KEP.SERIBU,KEP. SERIBU SELATAN,PULAU PARI,3101021003,2020-10-20,175,0,175,0,0,0
DKI JAKARTA,KAB.ADM.KEP.SERIBU,KEP. SERIBU SELATAN,PULAU PARI,3101021003,2020-10-21,175,0,175,0,0,0
DKI JAKARTA,KAB.ADM.KEP.SERIBU,KEP. SERIBU SELATAN,PULAU PARI,3101021003,2020-10-22,175,0,175,0,0,0
DKI JAKARTA,KAB.ADM.KEP.SERIBU,KEP. SERIBU SELATAN,PULAU PARI,3101021003,2020-10-23,175,0,175,0,0,0
DKI JAKARTA,KAB.ADM.KEP.SERIBU,KEP. SERIBU SELATAN,PULAU PARI,3101021003,2020-10-24,175,0,175,0,0,0
DKI JAKARTA,KAB.ADM.KEP.SERIBU,KEP. SERIBU SELATAN,PULAU PARI,3101021003,2020-10-25,175,0,175,0,0,0
DKI JAKARTA,KAB.ADM.KEP.SERIBU,KEP. SERIBU SELATAN,PULAU PARI,3101021003,2020-10-26,175,0,175,0,0,0
DKI JAKARTA,KAB.ADM.KEP.SERIBU,KEP. SERIBU SELATAN,PULAU PARI,3101021003,2020-10-27,175,0,175,0,0,0
DKI JAKARTA,KAB.ADM.KEP.SERIBU,KEP. SERIBU SELATAN,PULAU PARI,3101021003,2020-10-28,175,0,175,0,0,0
DKI JAKARTA,KAB.ADM.KEP.SERIBU,KEP. SERIBU SELATAN,PULAU PARI,3101021003,2020-10-29,175,0,175,0,0,0
DKI JAKARTA,KAB.ADM.KEP.SERIBU,KEP. SERIBU SELATAN,PULAU PARI,3101021003,2020-10-30,198,7,191,23,7,16
DKI JAKARTA,KAB.ADM.KEP.SERIBU,KEP. SERIBU SELATAN,PULAU PARI,3101021003,2020-10-31,199,8,191,1,1,0
DKI JAKARTA,KAB.ADM.KEP.SERIBU,KEP. SERIBU SELATAN,PULAU TIDUNG,3101021002,2020-10-01,364,15,349,0,0,0
DKI JAKARTA,KAB.ADM.KEP.SERIBU,KEP. SERIBU SELATAN,PULAU TIDUNG,3101021002,2020-10-02,366,13,353,2,-2,4
DKI JAKARTA,KAB.ADM.KEP.SERIBU,KEP. SERIBU SELATAN,PULAU TIDUNG,3101021002,2020-10-03,368,14,354,2,1,1
DKI JAKARTA,KAB.ADM.KEP.SERIBU,KEP. SERIBU SELATAN,PULAU TIDUNG,3101021002,2020-10-04,368,14,354,0,0,0
DKI JAKARTA,KAB.ADM.KEP.SERIBU,KEP. SERIBU SELATAN,PULAU TIDUNG,3101021002,2020-10-05,369,15,354,1,1,0
DKI JAKARTA,KAB.ADM.KEP.SERIBU,KEP. SERIBU SELATAN,PULAU TIDUNG,3101021002,2020-10-06,369,15,354,0,0,0
DKI JAKARTA,KAB.ADM.KEP.SERIBU,KEP. SERIBU SELATAN,PULAU TIDUNG,3101021002,2020-10-07,369,14,355,0,-1,1
DKI JAKARTA,KAB.ADM.KEP.SERIBU,KEP. SERIBU SELATAN,PULAU TIDUNG,3101021002,2020-10-08,372,17,355,3,3,0
DKI JAKARTA,KAB.ADM.KEP.SERIBU,KEP. SERIBU SELATAN,PULAU TIDUNG,3101021002,2020-10-09,373,18,355,1,1,0
DKI JAKARTA,KAB.ADM.KEP.SERIBU,KEP. SERIBU SELATAN,PULAU TIDUNG,3101021002,2020-10-10,373,8,365,0,-10,10
DKI JAKARTA,KAB.ADM.KEP.SERIBU,KEP. SERIBU SELATAN,PULAU TIDUNG,3101021002,2020-10-11,373,8,365,0,0,0
DKI JAKARTA,KAB.ADM.KEP.SERIBU,KEP. SERIBU SELATAN,PULAU TIDUNG,3101021002,2020-10-12,373,7,366,0,-1,1
DKI JAKARTA,KAB.ADM.KEP.SERIBU,KEP. SERIBU SELATAN,PULAU TIDUNG,3101021002,2020-10-13,373,6,367,0,-1,1
DKI JAKARTA,KAB.ADM.KEP.SERIBU,KEP. SERIBU SELATAN,PULAU TIDUNG,3101021002,2020-10-14,374,6,368,1,0,1
DKI JAKARTA,KAB.ADM.KEP.SERIBU,KEP. SERIBU SELATAN,PULAU TIDUNG,3101021002,2020-10-15,374,5,369,0,-1,1
DKI JAKARTA,KAB.ADM.KEP.SERIBU,KEP. SERIBU SELATAN,PULAU TIDUNG,3101021002,2020-10-16,374,4,370,0,-1,1
DKI JAKARTA,KAB.ADM.KEP.SERIBU,KEP. SERIBU SELATAN,PULAU TIDUNG,3101021002,2020-10-17,376,4,372,2,0,2
DKI JAKARTA,KAB.ADM.KEP.SERIBU,KEP. SERIBU SELATAN,PULAU TIDUNG,3101021002,2020-10-18,376,4,372,0,0,0
DKI JAKARTA,KAB.ADM.KEP.SERIBU,KEP. SERIBU SELATAN,PULAU TIDUNG,3101021002,2020-10-19,376,2,374,0,-2,2
DKI JAKARTA,KAB.ADM.KEP.SERIBU,KEP. SERIBU SELATAN,PULAU TIDUNG,3101021002,2020-10-20,376,1,375,0,-1,1
DKI JAKARTA,KAB.ADM.KEP.SERIBU,KEP. SERIBU SELATAN,PULAU TIDUNG,3101021002,2020-10-21,376,1,375,0,0,0
DKI JAKARTA,KAB.ADM.KEP.SERIBU,KEP. SERIBU SELATAN,PULAU TIDUNG,3101021002,2020-10-22,379,1,378,3,0,3
DKI JAKARTA,KAB.ADM.KEP.SERIBU,KEP. SERIBU SELATAN,PULAU TIDUNG,3101021002,2020-10-23,384,6,378,5,5,0
DKI JAKARTA,KAB.ADM.KEP.SERIBU,KEP. SERIBU SELATAN,PULAU TIDUNG,3101021002,2020-10-24,384,1,383,0,-5,5
DKI JAKARTA,KAB.ADM.KEP.SERIBU,KEP. SERIBU SELATAN,PULAU TIDUNG,3101021002,2020-10-25,384,0,384,0,-1,1
DKI JAKARTA,KAB.ADM.KEP.SERIBU,KEP. SERIBU SELATAN,PULAU TIDUNG,3101021002,2020-10-26,386,2,384,2,2,0
DKI JAKARTA,KAB.ADM.KEP.SERIBU,KEP. SERIBU SELATAN,PULAU TIDUNG,3101021002,2020-10-27,386,2,384,0,0,0
DKI JAKARTA,KAB.ADM.KEP.SERIBU,KEP. SERIBU SELATAN,PULAU TIDUNG,3101021002,2020-10-28,386,2,384,0,0,0
DKI JAKARTA,KAB.ADM.KEP.SERIBU,KEP. SERIBU SELATAN,PULAU TIDUNG,3101021002,2020-10-29,387,3,384,1,1,0
DKI JAKARTA,KAB.ADM.KEP.SERIBU,KEP. SERIBU SELATAN,PULAU TIDUNG,3101021002,2020-10-30,394,6,388,7,3,4
DKI JAKARTA,KAB.ADM.KEP.SERIBU,KEP. SERIBU SELATAN,PULAU TIDUNG,3101021002,2020-10-31,398,10,388,4,4,0
DKI JAKARTA,KAB.ADM.KEP.SERIBU,KEP. SERIBU SELATAN,PULAU UNTUNG JAWA,3101021001,2020-10-01,104,4,100,0,0,0
DKI JAKARTA,KAB.ADM.KEP.SERIBU,KEP. SERIBU SELATAN,PULAU UNTUNG JAWA,3101021001,2020-10-02,104,2,102,0,-2,2
DKI JAKARTA,KAB.ADM.KEP.SERIBU,KEP. SERIBU SELATAN,PULAU UNTUNG JAWA,3101021001,2020-10-03,104,2,102,0,0,0
DKI JAKARTA,KAB.ADM.KEP.SERIBU,KEP. SERIBU SELATAN,PULAU UNTUNG JAWA,3101021001,2020-10-04,105,3,102,1,1,0
DKI JAKARTA,KAB.ADM.KEP.SERIBU,KEP. SERIBU SELATAN,PULAU UNTUNG JAWA,3101021001,2020-10-05,108,6,102,3,3,0
DKI JAKARTA,KAB.ADM.KEP.SERIBU,KEP. SERIBU SELATAN,PULAU UNTUNG JAWA,3101021001,2020-10-06,108,6,102,0,0,0
DKI JAKARTA,KAB.ADM.KEP.SERIBU,KEP. SERIBU SELATAN,PULAU UNTUNG JAWA,3101021001,2020-10-07,108,4,104,0,-2,2
DKI JAKARTA,KAB.ADM.KEP.SERIBU,KEP. SERIBU SELATAN,PULAU UNTUNG JAWA,3101021001,2020-10-08,108,4,104,0,0,0
DKI JAKARTA,KAB.ADM.KEP.SERIBU,KEP. SERIBU SELATAN,PULAU UNTUNG JAWA,3101021001,2020-10-09,109,5,104,1,1,0
DKI JAKARTA,KAB.ADM.KEP.SERIBU,KEP. SERIBU SELATAN,PULAU UNTUNG JAWA,3101021001,2020-10-10,109,5,104,0,0,0
DKI JAKARTA,KAB.ADM.KEP.SERIBU,KEP. SERIBU SELATAN,PULAU UNTUNG JAWA,3101021001,2020-10-11,109,5,104,0,0,0
DKI JAKARTA,KAB.ADM.KEP.SERIBU,KEP. SERIBU SELATAN,PULAU UNTUNG JAWA,3101021001,2020-10-12,109,5,104,0,0,0
DKI JAKARTA,KAB.ADM.KEP.SERIBU,KEP. SERIBU SELATAN,PULAU UNTUNG JAWA,3101021001,2020-10-13,109,5,104,0,0,0
DKI JAKARTA,KAB.ADM.KEP.SERIBU,KEP. SERIBU SELATAN,PULAU UNTUNG JAWA,3101021001,2020-10-14,109,5,104,0,0,0
DKI JAKARTA,KAB.ADM.KEP.SERIBU,KEP. SERIBU SELATAN,PULAU UNTUNG JAWA,3101021001,2020-10-15,109,1,108,0,-4,4
DKI JAKARTA,KAB.ADM.KEP.SERIBU,KEP. SERIBU SELATAN,PULAU UNTUNG JAWA,3101021001,2020-10-16,109,1,108,0,0,0
DKI JAKARTA,KAB.ADM.KEP.SERIBU,KEP. SERIBU SELATAN,PULAU UNTUNG JAWA,3101021001,2020-10-17,109,1,108,0,0,0
DKI JAKARTA,KAB.ADM.KEP.SERIBU,KEP. SERIBU SELATAN,PULAU UNTUNG JAWA,3101021001,2020-10-18,109,1,108,0,0,0
DKI JAKARTA,KAB.ADM.KEP.SERIBU,KEP. SERIBU SELATAN,PULAU UNTUNG JAWA,3101021001,2020-10-19,109,0,109,0,-1,1
DKI JAKARTA,KAB.ADM.KEP.SERIBU,KEP. SERIBU SELATAN,PULAU UNTUNG JAWA,3101021001,2020-10-20,109,0,109,0,0,0
DKI JAKARTA,KAB.ADM.KEP.SERIBU,KEP. SERIBU SELATAN,PULAU UNTUNG JAWA,3101021001,2020-10-21,109,0,109,0,0,0
DKI JAKARTA,KAB.ADM.KEP.SERIBU,KEP. SERIBU SELATAN,PULAU UNTUNG JAWA,3101021001,2020-10-22,109,0,109,0,0,0
DKI JAKARTA,KAB.ADM.KEP.SERIBU,KEP. SERIBU SELATAN,PULAU UNTUNG JAWA,3101021001,2020-10-23,109,0,109,0,0,0
DKI JAKARTA,KAB.ADM.KEP.SERIBU,KEP. SERIBU SELATAN,PULAU UNTUNG JAWA,3101021001,2020-10-24,109,0,109,0,0,0
DKI JAKARTA,KAB.ADM.KEP.SERIBU,KEP. SERIBU SELATAN,PULAU UNTUNG JAWA,3101021001,2020-10-25,109,0,109,0,0,0
DKI JAKARTA,KAB.ADM.KEP.SERIBU,KEP. SERIBU SELATAN,PULAU UNTUNG JAWA,3101021001,2020-10-26,112,3,109,3,3,0
DKI JAKARTA,KAB.ADM.KEP.SERIBU,KEP. SERIBU SELATAN,PULAU UNTUNG JAWA,3101021001,2020-10-27,112,3,109,0,0,0
DKI JAKARTA,KAB.ADM.KEP.SERIBU,KEP. SERIBU SELATAN,PULAU UNTUNG JAWA,3101021001,2020-10-28,112,3,109,0,0,0
DKI JAKARTA,KAB.ADM.KEP.SERIBU,KEP. SERIBU SELATAN,PULAU UNTUNG JAWA,3101021001,2020-10-29,112,3,109,0,0,0
DKI JAKARTA,KAB.ADM.KEP.SERIBU,KEP. SERIBU SELATAN,PULAU UNTUNG JAWA,3101021001,2020-10-30,112,3,109,0,0,0
DKI JAKARTA,KAB.ADM.KEP.SERIBU,KEP. SERIBU SELATAN,PULAU UNTUNG JAWA,3101021001,2020-10-31,112,3,109,0,0,0
DKI JAKARTA,KAB.ADM.KEP.SERIBU,KEP. SERIBU UTARA,PULAU HARAPAN,3101011003,2020-10-01,62,0,62,0,0,0
DKI JAKARTA,KAB.ADM.KEP.SERIBU,KEP. SERIBU UTARA,PULAU HARAPAN,3101011003,2020-10-02,63,1,62,1,1,0
DKI JAKARTA,KAB.ADM.KEP.SERIBU,KEP. SERIBU UTARA,PULAU HARAPAN,3101011003,2020-10-03,63,1,62,0,0,0
DKI JAKARTA,KAB.ADM.KEP.SERIBU,KEP. SERIBU UTARA,PULAU HARAPAN,3101011003,2020-10-04,63,1,62,0,0,0
DKI JAKARTA,KAB.ADM.KEP.SERIBU,KEP. SERIBU UTARA,PULAU HARAPAN,3101011003,2020-10-05,64,2,62,1,1,0
DKI JAKARTA,KAB.ADM.KEP.SERIBU,KEP. SERIBU UTARA,PULAU HARAPAN,3101011003,2020-10-06,64,2,62,0,0,0
DKI JAKARTA,KAB.ADM.KEP.SERIBU,KEP. SERIBU UTARA,PULAU HARAPAN,3101011003,2020-10-07,64,2,62,0,0,0
DKI JAKARTA,KAB.ADM.KEP.SERIBU,KEP. SERIBU UTARA,PULAU HARAPAN,3101011003,2020-10-08,64,2,62,0,0,0
DKI JAKARTA,KAB.ADM.KEP.SERIBU,KEP. SERIBU UTARA,PULAU HARAPAN,3101011003,2020-10-09,64,2,62,0,0,0
DKI JAKARTA,KAB.ADM.KEP.SERIBU,KEP. SERIBU UTARA,PULAU HARAPAN,3101011003,2020-10-10,64,2,62,0,0,0
DKI JAKARTA,KAB.ADM.KEP.SERIBU,KEP. SERIBU UTARA,PULAU HARAPAN,3101011003,2020-10-11,64,2,62,0,0,0
DKI JAKARTA,KAB.ADM.KEP.SERIBU,KEP. SERIBU UTARA,PULAU HARAPAN,3101011003,2020-10-12,64,1,63,0,-1,1
DKI JAKARTA,KAB.ADM.KEP.SERIBU,KEP. SERIBU UTARA,PULAU HARAPAN,3101011003,2020-10-13,70,7,63,6,6,0
DKI JAKARTA,KAB.ADM.KEP.SERIBU,KEP. SERIBU UTARA,PULAU HARAPAN,3101011003,2020-10-14,70,7,63,0,0,0
DKI JAKARTA,KAB.ADM.KEP.SERIBU,KEP. SERIBU UTARA,PULAU HARAPAN,3101011003,2020-10-15,70,7,63,0,0,0
DKI JAKARTA,KAB.ADM.KEP.SERIBU,KEP. SERIBU UTARA,PULAU HARAPAN,3101011003,2020-10-16,76,12,64,6,5,1
DKI JAKARTA,KAB.ADM.KEP.SERIBU,KEP. SERIBU UTARA,PULAU HARAPAN,3101011003,2020-10-17,77,13,64,1,1,0
DKI JAKARTA,KAB.ADM.KEP.SERIBU,KEP. SERIBU UTARA,PULAU HARAPAN,3101011003,2020-10-18,77,13,64,0,0,0
DKI JAKARTA,KAB.ADM.KEP.SERIBU,KEP. SERIBU UTARA,PULAU HARAPAN,3101011003,2020-10-19,77,13,64,0,0,0
DKI JAKARTA,KAB.ADM.KEP.SERIBU,KEP. SERIBU UTARA,PULAU HARAPAN,3101011003,2020-10-20,77,13,64,0,0,0
DKI JAKARTA,KAB.ADM.KEP.SERIBU,KEP. SERIBU UTARA,PULAU HARAPAN,3101011003,2020-10-21,77,13,64,0,0,0
DKI JAKARTA,KAB.ADM.KEP.SERIBU,KEP. SERIBU UTARA,PULAU HARAPAN,3101011003,2020-10-22,77,13,64,0,0,0
DKI JAKARTA,KAB.ADM.KEP.SERIBU,KEP. SERIBU UTARA,PULAU HARAPAN,3101011003,2020-10-23,77,13,64,0,0,0
DKI JAKARTA,KAB.ADM.KEP.SERIBU,KEP. SERIBU UTARA,PULAU HARAPAN,3101011003,2020-10-24,77,7,70,0,-6,6
DKI JAKARTA,KAB.ADM.KEP.SERIBU,KEP. SERIBU UTARA,PULAU HARAPAN,3101011003,2020-10-25,77,7,70,0,0,0
DKI JAKARTA,KAB.ADM.KEP.SERIBU,KEP. SERIBU UTARA,PULAU HARAPAN,3101011003,2020-10-26,77,7,70,0,0,0
DKI JAKARTA,KAB.ADM.KEP.SERIBU,KEP. SERIBU UTARA,PULAU HARAPAN,3101011003,2020-10-27,77,1,76,0,-6,6
DKI JAKARTA,KAB.ADM.KEP.SERIBU,KEP. SERIBU UTARA,PULAU HARAPAN,3101011003,2020-10-28,77,1,76,0,0,0
DKI JAKARTA,KAB.ADM.KEP.SERIBU,KEP. SERIBU UTARA,PULAU HARAPAN,3101011003,2020-10-29,77,0,77,0,-1,1
DKI JAKARTA,KAB.ADM.KEP.SERIBU,KEP. SERIBU UTARA,PULAU HARAPAN,3101011003,2020-10-30,87,10,77,10,10,0
DKI JAKARTA,KAB.ADM.KEP.SERIBU,KEP. SERIBU UTARA,PULAU HARAPAN,3101011003,2020-10-31,88,11,77,1,1,0
DKI JAKARTA,KAB.ADM.KEP.SERIBU,KEP. SERIBU UTARA,PULAU KELAPA,3101011002,2020-10-01,147,2,145,0,0,0
DKI JAKARTA,KAB.ADM.KEP.SERIBU,KEP. SERIBU UTARA,PULAU KELAPA,3101011002,2020-10-02,154,9,145,7,7,0
DKI JAKARTA,KAB.ADM.KEP.SERIBU,KEP. SERIBU UTARA,PULAU KELAPA,3101011002,2020-10-03,154,9,145,0,0,0
DKI JAKARTA,KAB.ADM.KEP.SERIBU,KEP. SERIBU UTARA,PULAU KELAPA,3101011002,2020-10-04,155,10,145,1,1,0
DKI JAKARTA,KAB.ADM.KEP.SERIBU,KEP. SERIBU UTARA,PULAU KELAPA,3101011002,2020-10-05,155,10,145,0,0,0
DKI JAKARTA,KAB.ADM.KEP.SERIBU,KEP. SERIBU UTARA,PULAU KELAPA,3101011002,2020-10-06,155,9,146,0,-1,1
DKI JAKARTA,KAB.ADM.KEP.SERIBU,KEP. SERIBU UTARA,PULAU KELAPA,3101011002,2020-10-07,155,8,147,0,-1,1
DKI JAKARTA,KAB.ADM.KEP.SERIBU,KEP. SERIBU UTARA,PULAU KELAPA,3101011002,2020-10-08,155,8,147,0,0,0
DKI JAKARTA,KAB.ADM.KEP.SERIBU,KEP. SERIBU UTARA,PULAU KELAPA,3101011002,2020-10-09,155,8,147,0,0,0
DKI JAKARTA,KAB.ADM.KEP.SERIBU,KEP. SERIBU UTARA,PULAU KELAPA,3101011002,2020-10-10,155,8,147,0,0,0
DKI JAKARTA,KAB.ADM.KEP.SERIBU,KEP. SERIBU UTARA,PULAU KELAPA,3101011002,2020-10-11,155,8,147,0,0,0
DKI JAKARTA,KAB.ADM.KEP.SERIBU,KEP. SERIBU UTARA,PULAU KELAPA,3101011002,2020-10-12,155,1,154,0,-7,7
DKI JAKARTA,KAB.ADM.KEP.SERIBU,KEP. SERIBU UTARA,PULAU KELAPA,3101011002,2020-10-13,178,24,154,23,23,0
DKI JAKARTA,KAB.ADM.KEP.SERIBU,KEP. SERIBU UTARA,PULAU KELAPA,3101011002,2020-10-14,178,24,154,0,0,0
DKI JAKARTA,KAB.ADM.KEP.SERIBU,KEP. SERIBU UTARA,PULAU KELAPA,3101011002,2020-10-15,179,24,155,1,0,1
DKI JAKARTA,KAB.ADM.KEP.SERIBU,KEP. SERIBU UTARA,PULAU KELAPA,3101011002,2020-10-16,179,24,155,0,0,0
DKI JAKARTA,KAB.ADM.KEP.SERIBU,KEP. SERIBU UTARA,PULAU KELAPA,3101011002,2020-10-17,181,26,155,2,2,0
DKI JAKARTA,KAB.ADM.KEP.SERIBU,KEP. SERIBU UTARA,PULAU KELAPA,3101011002,2020-10-18,181,26,155,0,0,0
DKI JAKARTA,KAB.ADM.KEP.SERIBU,KEP. SERIBU UTARA,PULAU KELAPA,3101011002,2020-10-19,181,26,155,0,0,0
DKI JAKARTA,KAB.ADM.KEP.SERIBU,KEP. SERIBU UTARA,PULAU KELAPA,3101011002,2020-10-20,181,26,155,0,0,0
DKI JAKARTA,KAB.ADM.KEP.SERIBU,KEP. SERIBU UTARA,PULAU KELAPA,3101011002,2020-10-21,181,26,155,0,0,0
DKI JAKARTA,KAB.ADM.KEP.SERIBU,KEP. SERIBU UTARA,PULAU KELAPA,3101011002,2020-10-22,181,26,155,0,0,0
DKI JAKARTA,KAB.ADM.KEP.SERIBU,KEP. SERIBU UTARA,PULAU KELAPA,3101011002,2020-10-23,181,26,155,0,0,0
DKI JAKARTA,KAB.ADM.KEP.SERIBU,KEP. SERIBU UTARA,PULAU KELAPA,3101011002,2020-10-24,181,2,179,0,-24,24
DKI JAKARTA,KAB.ADM.KEP.SERIBU,KEP. SERIBU UTARA,PULAU KELAPA,3101011002,2020-10-25,181,2,179,0,0,0
DKI JAKARTA,KAB.ADM.KEP.SERIBU,KEP. SERIBU UTARA,PULAU KELAPA,3101011002,2020-10-26,181,2,179,0,0,0
DKI JAKARTA,KAB.ADM.KEP.SERIBU,KEP. SERIBU UTARA,PULAU KELAPA,3101011002,2020-10-27,181,2,179,0,0,0
DKI JAKARTA,KAB.ADM.KEP.SERIBU,KEP. SERIBU UTARA,PULAU KELAPA,3101011002,2020-10-28,181,2,179,0,0,0
DKI JAKARTA,KAB.ADM.KEP.SERIBU,KEP. SERIBU UTARA,PULAU KELAPA,3101011002,2020-10-29,184,2,182,3,0,3
DKI JAKARTA,KAB.ADM.KEP.SERIBU,KEP. SERIBU UTARA,PULAU KELAPA,3101011002,2020-10-30,206,24,182,22,22,0
DKI JAKARTA,KAB.ADM.KEP.SERIBU,KEP. SERIBU UTARA,PULAU KELAPA,3101011002,2020-10-31,208,26,182,2,2,0
DKI JAKARTA,KAB.ADM.KEP.SERIBU,KEP. SERIBU UTARA,PULAU PANGGANG,3101011001,2020-10-01,163,7,156,0,0,0
DKI JAKARTA,KAB.ADM.KEP.SERIBU,KEP. SERIBU UTARA,PULAU PANGGANG,3101011001,2020-10-02,165,7,158,2,0,2
DKI JAKARTA,KAB.ADM.KEP.SERIBU,KEP. SERIBU UTARA,PULAU PANGGANG,3101011001,2020-10-03,164,6,158,-1,-1,0
DKI JAKARTA,KAB.ADM.KEP.SERIBU,KEP. SERIBU UTARA,PULAU PANGGANG,3101011001,2020-10-04,167,8,159,3,2,1
DKI JAKARTA,KAB.ADM.KEP.SERIBU,KEP. SERIBU UTARA,PULAU PANGGANG,3101011001,2020-10-05,167,8,159,0,0,0
DKI JAKARTA,KAB.ADM.KEP.SERIBU,KEP. SERIBU UTARA,PULAU PANGGANG,3101011001,2020-10-06,168,8,160,1,0,1
DKI JAKARTA,KAB.ADM.KEP.SERIBU,KEP. SERIBU UTARA,PULAU PANGGANG,3101011001,2020-10-07,168,5,163,0,-3,3
DKI JAKARTA,KAB.ADM.KEP.SERIBU,KEP. SERIBU UTARA,PULAU PANGGANG,3101011001,2020-10-08,170,7,163,2,2,0
DKI JAKARTA,KAB.ADM.KEP.SERIBU,KEP. SERIBU UTARA,PULAU PANGGANG,3101011001,2020-10-09,171,7,164,1,0,1
DKI JAKARTA,KAB.ADM.KEP.SERIBU,KEP. SERIBU UTARA,PULAU PANGGANG,3101011001,2020-10-10,171,7,164,0,0,0
DKI JAKARTA,KAB.ADM.KEP.SERIBU,KEP. SERIBU UTARA,PULAU PANGGANG,3101011001,2020-10-11,171,7,164,0,0,0
DKI JAKARTA,KAB.ADM.KEP.SERIBU,KEP. SERIBU UTARA,PULAU PANGGANG,3101011001,2020-10-12,171,7,164,0,0,0
DKI JAKARTA,KAB.ADM.KEP.SERIBU,KEP. SERIBU UTARA,PULAU PANGGANG,3101011001,2020-10-13,174,8,166,3,1,2
DKI JAKARTA,KAB.ADM.KEP.SERIBU,KEP. SERIBU UTARA,PULAU PANGGANG,3101011001,2020-10-14,174,8,166,0,0,0
DKI JAKARTA,KAB.ADM.KEP.SERIBU,KEP. SERIBU UTARA,PULAU PANGGANG,3101011001,2020-10-15,175,7,168,1,-1,2
DKI JAKARTA,KAB.ADM.KEP.SERIBU,KEP. SERIBU UTARA,PULAU PANGGANG,3101011001,2020-10-16,175,5,170,0,-2,2
DKI JAKARTA,KAB.ADM.KEP.SERIBU,KEP. SERIBU UTARA,PULAU PANGGANG,3101011001,2020-10-17,176,6,170,1,1,0
DKI JAKARTA,KAB.ADM.KEP.SERIBU,KEP. SERIBU UTARA,PULAU PANGGANG,3101011001,2020-10-18,176,6,170,0,0,0
DKI JAKARTA,KAB.ADM.KEP.SERIBU,KEP. SERIBU UTARA,PULAU PANGGANG,3101011001,2020-10-19,176,5,171,0,-1,1
DKI JAKARTA,KAB.ADM.KEP.SERIBU,KEP. SERIBU UTARA,PULAU PANGGANG,3101011001,2020-10-20,178,7,171,2,2,0
DKI JAKARTA,KAB.ADM.KEP.SERIBU,KEP. SERIBU UTARA,PULAU PANGGANG,3101011001,2020-10-21,178,7,171,0,0,0
DKI JAKARTA,KAB.ADM.KEP.SERIBU,KEP. SERIBU UTARA,PULAU PANGGANG,3101011001,2020-10-22,178,7,171,0,0,0
DKI JAKARTA,KAB.ADM.KEP.SERIBU,KEP. SERIBU UTARA,PULAU PANGGANG,3101011001,2020-10-23,178,7,171,0,0,0
DKI JAKARTA,KAB.ADM.KEP.SERIBU,KEP. SERIBU UTARA,PULAU PANGGANG,3101011001,2020-10-24,178,4,174,0,-3,3
DKI JAKARTA,KAB.ADM.KEP.SERIBU,KEP. SERIBU UTARA,PULAU PANGGANG,3101011001,2020-10-25,179,5,174,1,1,0
DKI JAKARTA,KAB.ADM.KEP.SERIBU,KEP. SERIBU UTARA,PULAU PANGGANG,3101011001,2020-10-26,179,4,175,0,-1,1
DKI JAKARTA,KAB.ADM.KEP.SERIBU,KEP. SERIBU UTARA,PULAU PANGGANG,3101011001,2020-10-27,179,3,176,0,-1,1
DKI JAKARTA,KAB.ADM.KEP.SERIBU,KEP. SERIBU UTARA,PULAU PANGGANG,3101011001,2020-10-28,179,3,176,0,0,0
DKI JAKARTA,KAB.ADM.KEP.SERIBU,KEP. SERIBU UTARA,PULAU PANGGANG,3101011001,2020-10-29,179,2,177,0,-1,1
DKI JAKARTA,KAB.ADM.KEP.SERIBU,KEP. SERIBU UTARA,PULAU PANGGANG,3101011001,2020-10-30,179,2,177,0,0,0
DKI JAKARTA,KAB.ADM.KEP.SERIBU,KEP. SERIBU UTARA,PULAU PANGGANG,3101011001,2020-10-31,179,2,177,0,0,0
